--E---------o-B-------------E----------B----o-X------?-E---E---oo-----E----------EX--------X-B?-X----E-o---B---M-----B-o?--------E--EXE-----X----X--Bo----o--X-X------B--X------------X-B-------------M-
-?---------X---------------B----------------o-----X----------------------------------------X------o-----X--X-----o-o--BE-----XoE--E-X----------E-----------------------------E-------X--Eo----X-B--X----
-B---B----------------E-----------B--E--------------E--?--o---?-?--B--------ME-------------X--X--------X---X-B----o-------------M-----------oX-------------?----X----B-----?-----------E-X----?---------
-E?------------------------o-X-------------------------?---------o-------------------------B--o?EBX---------o----M-E----X----X------------o---o----?B-?---B---E--------------------------------------E--
-XX--X--XB--X-----o-M-o----M-----?--o--?-o-----B-------------------X-------------?----o---?-----------?-X---o-o--BX-----X-------X--o------X---------E-M----------M-----------B------------E--M-------X--
--------X-------------------B------------------------------X--o-----------XB---X----------B------E----B--------------------------E------------o-B?------------E-o--M-----o-E-----------------o------X--M
B-----MoB-------?-------------o----------------E--X-----------?X-----B--------?----X------X--?----B---X-----------?---M------B------o---E-E-----------X----XEB---X-------BX------------?Bo-X------o---BM
-B-----------o---o---------B--------E----X-------------EEX----B---X---------B-E-E----------B---------B-----B----B-----------oX-------o-----X--MX--EM--------o---------E-------------------o-------E----v
-------X--------E---B-E-------------------X---------X-----o----E-------------X-------------E---------B----E------------o--X-------X------X----o---------E-------------X-M--o--B-------?----------Bo-----
-E------?XX-----E--o-------------o-------X-------B------M----------M---o--B----B-----BX---------------M-----BM-----?------------BB--------X--oX----BB--E-B----------------------E--Xo--oBX-?-------?B---
---------E-------?----------o---?-------------Xo----o-------o--o---M------M-----X----------------------X--M------X-----oX-E----------M--------M--E-X---X-X------------------------MX--EX---oo----------X
------------------o-----------B------o--------Eo---X--------oB-------------------------------B-M----?X---------X----------?--------X--E-B-X-------------E-------o----X------------o-----------?---------
-----X--------B--X-------B------------X-----X--X-------B-------------E?-----M--B----X-------E-X---------M------------o?E----o---X-----?-o----Xo-E-oB--------------------------?----------------X--------
-----T-X--TTT--XT-----MTTTT--T----------T---?-T----TT-------T----T--T-----------T----TT---TB--?-T-X-E------XE-----E----T---TXT-T-T-----TTT-T-T----------TT-----ME-T-TEX--T--B--T--XT--TT-X---T-?-X?---o-
m----|--o-|||E-o|---o--||||--|-E-o--B--o|---B-|--E-||-------|-BE?|X-|-EXB---BX--|--o-||---|--?--|----X-EM-B---B---B--?-|-X-|-|-|-|-?--X|||-|E|o----Eo-?-||-o------|-|----|-----|--X|-X||---?o|-X----o---
XXXXXXXXXXXXXXXXXXXXXXXXXXXXXXXXXXXXXXXXXXXXXXXXXXXXXXXXXXXXXXXXXXXXXXXXXXXXXXXXXXXXXXXXXXXXXXXXXXXXXXXXXXXXXXXXXXXXXXXXXXXXXXXXXXXXXXXXXXXXXXXXXXXXXXXXXXXXXXXXXXXXXXXXXXXXXXXXXXXXXXXXXXXXXXXXXXXXXXXX
