--M-B-------B-----------------B---o-E-o-------X--------X-X-----------o---------o-----o-E-E----------X--------E--E-------------o--?X----B--E----o---------------E-E--E----BXB---------------B--M--B----B-
---B?----------------------------Bo-------?-B-o----------E--X------o----BXX---X-E---------o-M-BE---X----------------?B--------B----X----o-E-X--o?------o--------B-----o--B-----o--E-----E----------?----
--------o--------M----------o---------o---o-X--B-------o--oXX-----------B-------X---B-----oE----B--E---X------X----X--o--------X-XX--E--Bo--o-----B----?-o-oX-X------------B--E--E----------------X--o--
-----M---X-----------------X---XM--?E-------------------E------o--X---X---------o?--------------------------------------X------X--E--X-----------MB?X---X---M-------o------o-X?----o---------MX-------X-
-----------o--BE---X-----B-E------------o----EX-X------T--------------X--B--------E--M--E-X-E------?------E----------X--------E-o-XB---o----E-------o------------------------X-----------------o-o-E----
------o--X---?M---o------------------------?-----------XX---------B-E--X---B----------B-----------------------X-X-------X-------------?-------------------------X---------?------?--E-----X---o------o-X
---------XX---ME--------X---B-----?-------o-X-----M----E--X------B--o--B--------------BE----------B-------------------------o-----X---B-------X-B-E------M------------X---?------------X-----M-o-o-o?---
--X-----X?----E---o----------ME------X---E-----------X-?--------B-------X------------?-X-E------------o--X------E-----E-----------o-----X-----X----------o---------?--E----E---E-----BX----------------v
----------B-----?--EE-EX--X---------------------X------------o---E------------o-----------------X---B-?-------------o------o------?-------------X-------X-----B---o--o-------B----X-------------------X-
o-------X-------------X-----------o---------X-----o--X-X---E----------X-----------E-EM---E-----M-X--------E------M--o-------------------E--------------------o-----X--B-------o--X---------------o-X----
----E-------------B----------E------X--------X----------o--X---------------X-----------E----------E-------XX--------?o---------------o?------------------------E--------------M--------------------M----
-----------------------T-?-o----EXE--o?-B----M-B-X---X--------B-----B?-?--o--?---X--XX--------X---E----------------------X---E-----E---B-B---BE----B-----B-----B-------o--o----X----X--o-T?-o--B-----B-?
--------------------XX-|--E--o-X-----E--T----T--------------T-------X-------E----X--B------T--X-T---------X-----B-------o------B------?----o--------X------------------oB-----------Bo--T|-T----------X-
----o---T----T-o----B--|TB-----B---o-T--|-B--|---oT--XTo--o-|--T--TT-----T--T-T-o-oTT------|T-X-|-----TT--TT----B----o--TE--T---ToTM--B----B---o--------E-?-----EXT-------ET-T-TT----?--||-|ET--T-----X-
m-------|----|----?---X||----------M-|--|----|X--X|---|-----|-B|-B||--B--|--|-|-B-X||X---oE||---|--M--||--||------------|--E|X--|-|B------X-----------o-o-X-X-----|------o-|-|-||--XB---||-|-|--|-E-----
XXXXXXXXXXXXXXXXXXXXXXXXXXXXXXXXXXXXXXXXXXXXXXXXXXXXXXXXXXXXXXXXXXXXXXXXXXXXXXXXXXXXXXXXXXXXXXXXXXXXXXXXXXXXXXXXXXXXXXXXXXXXXXXXXXXXXXXXXXXXXXXXXXXXXXXXXXXXXXXXXXXXXXXXXXXXXXXXXXXXXXXXXXXXXXXXXXXXXXXX
