--X-------X-B-X?----XX----E--?----X--B-B-MX----o------------?--------------X---B-B------B-E-X--E---------------X-------oo-----X---X-----------B---------M-o-----X----X--B-------o--X--------B--X-------X
X-----T--------XBX---------?-X---XMB-B-------?--o----B-o----X----X------------EB----XX---X--X---X---E--o-------M--X---XX-?----X----E------X-o-------------o---B-----o--X------X--------?------X-o-----X-
--?---|---X------M-----XX------------------------------------------X-XXX------B-X-------XM--------------X?--BM-MX---EE-XX-E-Xo--o-X------E---XX-------------------X-----o---X---------------BB----------
----Xo|---X--o--X-------------B--------X---X--o-------------------B---B-o-----B----X---------X-E----B-X-B---XB-----o-XoX?-X-ooX--oo--o-BB--o--------Bo-----?----M-oX-Xo--X----------X-------E--X---?--B-
---X--|o-----------------MB------X----B--?-------------------------o----B--B-X----X---E-------BM----?--B-B---X---X?B--o-o--------?X----?XX--------------o------?E-X-X---oo--X-X----o--------------------
------|M----B--oo------EX-X------o---Xo----X----X--X-----X-?---------o-X----------------XX------M-----?X---------X-oXX---X-X---E-XXX-----o---------------------------------o----X-o--------X----E--X----
---M-B|--------?---XX-X--X-XX-X--X-----M--B------X--o------X-B--X----X-----XX----X-o-X-------X--EoXX------------?---?-------X----o-X--X------X---o?------X--o--?-?----X-X-------?--?B-------o-B-X-------
---E--|X-X---X----X--E---E--B---o--------Xo-BBX-XX-X--?-----------X-------------B-XE---E--X---X------X-B-----o---B------XX-oBX------X--E-XX------?----------------X---B--------X-B--X---X-----o--------v
------|-?--BX---o---o--?-E-----BB-----X-----o---E-o--XX-o------X--o-oo-M-o-------o-----XE--?----o----X?--E--B----E--------XX-----------------o--X--?----X--X-X-o-M-----o--X-----X-----X---X-------X-?---
------|--------Eo------------X-o------X------?--X-X------B-X------E-X-----------BX----E---XM---M-----B-?--------?-X----MX-M---E-EX--X--------X-----?---Mo---B--------X------X-----XX---X--o--X-----X----
-----X|-o-----E--B---X-oM-X----------E-------BX----oo------------------BMX----X-------MX---------?---XoB---MX---------X-----o------------o--?-----------E----X------?--BoX-------------------E-B-XXM---B
--?---|-oB------o-------X--EX-X-------------E?-E-B--------o---------------o---XEX----E---XBX-B-B-o-----------X--X-?---B----E----------?M--o-Xo--------o?-X-E--X---XB-XB---X-?---E---Xo-B--Xo----------BX
--TT-X|--T--X----M---X-----------oB-X----E--?-----B------X-X-----------------X--B-X-X-E--------X-XB--XEo-o---Xo---XX----------o-?X-oX----X---B?------------X------------X--oo-X----?----X-X---o--X--o---
--||--|BX|-o---X--E--?-----o--B--X-B-X----B---BT-E-----o---E------T-X--X----X-X-X--oE---X--o-o-?Xo-X----B?---X----X--?X-----M-B--?--o---X----------------B-------?--oXB-B----------------------oo-?--XX-
mX||-B|--|--X-----------BB-------X----o--X--X--T---X--XX-----o----T-------o-E---------XM-----------o------X-X-------BX-X----------o------oXo-----------X--X----------X-XB-oXo----M-M-X-------BB-?-B-----
XXXXXXXXXXXXXXXXXXXXXXXXXXXXXXXXXXXXXXXXXXXXXXXXXXXXXXXXXXXXXXXXXXXXXXXXXXXXXXXXXXXXXXXXXXXXXXXXXXXXXXXXXXXXXXXXXXXXXXXXXXXXXXXXXXXXXXXXXXXXXXXXXXXXXXXXXXXXXXXXXXXXXXXXXXXXXXXXXXXXXXXXXXXXXXXXXXXXXXXX
