------?-M------|---X------E-----E-------?-?-E--------------------B-T------------------B-------E---------------?-----------o--?-o-------o----?---BX----------B--B--------E----------?-------------E------
----X---o----------------------?-------------------E----------E-o------------B---------X--------------BoE--?----E------B---------------o-----?B----M------------E----Bo--------?--oE------?---------o---
?o---E----------------------?--------o-|-Eo?----B-B--------------------o--B------B-T---E----------------------?---E--o--T-|----------------o--?-------o-----------B|-o----BE--------B-|---E-------o-----
--?--E-----?-------?------E-----------B-|oB------B---M------o-------------o-------------?-TE------o----B-----B-------Xo----------------------o------T---------------E----------M---o-?---?-----------?B-
-o----E--?----B--------|----M----------o---------?---------E--E-------E----------BM------X---------------B-----------E--M---?------X-------?o?------o---B-B--B?E-------E--BB----------E------------Eo---
---?-----o-?Bo---oX-XE--X---oT-----------T--E------B--?---------------M---------M---------------B-?--------|----------B-o-------MB---E------------|E----------B---------T--------B-o--X---To?-----E-----
E-M---|--------o--M-oB-X-E--E---------B-------o---M-|----------?---------|--?--?-------T----E-----B-------X--o--B----E---M----o----------o-------M--EX----o-------------B|o----B-------------oE-------o-
-----------X------------------B--------?-o-------?E-----B---E--T?o|----------B-X--T------?--?o-------B-----------------EB--XTE---------?o--B-?-----B------E?------B--||-EB--------B--------EB-B--------v
--X-----X------E--------?----o-----B-B-------o----------------o-------------?B------------------E-------o---o--M----o----o----B----------B--X---o--------X-o------?T-E---o-----|-------B--------?B-M--?-
----E-----B----o---?-------Eo-E--T----------o--------------M--o--B-----?-----------?--------------|E---------??--X-X--E?-o------------------o--oE---?------?--------------?-----?-------------o------B--
-------TE---E---?-M-?---o-----o-------T--E------B|--|M--?-BBo--o------X--E------------o?----------?---X-X-------------B------E----T------oX---------|---------T--------E---T-E------------------------X-
--E----------------?-o------?------------------B------------E-----TB------------oX-------B-------E-?----|-M------X----------------E---------------E--------?--------E-T---|-----o--B--E-B-T-------------
--X---|---?------E----------------------?------B----------B-o--E--------o-----B----------------------EM-------B--o----------------T--M-------E-----|B-B-------------E--?-X---E----B-B-----?Xo-----EE----
---------E--E----?------BE----------|M--E-----E---------X------------|E----|----B---|--o--o--------------X--o-?--------------------------|---------M----EB---------------B----------o-----MB------------
m----------------T---------------------o------------o------E-oEB-----------B----------------------------?M-T---T------T----B-B-------M----o--?--------?---------?--------o---o---------o--o-------E-o--o
----------X--?--o---BB------?o--M---------E------------------------B---BX----?----------X-----B-------T----------------------E-------B-------------X---?---------oB-------X----o---------?--------------
