o?B---------------------------X-------?---------------MoBBBB-----------------o------------XB?MB----------MB-----B?----oB?BBX------------X---------------------------------------------------------------
---?XM-?X-----------------MXXX-----------BBB----------------------------------XXXX---BBX-BMB--------BX----X?---BB----B-----------------XB--?X--------BB---------------------XB------BB--BBXB-----X?BB---
o?-----B----MB-----------?B---------BBB---------?XXX----XXBX-B?B---XBBX------------------M??-------------------------------B?---?XB--X-----MXB------------BBX--M---BM-BBBM-BB--------------------------X
o-B----------MX------------XXB--------?M--?------XBB---EB--------BMB--?B?B-------BMBM---BXB--------------------------------BBBXX-MB--------------BMX-------BXB---------------------------BBX----o-X-o?B-
---------------------XBB--------------------------------------------BXBX--------------------X----------------------------BXB---?B?----------------------------------------------BBX--X?-------MBXXXX----
EXo?XBBBXX----B---M-----------------XB--MBBBXB-----------------B?B-------------------------------------------X?-BBXB--------X-------------B-X---------XBM??oBBXB-----MB?-----B?----------B?---------BB?-
-XXB--?X-M--------------------??B-------M--M--------------------------------------E?XB---------??XBB?BB-XB---B------XB---------------------B---o-XX-------------------------------------MBB-------------
--------B---------o-------------------XBB-------------?--------MXXXXXX------------------XBB------------------B-?BBB------------?B--------BXXX?--X---------------------BBBX-------B---------XX--------MXv
--?B--BBXB-------------------------BX?----XX---?-BB------------------B?MX----------------------M---------BBXM-------XB------------------------------------------------------------------M-BM?X--B-XB---f
---------------------------XB--BB----------------------------------------------------X-------BXM------------------XXMM------BXXB----MMM--BM?--------B?XM-----------EXX------XXBX----??XBBBB-------MB---f
-----------------------------------XB-BBo?X----o-----B----------oX------------EB-----------MBXXMMXB---B-----MBX----X?X?--------------------X-----oB-oB-------------?-------BB-------------------MMX----f
-----------M-------------oB---M-----------B-----X---------------B?--------------X--X------X-------------------M--B---------------------MBB-------------BXB?-B-?X-------o----XX---------------------?X--f
-----------------BMBBX--------XB--------XB?BB--------BBB---BBBB------BB----XBX----------------------------------B?BXMBBBBB-----------------X--------?--------------------XB-----XXB---------------XBM?-f
------B--------------------BMB-------------------------------------------oB------B?B----X-------------M------MB?B------??-------------?-------------------------------BBMBXXXXX------------------------f
m-------------------X?-------oXX------XB-----------------T?-----BB--BBX----------------------------XBMBXXB-XM-----BM?--XB------------------XX-----------??M-TTB?------X----X---o------------B------B---X
X---------------BX--------------------------------MMXMBBB|TXX---------------??BBB--------BB---------------oMBB------XB-?-MXB--XM--BMB--------BB?-------B?B--||BB----------BB--------------oBX----------X
---XXXX-XXXXX-XXX-XXX--X-XX-X-XXXXXXX-XXXXXXXX-X-X-XXXXXX-XXXX|X--XXXXXX-XXX--XXXX|XX-X-XXXX|XXX-X--X-XXXXXXXXXXXXXXXX-XXX-XXXX--X|XXXXXXXX-XXX-XX-XX-|XXXXXXXXX--XXXXXX-XXX-XX-XXXX-X-XXXXXX-XXXX---X-X
