-------oXX------------B--------------------BBoXB----------------BBM--------------o-------------BXX?--X-----------------------------BXX----------------------M?------------BB-oB---?-----------o?-----BB-
XX-----?XX-B------------------BB--E---------------XM----------------B?-----------------------------XX----------BMB--X-----------X----X?B?XMM-------------?BBB?B?B--XBB--BBB?XXXB?B--------------B-----B-
oo?----------------------BBBBX--------------X-------M------BBM------XM-------------BB?-----------XX-------BBBX----B----------------------BBXBBBB?--------------BBX----------------------B---------------
-------------------------BX??XoB?B??---------------X?----------XM--------o?-------------X--------------------------?BBB---------BB??---B--------------X-------E-BBBB-o?B-----------------BBBBB----------
---X?MB-------------BBB------BXX--------Xo---------------------------------------------?oXB------M-----BBBBB-----------------------------B----BXM----?M-X----?B----XB-----oB--------------XXX-----------
-----------MXBB-----------?BXBXB---------------------BBB?--?BXX?-XXMBBBBX----------------------------------------XMB--------XBB-----------------------------------------BX-?B?-------------------------M
-M-------BB--BB--XXBM-?---------------?------------X--XX--BBB?B------------------oXMB--------MBEB?X----------?-------MBBXXB--------M----------?------------------------------------------XB-------------
-----------------XX--------BBBXBB--X--------------------oM?-----o-----------------B?BX-----BBX--------X------------------XBB--------------------BBB---X----------------------BB?B?-B-X-BM--------------v
--------BX---BBBX-----BB-----------??-oBX?B----------------------XB???X-?BBB-------------BX?X---XX?BBB------?BB?-----M---------------?BXM-------------XMB-----------------?B---------------------------f
---------------------------------MXB----------?------------------------?XXX?B-B-----------oX--------BX--------BMB----------------------------------MoX-XMX?--------MBB-MXB--------B?X-----XMB---o---XX?f
----------B??BBB?BX---------------------------B?X------------E----------------------?BXB----oB?B------------------B------o?----------------oM?X-----------oM-----MBBX-------?B-----BXBX-MMMXBBXX----EBXf
------------XBBBo---------------------BBB------oXM------------------------XXXM--MB---BBB-?X?---------------B?B---------B?XX-------B---BBBB----------------------------------BX-BBB?---------------oXXX-f
-----BX--------------------------------------------?B--------B-----------------------BMB------------B-----------------------B??BM---B----------Mo-----------------------MM--------XBXB---MB--o---------f
----------------XBXXB------XE?X-?XBBM-------MXBX----------BX----BB--o--------------?---M---BB?---------BM--------X?XBB-------MBX------BB--------------------------------XX?--------------------------XXf
m---------------------------o?BMX---------BBB-------------------------M--------------------------------------------------TB--------------------------??B-----------XM----B-------------------??B----XB-X
XX--XX?------------BBBBBM------------------------------B-----------BM----BBXB--oB-----------?MXBXX----------------B----X-B-----------M?-------------BBB---------------------B------XX----------------BXX
XXXXXXXXXXXX-XXX-XXXXXXX|XXXX--XXXX|||XX-XX-XX-|X|XXXXXX-XXX-|XXXXX|XXX-X-XX|XX-X-XXXX-X-XXXX-XXX-X-X|X|XX-|-XX-XX-XX|-|X-X-XXXX-XXX|-X--XX-XX-|XXXX|XXXXX-|XXX-X-XX-|--XXXX-X-XXXXXX--XXX--XXXXX-XXX--X
