o--B--XB--?--X----o-------X------?o----o---------M--M----E-----X------B-----?---?---X--X--X------------------X----X-?---X--X-XX---o-XX-o--?----------X-oX---X-------X--oX----------------Xo----------?--
o------E--XX------o-----E-----------BXB---?--X-----X--X-oE-X------Xo---o-X--o-X?-X----------o---B----X----E--------X---X--oXX------------X-----XX---BE------X-E---?----------------------------?-----EX-
----XX-X---------------B---X-o---M--------XB----------X----M------X----X-Mo---B-----B-----o---X---Xo----BX----X---XX---X----XME------Xo--X------XE-------o------X-----XX-E-----o--oX-B-B-XX--------XX---
--?-B-??--B?-B-------X---XE------o-------M-----X-X--B----Mo-----BX----------B-------?-o------X--X--XE-----M------o-X-M------B----?---------oB-XEM-X-X--?--B---X---XB-----E----------X--XX-----XX-------X
E--Bo-----?--XX-XX--o---MX-------EoB---X-?----------X---------XX---o------------------X?-----B-----XXo----oo----o--M--X-------X-----B----XB------X-------oM----------------------M------X--------o------
-X---------X----Xo--X---X--------o--BXXo----------X----------------X--X--------------X-o-----?-o--------X-X---------?----X----------o-------------o--X------------X--------X------XX--E-XX--X-----------
------?----o-X---E--B-X---o-X-?-o--------E---XXoX----X-----X--o-------B-----------oo------X------X---------X?--X--X----?--oB------X---------M---M--o------o-X--X---X----B---EXX------------E-----X---E--
---X---o-----------o----XX-?--oE-?---X--X-X--B-X----?X---o---X---X-----B---------------oX---?-----X------oE?--------X-------E--------X-X---X----MX----XB---Eo--X-o--X--o-------------------------o-----v
-----------------E-----o---X?B-B-----X-?---o------------------o-E-Xo--BX--X--------oB----------?----X--EX-X----X-XX-B-M--------Bo?---------o----M?----EXX-B---X-----?--------X-------B-??--XB--M-----X-X
?---X-B--B--XE-X?----X-XME-----BXX----X-E-------M------X-X-o--M------------------------o--------------------------XBX------------------o--------------------X-E--E-----------?------M-------E----X-X---?
----o------------oo?B----X-X-------------B-B--------------------B?--o-----X------o----X---B----X------X-----X-X-B---?o-X--------X-Xo----M---X-X--------X-----MX--E----------?------------XX-E--X-------X
--o-----B-X--------------X?--oX------?---BX------?-----E---------?---------o--------X--------E--E---B--X---X---X--------------MX------------------o-X---------M----E-----XXBX-----?-----?--B-X-o-------B
-o-X-----X-------X-----X-oX---------XX-o--?-------X-------B----X--X----------X-------XX----X---X-M-X-B-------X--?---?------X-------------X---?---X-----------E---------------?E-XB--X--X-----XX-----X---
----------X-----X---X------------E-X------X-X---X--o---Eoo-o--------X-B-BX---X-B-------------Xo------X--------X---o--------X-X---------X-o---X---------X----?--E----X----o-----XM-M-B--X-------X-X------
m---------oBo-BX-X-B-------B-------TB-X------|-B-?-E---E-----------|--Bo----o--B--XB----X----------------o----XX-------oX-----XX-----X----o-|-------M----XX-----MX--E---------M-BoX----Bo--|-B------X---
XXXXXXXXXXXXXXXXXXXXXXXXXXXXXXXXXXXXXXXXXXXXXXXXXXXXXXXXXXXXXXXXXXXXXXXXXXXXXXXXXXXXXXXXXXXXXXXXXXXXXXXXXXXXXXXXXXXXXXXXXXXXXXXXXXXXXXXXXXXXXXXXXXXXXXXXXXXXXXXXXXXXXXXXXXXXXXXXXXXXXXXXXXXXXXXXXXXXXXXX
