M--------?-------EX----B-------M-------B-------------T---o---B-B--B----------o---------?----o--------o----B----o-----------------------|---o--o?---------o-o-----------o--B-----B--------T-o---------B--
------oB----o-------------To-------------T--------------------o----B---?--------E----------?------|-B----?---o-E-B-----o--------E-o------------X-----o-----B----B-o-----------------X-----?----X---M-?--
?------|---------------B----M---o-o-?-o----------?----E--|B---------------o------o----X---T---?B-----T------------B------B-----o--B-?----------------?------?E--|-------B---------B--Bo---------------?-
--X-E?B------------B-------------------------EB-----------oTBB-----M----|----B------------------------?|E-E-----------E---------M------B-------E?-------?--?o--B------M--------o----------B------E----o-
----------B---------X-------B-------E-------------|-oo---------oT-----B--------oE----o---T--------|X----?----------------------------?o-------------------?---------E----BX-?-----------------------?---
--B---------------B-----------E--|----?----------B-----------------------------X---?-----o-------|---?----TB-o---------T?-T----?-----------M--?--B---------------M-o--B----------------------------o----
----------B-----?--o------------|-----B----------B-o-------E-B-----B--o------------------------BT-------------X-----X----o------------------------M--------E--E--E----------B---E-----------B--T-E---EM-
----T---E------o-------------E-----B---?----E-----B---------E---------o------|------?------------------|-----?-----------------?---X-----?----------M-------------E-------B----B-------------B---?-----v
-------T------------B-----------------------------------M-o--?B------------X---?----------------B--E------B-----B-----E-------|--------------MEE----o-----BE-------B--o-----T--B-----X---------o--------
---M---?---------------M---------MEB--X--o-B-------------B-------------T-------------B-M-|-----------X----B----o----------T-------------T-----------E------?---?E--B-------T--------X----X-----------|--
-----o---?-----|--------X-E-|---M-----B-----------BoM-M--E------?B-----------------------------------X--------------To-?----o--------------T------------------M---?---|-o-E---E---------T-------o-------
---oE---T-------o-o--?--------------------o----M---------------B-----B-----------o----E-----o-----?---E-----?T----B--E------oo-----E----------B---B---------|-------------B---?------B--M---------------
-------------------------------X----------B-oX-?oT---?-?---o--o-o---E?--MBX----B-B--------B-------------E--------------------|----------oo---------------------------M--------o----------BE--E----------
M---X----?-?----------o---o------------M------?--------|?-----------B----------------------?B-E-|------B---?-----BB---------T------T---------o----T----------X----E------------|--|-----M----------T----
mo--------------E-?---E-----?---B----------T---?---B--------------------o----------------------------?----B-----------------X------o-----------E---B-X---------------B--------E-------------|----X--B---
E--|---------EB-----?-?-----------E----?------?----E-E--EB-------X--T---X---E--------M----?-----------------?-------o---T-o----------TE---------o---|----XT--X---------M-----------|T---X----B----------
