----------------------B?B--ooBo---------XB-BB--?XB----------------------------M-----M-BBMX---------B-----M--------------B----XX-----o------M---B-------B------o-XB------B---o----XoX---------??---------
-----B-B?------------?-----------------?XM-----o--B----BX---------X------------------XB?---BB--o-?--BBM---?---MM--------XX----------X----BB-BBB-------------X-----------------o-MX----------------------
---X-X---X---------BB---------------X--------------------------EXM--Bo-----B---------BBBB-B-----BB-------X-----oB--BX----BBBB------------------------------X-XX--B----------------B----M-----B----------
o---------------------o-----XBB----X---------?--------------------------X-------------M------M-------------------------------X---------o-EBX-------------X---o---------------------------?M-------------
----MXM----o--X?XB-----B--------------X-M-E-----------------MB?----------------MB----------o--X?oX---oMXX-B-----------------BM--B----B-X------------------------?BB---o?--------o-X---B----MBMMX---o----
---------------MXB-----Bo----------------MB------B---M-------M---------------o-X-------o----------------X?---o-------EB------X--X--------X-------------------X--X-------BoB----MM----EB--?---o--B-------
-------------oXXM----o-------------X--------------M-----------B----------?X--Bo--X---------B------o-------------------o-----------?---------?--X--B----------XXX------------B------XB-------X?----------
B------B------BXB---------------------------------------------------o---------------------o------BB--------------M--X----------?----B--BX----?-----------?------o------------------------BB-Bo--------Bv
B???--------------X------------o-XB-----------B-X-XX--X---?--------------?B--X-------B-?X------Bo-----------B-------BX----o?B-----------------?X-------------X???BB---X--XM?B-oX?---?---XX-M-B--------?f
-------------------------------o-o----------?--------X-------o?X---------------------------------M-------------------B----------X-------------??--?----------------E-----------------------------------f
------BB----B-BX----------X---------------X-----B-------BBX-BX----------------XM------------------B------E-B?--------------?XXB-X----M-X-----?B--MX-------BX-?oXM------E-XMB-BB---------------B------BMf
----------------o-------B------------------------------------------------B-----?-MB---?B--------------?--X---?---B--?------------------o----?--------oXX--------------------------------------------E-Bf
--------------B-------------BBM--E-------------------------XXMX--o--?---o--------------------BBBB--------BB--------BXMX---------BB--------------M-X------------XXBX----------------B-------------------f
---------X-------B-----?--------------?----------------------------------------------------XB--------X---------BBBB--------------X-------?---?---BBBM--------------MM--o-------------------------------f
m-----X------o---------X-----o--------B---M---B--B-BB?X----XM-X-------------------------------------------X---------------------------X-----------------------o----------BXX-T---XX---X----------oX----X
-----B--B-------M-------------E--B?-------X-X-M--------BMXX--TB------------------------oo--------------o-----------------------------------X----------B--X-------------------|--------o-------------oX-X
XXXXX-X-X--XXXXX--XXXXXX-XX-X|XX-XXX-XXXXX-XXXXXXX-XX|XXXXXXXXXXXXXX|--XXXXXXXXX-XX-XXXXX--XXXX--XXXXXXX|-X-XX--XXX-XXXXXXXXXXXXXXXX---XXX-|-XXXXX-XXXX-XXXXXX-XXXXXXX-X|XXXXXXXXXXXX-XXX--X--XXXX-XX||-
