o?----o----------XXX------------X-X--?---XX---X--XX-------oB-o-------X--X---?-o-----------X--------X----X--M----B---X------XX--XBoo-------E------------------?MB--------o----XX-Xo-------------------X--
---E---------o-----|-X-X----o-X--------------------X-X-BX--X-M----o---------E--?--B-------?Bo--X----X---------X--X----E----X----?-B--MXM----E-----------------X-o-X--------------|--------o-X----B-E--M-
?X-?XX----B--E-E?-Xo------------X-----XX---------------o-X-------M|--X-----------X---X------------------|--X---o----------X----------M-B-XX?----X-o-E-?---B-----------E-------XX---o-----oBX---o-oX-o-X-
---XEX----X-X---?-X-EX-B----X|--E--M----o?------X-E-------oX-----MX---?---------X-------X-X---------BE-----o-E------M-oX----------|-?--------------o---B----B-B----E---X-Xo----------o-X-------?XB------
------X-XB-----o----o----|E--X-----X-o?--------o---E-X---X--o------------B-----X--|X---?-E-X----o-------X-X-----------E-----X--------o----------Bo-Bo--------XX-|-----------------M-----M-Xo-X-B----BX--
-------X---|o-XEX--o---------X----------X-X------BX-------X----------------XE-------------Xo---oX-----------B----X---------|o-X---X--ME--o------MB-----BX--B----?o--------X-----EX---X--M-oB------|--B--
-------X----B-X--X----------------X--o-X-----Xo---E--?----XX---X-o--X--X----?---oXX?X-?-B?-o---?--------X-----X------B-o--------|-?|------o----o-B-X-XX--M--X---oX?X--B-X--X--------X--------X-B-E---XoT
oo-----|---X-X---XX-oo?|-B-----------------X----------X?---X-Bo-o-E---XBXX---------X-----X------?-------X--------------------BoX---------X-o-------------Bo---X-??-Mo----------|E---o--X-------XXXE-?--v
-M---M------------X------------B---X--------X----o-------M--o---XX--------X--------------------MX---------------|---B-o|----X--M--X--|X-------E-?------XX----o---------------M?-X--------------X-X----oX
-----??-oB--X--X-X-------o--X--B--X-----X---------XE------|--?-----------X----?o--------------------B--B------X----X--XX-----X-X--?------------E?-------X----------X---------o------X---o----B--Xo------
----X-X---o-----B---X--o-------oX-----X--E-o-M----X--?-X-X----B--?---|--BB-?-X--MX----?--EX---o---oE--X|--?-M----X-----B--o-E--X-MX--------XXo-EX---E----------X--E?-----X----------o-X--X-Xo------X-?--
----X-T-X-?M----X----X--------o-------X---?-Xo---B-Mo-------X--X-o----------?------Xo-------------------------M?-X----B--X------E-------B----X---M----X-----B-X?--?-|MoM-X----o-----------------------B-
------|o-------?----B-------------E-------XX----B-X------o-----|-M---o----o-----o--------M-X---o--------------o-|--X-----X----?------X----X--o-X-----XoXX-XX---?-------oX?--------B-----X???|----X----?-
X-----|-o-----XE-----------X---X------|----X-------X--X----?B---X-X---X-T--X----------X-B----?----X--------X|-o----B--o---B--------X-?--oM?-----X--X--X------X-----?-------E---XX----oXB-X--o--X---X----
m-----|XX---------X--Xo--o----X--B--|------XXXB-------X-?-----------X--o|--X----B-X-BX-oB-o-----XE-----o----X?-------X-------?---E------XX---BBBBX----------X-----------XX--|X---E--EXX----M-------?B-XB
XXXXXXXXXXXXXXXXXXXXXXXXXXXXXXXXXXXXXXXXXXXXXXXXXXXXXXXXXXXXXXXXXXXXXXXXXXXXXXXXXXXXXXXXXXXXXXXXXXXXXXXXXXXXXXXXXXXXXXXXXXXXXXXXXXXXXXXXXXXXXXXXXXXXXXXXXXXXXXXXXXXXXXXXXXXXXXXXXXXXXXXXXXXXXXXXXXXXXXXX
