--------o----oo------------?-----------------B---B-----B-------T-----B----o?E--------------E-----oE---------------B-?o----------------------------------------------?-------------B------T--------------
M---?--B------------T-E----------------------?---?-----B----------o------T?---------X-----------------o---M-----X---BM-------o------oo----o-----------|---------------------------M------B--o-----------
---oo-B----------?E------------o---?-T--E--------------------?----------------------B---?------------oM----T-XT-?------------------Bo------Bo------o-B-B------T------------o------E-M-------o------E---B
?----------o------?-?-o----------------------o----?M||--o-o-----------o-E---E------------o------------o-E--?-T-----M-B--E---oE-----------------|-B---------------M----E--E-------E--------|XT---o-------
---------------------------|---M-----B-X----B---M-----X-oX--X---------o---B--T---E--E------o--|--------------X--------------E-oB--------?X--MB-------------B------M------?o------B------o--------B-o-?--
B-----------X----------B-----------E--------o---B------------B-----------------?--------------o-------?--------o-?------B---B------B-------|-?-Eo?--|----------------------T------------------T?E--M----
---E-?-o---o----E--------B-----------EE-------------o---B-------X-----B----------------o-----o-------B----------B--------|o----M-------oB--o---B---X-|-B?----E--B----|--B----X-----------?----------EE-X
o-M---o-o-----------T---------B-o----T----o-------------o----------------?-----------M-------------T----B-T--------------o--o----o-----o------T----|----?----------?-------o-------?o-----------?---o--v
----o----------B----------o----B---|-------------------------o--o--?o------------o--------o-o---------Eo-------B---------------oB------o--------------X-----------------o----------------o--BB-o----o-?-
?-------E--?--------B-----X-o------------------T------B--?T---o----B--------------|--------X---------X------------T-?--o---M-B------------------o-------E---M-o--XB--------o-----------B-------B---B--o-
-----o-|---------T-----------?----?----E----o-----------o----------B?-|-----------T--T-M----------------|----------o---------------o-B----------T--------o---B--o--B-----o-------B?----T----------------
----o--B-------------------B-----E---------------o--X--o?------------------B-----------------?o-----------B---------o-B-----M-----------------------------?------TE-----------o--T---X?-----?-----B-----
--o-ET-------|----E-----T-------------------------?------------E-----?-M-B--B------o--T--?----o-T--?----B------------------B-?---o-----T---?-?--BB--?-MB-----------E------B------------o-------o--------
-------M-o----------B-------B?-T--------?---?---To------?----------------------------------XB-?----------------T----E-----E---o------|------X---?-B---E-|B------------------B------------------o--T-----
mB--Xo---B-?----|------E------------?oX--------------?-----------------------------T--oo-o-----E--T--------BE-------o---o?-M------B---?M--------E-B-------------?--E--------------X--------B---------o--
B------------o-?---o-|------------o-----------B--------------?---E--B-?B-oB----------E------M----M------E--|-----|X-----------o--B-----?Eo|oM----oE---------ET-B----E-------------B--E------B|-M-----?--
