------------------------M-B-X--------------B-------M---|----------------|--------o---------------M----------------------------?-o-------T---------------------X--------?----M-o-----------?-------------
-------X---M-------E-------------------------------?--------B--T--T--------------------E-B-------------?--B-------B----------o---?-----------------------------------?----?---------------E--o----------
------------T--?----------|------B-----------T--------------B----?--??---------------------o--?---------|B-------------------------o-------?-T-------------B------------------M----------|T----B--------
----M-----|------E--------B--B----------------B--B-X------------------?---------------------------T--B-------------B--?o------------X------E--M-?--------------T-----------------------------B---B------
-----|-|--B---------B-|-------------------o----E-------------------EE?--------?-------------o------T--o-------XB----------|----------------------o--X----?---o------------B--|B--?------------------o-?-
E--------?-----B------T--------------o------B-E-?-----o---o----B-B--|-----------------------B---TBM---X-----o?----------?--------------------B-----|----?--B-----------------------o---------o----------
-----M--------T----------o-B----------------BE----o|--o----X---------o--------M-------------?-?|---?-------------E-?-B-M----X-------------o-To------M---------------?-----BM----E-----------------------
-------X---B-----------o-E---B---?---?------|-----------B-------?----------?-------o--X---------B------E-|--B-----oT-----------------------------------------------E-E-----------------B--M-----?---?--v
--oB-?o---M-BE----------B----------------?|----------------------TBo------------------B-o---B----------E----------o-----BE---------o------------------------------o--T---o-?-----?------------oX-----|-E
-------B----------------------B----T---o-------?------T--------M-----X-B-??--o-----?--------E-o--------B---o--X--oo-T--B------|-----------------------------E------------E-B---M------B----------?---o--
------------B--------------B-?-|------E----o-----------M?------M----B-------o---E-----------o?----?---EE-------------o---|--E-B------M--------B---M---------------B------XoE-------------?-----------XX-
-----------B---T--oM--E-B----------------E-----?----------EB---------------E--------o--------------------------o------?-------B-----M--------------?--------------|---T----------B-----------|----------
----------------T-B-----Bo--------------------?-----------T-------------------X-o-o---------B-B--?B--B---X-?Bo---T----o--------------o--EB-------E-----E--?--?BB------M---B-----------o---o-ET--M--o--?-
-------M--------o----?--o---E----Eo----------T---------------B--o----------------??E----------------o-----E---?----E-----B-B-------o-oB?----|---|---?--------------------------?-E--------T-----Bo------
m----E----------X--------------------o--T-----------?---o--------?----------------------------------Eo-----------------------o---oo------?-B----------------|--------B---------------TMEo---------o-|-o-
B-o--Xo---o-------------B---------B----B-----------------------------X---------oE?----T-X---M-X---Bo|M---------------?------------B-----------T---T-o------M----------------E------?-T------------------
