---------?----EB---------o---oX|-------------------------oT-----M---?----B-B----------M|--M-----?|-o---BE-------E-EM-----o--oo----X----o------------------------o---B------?-B-------------B------------
---o------?--XB-------------oT-B------------------E-----------?---T-----M--?---M-oo|-----B--?-----------BB-----?---EB--?---------o--X-------?---X----E-----o------E---------------o-------------|-------
---o-----------------o-------X---o------------o-B--------------E---o----ooB----X|-----ME-------B---------M--o--oT-EB--o-----o-?--M----|--------|-----------BE--?----------B------------------o---M------
---Bo----M---------|-----M-------E--|-E-?------------------o---To-----|--X--------|---o---------------------------B----T--------T--------------?--------------------E----------------E---------E----B---
--?-?---?-o---?--o-E-------E----EB-------B|---B-------B------------------------o-M--T----E----o?-o----B-------?--------------------------------B--|M-----B---BE-----M-------X---------------------------
-o-------|-B------------?--o-M--EB-E--------------------------------T-----o---B---BM------|--------------E------B-----M-----o-X-------|-?------------?--Eo---------E-----------------------------------B
-o-B----------E---B-|-T--E-----o--M---------------o---o---------------TB-T---------T-B--------E--T--------?---B-X-?----?----------T--------------------o------o-?-------X-B--?---------o-?---------M----
o-----------|--------B----?--B-M-|----E----EM-M----E-----B---T-------?---?--M----o-------------------------E--o--E--------oB---E----o---------------o-----o------X-----------o----Eo-------|M---------Ev
----T--B--------T------E---B----T-----------o-B--------M---E------------|E--------?o-----B------------------B---o--------------B--E----E--B-B-----X-----------------------M|oB-----|---?---|------------
-E-----------------?--------B-----B-------------T--T--------------?-------T--M----?------------o----------------M---------M---------------------oo----?-B-----E---E---------?----X-------?-|---------T--
-?--?-----------X-??-T-----------o----E-----o---------------------------E------B----------B-----EB----o--B-------o-----------?E-----?-------------|--------------------------------------------------o--
----T-------T--------------------------X------------------MB-----T----------------------------M-o----oE----------------T------B------------------B-------------------------B------M-------o---o---------
--B-----M----o-------B|-E----XB------------|----------o-Eo-M-----------E---B----------------?--------B---------o--o--------B-oB-|------------------o----X-----------B--B?-----B------?--X---o-----TB----
--?---TB----------E--------E-----------o------------||-E---------------------?-----------------?--X-----------------ooo-o-----------------o----M--oE-------o-----|-------Eo-----EM|------E?------o-BE||-
m-T-X---To----X----o----B--B----o-----------|---o---B--E-----E--EM------------------------o-----o-------B----?----|--T-o---X?-E-----|--|----------oX-------M-T------?-B----B--------?-------?-----T-----
XXXXXXXXXXXXXXXXXXXXXXXXXXXXXXXXXXXXXXXXXXXXXXXXXXXXXXXXXXXXXXXXXXXXXXXXXXXXXXXXXXXXXXXXXXXXXXXXXXXXXXXXXXXXXXXXXXXXXXXXXXXXXXXXXXXXXXXXXXXXXXXXXXXXXXXXXXXXXXXXXXXXXXXXXXXXXXXXXXXXXXXXXXXXXXXXXXXXXXXX
