--------------------------------X?XB---------------------------------XB----------XB-------------XX--o-----------------EX-----------BM-------------------oE-------------XB?BBBXB-----X-------------oE?X--
------oX-??X?----------------------X---XMBBX-------B------------XB------??----X--XXB------E--------------------oB?-----Bo---------o--------B-----------B----BX--X------------------------EBBB-----------
MB--------X-MX-------E?X--------------------------------EB--------------------o?-----oXX------------o------?-B-------------B----------MX-X-------BXBBB---------------------------------------?----B-----
----oX---------------?XB-BBM---------------------o-BMXMB---------o----------B---XB-XXB--------X--??-------X-------XX-----X-------------X--E---B?-oX--X----------B-----B---XX--B--------oB?XXB------o----
----------------------------------Moo?---o?--B---o----------------------B-----?-----MBB-----o-X--------------oBB----M--XB-------?-BB-MB---------------------------------XX----?----------oX-------------
-------B?B------BBB--------o---MXXX-----M-------------BXB-B------XB?M--------BX??-------MXXB-----------------MXX------------------------------------BEXXXXB--B?BB----XMB-----B------MXMB?BBX---XB?XB----
------------------------XB------M--------------B---------------------B-------oX---X------??---------M------o----X-B----------X----------E----oXBBBX----------XXB--MX-BB--oBBBX-------BB-----------------
----------MB-------------BBBBBX?-----------------EB?B-------------------------ME------------?BXBB----XXBBB-----?B------------------------------MBB?--?---XBB---------?-?XB-----------------o------MBBBBv
XM----------------------M----------------X?B--------XXXB--------------oB?-------BMXXX-------------B--?X----MX?---M--X-XB------------------BB?MX----XXMXB---?-------------XM---------------X----oXBX----f
---------------------o?---M-------------?-B?M----XBX----X-----------XBBX--M-------oX------------X--X----------------X---------------------------------------XMBB------BXBBXMBX-MMBB-----------XBB------f
------XMX------XX---------oX?--BXB------------------------------M----X-------oMM?BBB---------B?BXX-----------------------XXBXB--------------------------XXB--------?BB---------------------------------f
-----------------X---------------------------o-----------------B---------------BXXX------?X-B-------------XXMBBX-----BX?--------o-----------------B----------------B?---------------------BB----------Xf
---------B--------------------------------------B??X------------------X?X-BXBBX-----B-----------?-----o?B----B--------------------------M-----------------------------XB----------XB-------------------f
-----EX--X--B--M----MXB-------------------------B-----------XX-------?BXXB--------------------XBB-----------XBXXXX----------------XBXBBB--------BB--------??-----------------BB--?BX---------------BX--f
m----TM-B-------------------------------------XB-o-?MBXB-------XoB?-----------B------------------------?------------------------------X---MMBB----------B----?---------------------BBB---M----------?BXX
-----|XB----------------?--o-XX------------X---MBXX----oB------?BXTXXB----BB--X-------------------------------BX----------BBX--XB-X----------BB?X----M?MX-------BXB--o---BX----XXX--------------------BX
XX-XX-XXX-X-XXXXXXXX--XXXXX--|XXXX--XX|XXXXX-X-XX--X-X-X-XXX-XXXXXXXXXXX-XXXXXXXXX|-X-XXXX-XXXXXXXXX--XXX|-XX--XX--XXXX--X|X-XX--XXX-X-|-XXXXXXXX--XXXXXX|X-XX--XX-X|X-XXX-XXXXXX-XXXXXXX-XXXXXXX--XXXXX
