---Bo----------------o--------EME----X-----------------E--X--B------------------------o-M---B------|--------E-o---------------B-o-E------|-?--------------B-------o--------------------------B-------ooE
--X-------------------------M------------?------------o-B?-E------X----|-------o----------o-----M-----o-------B----E--X---------?----------------?-------------|----------------B-----B--?-------------|
------|--------?-B-----T----------------|-?B--B----o-E---------M---?----B---B----------------------|------------M---B-------------------T---------------X----------o-------------E---o----B-----|-------
---------X-------B-|--?--?------?--------------M--|----|-------------B-?--------------------------?----B-----------T--------X-|-------?--o----------XM-----?-------X------B------------E----------------
----------TB------------B------------B-------------------B------E-----B-----B----------Xo-----B---------E-----B------E---B----M-----------?----------------------o--?--?E--------o-----o-B---B-----E-X--
--T-------?--------E---E--o------------------------------?---B-----------?-o------------------o-T-------------------X-----------o----E?-o--------o-----?----M----EB---?-o-B----E-B------------o---B-----
-------------------------?-----------------------B--E-------oB-----------E-----|------?-------E-oM----------------X--o----------------?-o------------X---Mo--B?-X?-----------T------B--?---X-X--?E-----o
---------o-o-------B--|--E-------------------------------------B----Eo-------T---o-E----o---------B-B--?-E--T-----T----------------M-------------------------B-----------|-E------?-----X-----o--------v
--BE--------o----------------------------o--------------------------------------o-?-X--------------?---------E---------------B----T-----|----E-------------------?-------BB------------B----------o-----
-------T-o----------------E---M-X----?--B-T--BM---B-----------B-?------|----------|-?------------------------?----oE---B-B----T--------E--X------------------B---------E-----------TT-----X-?--BT-------
B-?-B-----T-----E-------B-----o---------o--------T-------|---------------o--?----M---?------B---M-|------X--------------T---B--T-E---T|----o-o----B----------?--M------T-------------------E------o-----
?------o---o--??--------------------X--B--------------------o-------------------------B-------?----------o---B---B------|----B-B-------o-|---|BM---M--M-----?-------B-X--E-----?----B-----B----o-E--?---
-B--B-o--E-?-----o-------------B----------?--------?B--------------B--?-o--------------------o-------E------T--------------------?-------?-----------------X-----------------------?----X---B-M---------
--T-o---B------T-B------BE-E--------o----------B---|--X----o?-o------BB-oo------M---B-?-------oB---o--------?------------o-o-?-B-----M---------B-------?---------T-o--------o--o--M---E-|---Mo--o--E-o-B
m----?M---B------B---------?-------------M------EX---------|------o------------|-----------?-----------E-------|------B---------?------------B--B----B----X--------------------------------E-o--M--o----
-----E-B--o-------B--o-------------------T--------------o-X-----?-B---?---o-----o-------E-----------------------B--o--|-----------o--------o---------?-o----------?---------------------E?-----E-----B--
