--------------------------------BM-----------------------------------??----------o--------------X---B-----XB-?MB?------BX---------------------------------------------------BXX-------------------------
------oBBBBBB----------------------XBB-XXBB--------------------XB------------------------B---------------------B?X-MMMX--M---BBB--B---X----------MXBMXB??X-------XM------BX?--B-------------------------
MBB-------B?M--------E-------------------------M-----?B-----------------B-X-------oB---------?B-----------BX--------------------BBB------------------X----------------------oXXB---------------MX-B-EBB-
----??M--------XX---------M--------oB--------------------------------o---------------------o--o--EX--X----X--------------------BB-Mo-B-BX?MM------------X------------------B---------?-o--------?-------
---------------------------------------------------?X--------BBB----BB----B----------------BX------------XXX--------X--------XB----BBB-??-------------MM-X?oM---------------?-----------------------BMB-
-------B--------?X---------MBMMM?-------X?------------B?--B?--------?-B--------BB--?----B---------oM-X---------------------------------------o------XM--------BB-B-X-------------------XX------XXXBB?---
------------------------XBX?XX--BB-------------o---------------------o-------?XM--BB-----BB---------XB-----BX---B-B----------XM---------EBX--X-MBBB------------X--------MBB--B-?X-----------------------
------o------o--------E----M---BB--------------------------B----------BMX-------M--------------------------------o---------------E-----------------X-----EBM------------EXX-----------XX-------B-------v
XB----------------------MX---------------MBB--------BM----------------??--------XMBXXMB--------------------------X--------------------------B-----------------B-XXMB----------------B-----BMXo-XBB-----f
---------------------------------BBoX?------------------XB----------BBX---o-------o-------------B--XMB--------------XX------------------------------------oXM---XB----XXX--XX-B----?-------------------f
------BBX------X?BBMBB----oX??-oBB------------------------BX-B----------------------o----X-----o?-BB--------?XM---B??B----------------------------------XX-?-------BMBB-----------------------oX--?----f
-----------------BB--------------------------o-----------------------------------X----------X------o-X------------X-----E?----X-------------------------------------------------------XXo-X------------f
---------BBB?-----------------------------------X---------------------B-X-XX-EB-----E?XX-----------------------------------------BB-----------X----------------??-B------------M----E-------XBX--------f
-----XX--XX-B--X?---?X--------------------------BB----------XXBX-----XBXX?X-------------------XBB-----------oM-BBXB---------------BMBBB----------------------XM-B----------------BM-------X----o-------f
m----TB-MXX-----------------------------------BB-oBBBM---------??MB-----------X--------------------B-------------?BXoXM-o---------X---------------------B----BX-----o---------------------------------XX
-----B------------------BX?o-B-------------B---B-------oXB-----BB-T?------MBXMBXB-----------------------------??----------BX---E?Bo---XXT--??--X?MM----?--X-XMX------------------oB------------------B-X
XX-XX-XXX-X-XXXXXXXX--XXXXX--|XXXX--XX|XXXXX-X-XX--X-X-X-XXX-XXXXXXXXXXX-XXXXXXXXX|-X-XXXX-XXXXXXXXX--XXX|-XX--XX--XXXX--X|X-XX--XXX-X-|-XXXXXXXX--XXXXXX|X-XX--XX-X|X-XXX-XXXXXX-XXXXXXX-XXXXXXX--XXXXX
