---------?B-BX---------------------------------X-------o----------------------------X---X-M---------------BB-----------------X----------------B-----B-B-----BX-??----o---------------------------EBX----
---------o--BB------------------------M-----------------------------o--------------M-M?---------E------------?---XB-M------------XXBB--------------o-----M-B------------?X----E?------------------------
----------------B--o--------XB----B--------------------o-X?-BB--------?o------------X-EX----------oBX---E-B------?B-------------------?-----------X---X----------BX----?----M---BBB--------B-------XXB--
---BBXBXB?----?-----------------BBB----B----------------EB-------------?---------BB----------------------------------------X----------------M------------------------M-----o---------------XX-----------
--------------------------o------------o?BM----------o-------------B-----------------?------------o--------------------------Xo---------XBBB--?Xo-----------------------------B-------BX?XB-X-----------
------------------------BBBX------------------MXXXXBX---------------XoBBBXBXB-----XB-B------------XBXBX-----BXXB-----------X--------B-----oX?-----oo----------------XX-----------------------BB-EX------
--?BBBBoBB--------??---------------X-B-------------BM-X-o----------BBE-----o-------------M----------?----B-XB-----?M----B---------BMBBB-------?B--?B-BB-------o---BM--?X?X-------------B-BXM?X-o-------B
--------------------o-------------------oBB-----?X---oBB------MXB------o-EBM----------------------B??------?-----X---------------o-------------------------------------------------------------o-------v
----------------------------------BB-XXX--B-----------XB--------B-----o---X-----------------XXB---------------------MBB--------XX--X------------?B--------B---------XM--B--?-------------------------?-f
B-----------M------?X---------M--X-----------------------------------------------X---------------------------------B?---?------------------------------------XBB----------BB--------------------X-----Xf
-------------------XBX-------------------B-----------o--------XX---------B--------------------------------XBB-XB----------M------E--------------?--BB--BB-?B---XM----XMB-M---o-------------------------f
--------XX------------XBM-------o?B------o-----B?---B-------??------E---MB--------------------??-----M---XB-------B----o-----------?X--------M-----B----?------------o----B?--E-------X-----------BX-M-f
------B-------E------o-----E----B-----------XM--------------------------------------------------MMo----o-----------X-----------?B-----?----------------E-X--------------MB-----------oBX------XXB------f
-----BBBB-------o---------------?X-----B--------B------------------------------BX-----B---------B-B------?-----------------X--XM----------o-------------BB--X-------MM---o-B------E----------------X---f
m----------T-------------M----X----B----TBX------o--------X-MBB----X-?---??MB---------?-X--------B----------B--B-?X---XB--E---------B-----X--------------T?--?-----B-------B-?----?--X---------o------BX
--E---?--oX|B----?-------------MBB?-----|-X----------------oM---------------M--M---EoB------?-T---T---------------------------------MX-----M--o----------|MBX--o-----------------?---------------------X
XX-X|XXXXX-XXXXX-XX-XXXXX|XXX-XXXXX-XXXXXXXXXX-XXX-X-X--XXXX-X-XXXX-XXXX---XXXXXX-|XXXXXXXXXXXX-XX-XX-X-X|X-X-XXXXXX-X-XX--X-X----XXXX--XX-XXXXX-XXXXXXX-X-XXXXX-XXXXXXXX-X-XXXXXXXXXXXXXXXXXXXX|XXX--X-
