-------------B-?-----------?---------BB--------oX-------------o-oBM------E---X-E---------B-o-o-B------X---------X---X-----------------X--M------E---?----X--------------M-X-o--E---o-----o-----X-----ooX
---B--------o---B------------------M-----X----E---------------M------o---X----------------------oXo----XM--BE-----------------------------o----o---B-o------B---------B--X--o-o---MX--EB----------------
--------------------X-?----X-X-M-----BooX----------?----o---X-----------?--X-----------------X---------E-X--E------B-------------------E--------------B-------B----------X----?----------o-----?------o-
----------?----o--M----------E-E---X-----X------B---X--E---------X------o--XB-E--o------E------------------BB------X-ME----------Eo-----o----E--------X-----o-----------------------?-X--------E--------
--------------MX--X------B---------o------M---------XXoB------X-----o------EE------B----o------------------------B---M---?-------o-E--?X-oo--BB?-E----o---o-X--?-------X-?----M----M--------------E--M-E
---X--------------M------------o-------------o-------B----------B-X--------o----------?--------X-o---------X-o-----X----o---------------?------o?--B-----------X---oX--------X------XX-B--------B---E---
-----?--B----B---X----o----X--------?-----------o-?-X--X-X---------------B----------X---E------------X-B-------XXE-XEXX---?------o--------BB--------X-----------E--o--X---X----X-o-------B------------oB
-X----------B---E--o--B----------------X?-----?----------X-----o---E-----X----X----X----?---------------------X------------------EB--EX-------B--o--B--E------M--X-B--------E-B-----?---X-E-?-B-------Xv
--B---X----------o-XoE--o------------o----X----?-------B-oo------B---------o----B----------X----B------E--B------oE-----?-------E-----?-----------B------E-------X----------X-X------B----o-E----E-M-B--
-M----B?--E--M-X------?B-----------X-----?---X---------X-------X---E---------E---------o---------M-?E-----------o------------M--------------o-----M---XE--------EEE-------B-?----E------EE--------------
-----XM-----X-------o--E--B----X--EB-------X--------------------------oo---------------?---------X--?-------XXo-B--------B-----------------------------o----------E-------M-M------------o--------------
-----X------X--E----B--------------o-o------XE--EX------X----oM-o--------B--------X-------E------------------B-----?-------------Xo---------B--B-------B---X--X-MX---X----oB---------BE--E-oE-X--B----o-
--------------------E--B---?o---------E------o-------------------X--X--?------Xo?--o---X-----------------------------------E---------X------B----------------------------?-----E-----E?-----E----B----B-
------T-----T---T--EE-XXoTTTEBT---ToB-X--o--E---T--oTT-T----T-T------T-T-TT-X-Xo-TT-T-----T----T---T--T--ToEE------oXB-------------EBX--T--X--T-X-X-------T---B-?----T----T-TE-E--------o------oTT----T-
m-----|----E|-o-|----oX--|||M-|---|--X------B--?|---||-|Xo--|-|o-----|-|-||------||-|X----|--X-|---|--|-B|EE---------E------o------o--o?|--?--|----XB---?-|------B---|X---|-|-X-----------------||----|-
XXXXXXXXXXXXXXXXXXXXXXXXXXXXXXXXXXXXXXXXXXXXXXXXXXXXXXXXXXXXXXXXXXXXXXXXXXXXXXXXXXXXXXXXXXXXXXXXXXXXXXXXXXXXXXXXXXXXXXXXXXXXXXXXXXXXXXXXXXXXXXXXXXXXXXXXXXXXXXXXXXXXXXXXXXXXXXXXXXXXXXXXXXXXXXXXXXXXXXXX
