--------------------------------------------o--------B?-------X?o?B------------BX--X?X---BX--X-------?---------BX------------BBo---------------MXBXBB-BBBBB----------------------XBB--------------------
--?XX?X----E----------------------???------------------oBM--------------MB----------------XBXXBBBB-------------------------MX---------EXBBBB------------BX----------------------B??----B-B-----M--X?BBX-
--------oB-----BXXB-BM-----------BXB-------------------B-------XB?B-BXX--------------B--------------B--BMBX?-----------BB---------------------BBB----------------oX--------------------?MX--------------
---------BB----X-------B----------MM--------?BXB--------------B--XXBE------------XBX----------X---------------------------------------------BoM--BBXX---o??BX--XB-----?B---BB----------------BEX--------
-X---BBB---------------------------------B?B--------XXXBB--MBX---------o-----------------------------X---XB----B-------o-----BB------------XXB----------------XX---------?MB----------------------------
-------BB-----B?B---------------?-------?----------BX-----------------?B---o------------oX------------------------MBB---BX------?X---BX?---------------------oBB--------------X-------BB?B-BBBBBXX--oXB-
--XBXXBBX--------------------------XX----oMXXB------oBB---BBo--------------M------BXBB-XX-------XBX---BBBB----XXBMXX-------XBo--X--------------------------?B----------------MM??-------B---------------
---M--------------------BB-----?B--?XB--B?M------------BB--XXB-----------?------------B?---BB---XBB----------XXX-----------------------B???---------------------?B-------------------------------------v
--BXBB-----?X?--------B-------------XB----------XBBX-------------E?--------------?oXX---------BB?--BXB------------------------------X---X--------------------BM----------?---------?B---B--------------f
o-----MBX?--------------B-----B------X-----M-----o--------------oXM-----------------------BXB------?B------------BBXX----B-----------------------XX---B---------------------------XXB-----------?BXBM--f
----X---XXBBX?B----B------BX--B?X----?X-----------M-----------------BX----------BXX?-E-BM---------------------------------------?XXMB---X----B?MMBX-------------?B---BB--------------M------oB----XXMBMf
-BMB-------------BX?B------------XXB------------?BBX--B----BBXX--------------------------oB---------------------------------------------E-----B----------------------------------------o---------------f
-----------XMBM--------?B-------------------------------?BX---?M------?BB------MBB--------------------------MBXXX-----------XM--------?B-------------------------?----B--oX--?XMMB----------oB---XXXBM-f
-------------oXXX----XBBM----------------?X-TXXX----------XX---EX??-----TX--------------XB----------o?-------------------XBB?B----------T----MXX--XXXXB------------------------BXX-------------B-------f
m----XX-X-TMM------XBB------XX---MBMTX------X?B----X----X--BX??B------M-----------T------XB---M--?-------TBB------------BB?BB---TB-BBMB-|oXB?------T--oTXBB-?o-TB----XXBBBM---------?B?MM----T-------X-X
X-MB?BBBXXXXXX-XXXMMXXXXBXX-B?XXX?BX|BXXXBBXXXXXXXXBX?MXXXXXXXX-XXXXXXX-XB--?X---BB-XXXXXXXX-XXXXX?XBXXXXXXXXXX?XXXXXXXXXXX---??XXXXBBMB---XXXXMB?B?BBBXXXX-XXX|?XX--?B-XXXXXXXXXX-BXXXXXXXXXXXXXX-MBBXX
