-oB----X-----------?B-------E---?----X--------?-------------XX-----E-o----X----------E---------------------M----E-------------------o-B------X---X------------------------B------XM-----------X------?X-
X-----T--------XX--------B----------------XB----o-----X--B--?-XXo-X--X-----B---------oE-------M----X-XX-?X---X--------X--oEE--X--X----X--X--?---XX?--X--X------------X--------B---X-o-X-X-o-o--X-X--Bo--
--XM--|-----X--oM--------------oE--X-X--B-X-X---Xo----B-----X----------EX-------------o--------E---X--X--o----X----oo-E-----XX-E----o-X?---------X-B------o----E----X--X---o----B-----X--X-MX-X-X----M--
----X-|-XX-X-?---?-E--?--------?-E---o?MXXB---------X----XB-B--------?X--Mo-X-----------X---?----X--X--------E------o--?-X-B??--o-----X---o--?o-X--X-X---------X-----X-X--X-X-----X-o---?------o----X-X-
X--o--|--o?XMXX--o------o---o-----X--X------X------X---------X--X-BEX----o--X----------------o-X-E------B----E--X---X--M-----o-E-----X------X-B--o??---B---B--o-X---X--X-o----------B--------X-----X-o--
--B?--|--o------BB----E-------X--o---------o----EXM-o------M--------o--M---X------X-------X-------------?-----XB--X-E-------EX---------B---------------o-?-------X-----E-----?X-X-X----XX--B------o--?X-
------|-E--XX------X--------X----o-XB-B?E----E------E---E------X--o--X------M-X-BXo-----?-----X-X-X------X---------E---B-B----------M------BXX------X-?----------X------X-?---X---------------?----?----
--X-o-|-----X-----XX------?-o---B-X-XX---------o----X-BE------M--------XXX-----------------------X-X---X-MX----X----X-----E-X----?-XX---------B------X----------B------------------------------B-------v
-X--M?|-X-XE--o-X-----?--E---X--------------XoX-o--X----B------XB?-E--E------X--XMo----oE-XX-B------X-EoE-X---X-X---?--BX-----?o----BX--XX-?-------------B-X-----------------X-----B--X-o---B----------o
Xo---o|--------B-----X---X-X-B--o--?--E---?---------o------M-X-------B?-X-X--B----o-B-------X-----------XE---------MB-X--o----X------------X---------------E--o--X--X--XM---------X-X-----BBB-XB---XXX--
----B-|---X-----B---B------------B-----o----------------B----------XXX--M------------X-XX--E--XooX---X----------X------E-------X-?o---B-E-----o---X----XXXX---B----X-B---B----------?-X--X--M------X-X--
------|?------E-X-------E-B-X-------------------E-X---------B--o----M-o----B-?--------X-----B------?---X-B-XoE--XEX-XB-------o-------------XB---------------------EX-------X-?X-X--------------B-o------
-X----|X-T-----------E-------X----X-----B---X-EX-----X-----o---X-----X-----X------B-X--------M-----------X--X-----X---X-X-X-----X?----------XX----oX---XEM?------------B----o-----X-X-------------XX-EX-
-X----|-X|---------B--o-------o-B---------X--?---X--o--o?----X-B-------------o--o-Xo-X------o------Xo----------X?--T--o----?----E-----E----TXX---X---?E-----M--X---?---------X---?--oE-o-X-B--o--------o
m-----|--|----XE-----X--B--------------X-X-X-X---o-B----Xo--X-------X---------X------------X-B--?-o--X?------X--?--|----X-o---XMT--?-------|------------X-?--X---X--oo------B-------oB----?---?--X----?-
XXXXXXXXXXXXXXXXXXXXXXXXXXXXXXXXXXXXXXXXXXXXXXXXXXXXXXXXXXXXXXXXXXXXXXXXXXXXXXXXXXXXXXXXXXXXXXXXXXXXXXXXXXXXXXXXXXXXXXXXXXXXXXXXXXXXXXXXXXXXXXXXXXXXXXXXXXXXXXXXXXXXXXXXXXXXXXXXXXXXXXXXXXXXXXXXXXXXXXXX
