-E--TXE-------XMX-T-?--X-M--o-X----XoEXX---------X-----------------X-X------E---X---X---------|----B----?--------X---oB------E-X-X------XX?--XoE---oo-E---|-X-------o------o---X----X--------------?----
---XE---o--B--X--------------X-E-----X----X-----X---B--|-------X----X--X-----------BTB------T-----o------|-X-XX-X-X------X--o---M----X-o-?E-----X----B---------o-oXX--o-o----------Xo--oo-B---|-----X---
--o--E-Xo---B--X--------------T----X---?X------------o--|-XXEE---------------Eo--T---XX---o-?----o--X----XX-o---------XX--------E----X--------XX---?E--XoT----X-X--B-------X?------------E-X-X----------
?---B--X-o--B--B---XX--------------X---o------M---XX?---TM--X----B-?-oo-Eo--B-oo?-------------XE---?-------X----------X--XX--T-X-X--X-------X--B-T---o-----M--X-E----T-oX-X------------X------o--X-X---B
E-oo--o--Xo--MX---B----------X------X----B---?-T-------X------o-------XT-----EE-----TX----XM-o--X-E----E----X--XX--?---|----E---X--XB------------Eo----o-X--X-X--o-XB--X---oX---MX--X-XXXB---M-o----o--X
--------o-----X---|-X--?B----X-oo--oXB-o------o--BM------------X-------------X--------B----oX----X------------B---o----B------------------TM----E-o-B-------------X--X-X------X-?--oX--X-------------X--
?-----------X--M--------X-|------B---E----X---M---?----o------------X-----?EX---E--X?-E--B--X--BE--------?o----X--X-X|X--XB-----X--X-B----?------B--o|-----X--XX-X----M-oX--B---------X-B---------------
------o?-----B--M---|oX-X-------o----M-B--o--X-X-------E--------E-X--X-----X-o--X----o----Xo--X-BX--------?Xo-X--o-X-E---XB-o--------X-E---B-----B--XE-------------------X-XT-----B-BX--oX-----X-XE----v
---------?----T-o-X-|EX------X------oX------o-----?--EX---o-------B-X--------XX-?----X---E-|-----?---X-X----------B--?--X--------|o-B--XX-----------X---XX-----B-X-o--|--?-X-?M------------E---X-B------
---X-----X--------X---------EX------|--o--X--X---o--X--X-------X--|--X------X-EX---X-|X----X--X--------B---E--------XE--------B-B---o---X----o-------?----XE-------XX-Xo---------X----X------Xo--X--o-E-
-XT---X----B|-B-------oB----E--X|-X---o----?---------X-XX-o----BooBE----X--?---XB--oX------o---------?----o--o----X-----BX-----------XX-----X----E-X-BX---E---X--------B-X--B--X-----X-------E---T-X---X
--X---B--------B-----------X-----?X----T---o--B-B-----?--X--o-X-----?o-------------------T-------B-|---o--T-X-X--?-------oT----B---oX-B---XM-X-XXX?---XX-B?-oX-----------|---XE-X--X------MXX-X-|XXX----
--X----------------o--o-----------XX--B-----------o--------X---E?------oE---X----X---|-o-B---oB-o----M--?-M--?---o--o-|BX-------X--EXX-B----XX---X--o----B----oM--X--X-B|---|-XX--------------------M---
-----XM----------E--X----o-----X----X-X----X-o-oX-----------X------X---X----X--o-----o---|--B----X-----BBE---X-X-------X---X-XX--X---------o----------X----------X--E-----|---XX------B--T----XX--------
mE|------X-XEX----XM----------B-----o-B---X|o-------X--X----X-?E---X---X-TXX----X-----o-X--------o----M--T-X-----oX---?----XX-XoXoXX---oX----X----?---------X----B-X----------o----------B----?----o--XB
XXXXXXXXXXXXXXXXXXXXXXXXXXXXXXXXXXXXXXXXXXXXXXXXXXXXXXXXXXXXXXXXXXXXXXXXXXXXXXXXXXXXXXXXXXXXXXXXXXXXXXXXXXXXXXXXXXXXXXXXXXXXXXXXXXXXXXXXXXXXXXXXXXXXXXXXXXXXXXXXXXXXXXXXXXXXXXXXXXXXXXXXXXXXXXXXXXXXXXXX
