------------------XB--E---------------------------M?-------oXB--------X--------Boo----------B---------EX--------------------?M---BB----------------------XB----X--------------------------BBB-----------
----------XXX-X----------------------------------------M----------------XB---------B------BB?XBX?----B----oXXBBBBX------------------BB??-------BX------B----------oXXXBB------------XBMB-?M?------------
E-----?B-BX-o-------oXM------------------------------------------E-XB----------------------------------------------------oB--X----------------------BB--?BB----------------MX----?XXBX------------------
BXB---?X----------XB---XB------------------X--B-------BX?X--XXXX--X---------???----------------M-MB------B--------------XX------------------XXMMX---------B--------B----E-----oBBB----------------------
---------------?BB-MX-------MXM---------o---------------------------------BB-------------------MB-X--------------?--------------MBB----------------B--------------------------BB-------------o?-MX??X---
--------BX--BBXBX---X-BBB------------BX?XXXBB-MMBBXB----------B?B---BBB?B----BX?-------------------------------------------------------MMBBBBX?XX-----BBXBB------?M--------------------oBX---M?---?XXB--
----------?--------BX--XM---------BX-----------------------?X-----------MBB---------B-----------------oMBX-----??---BB----BB-----B?XM-----------------MBB-------XBX-----o--------X-B?XX--------------XB-
B-------------B------------BX---------------X------XBXX-----B----------------------X-----BB-----BBBMB-----------BBX--XBB-------X-----B?--------------------------------------XXB-----------------------v
-------M?X--------?XBX--BM----XXMX?-oXM------X??X-BBB----M-B?B-----------------?-X------?XX?X----------------BB------------------------------------------X---?B------BX?BB?BBB-----------XBBXX---------f
----------E-------------------------------------XBB-B---BB--------BX--XB---------------------------E?BBXB----o------------oX?-BB?-------BB---?----------BB------BB-?--XB---------XB----------------XB--f
-----B-BBB-MBBMXB--BB----------------------------------X--------------------XBXXB----------------M?M-------?B------------BXX---??BX-------------XXX?X--BBBBB--------------XBX--XB-XB?X-BB----X------X--f
-------------------o-B--BX-----------B------BB------------------------BX?XXB----XX?------------XBXX-o---E------X?X------------------X-------BM---oX----------oBX--------------?---------------BX--BB?MXf
-------BB-----B---------X------------XM-BB-----------------XB-BBX----BX?---------------XX---BB-------BBB-----------------------------BBB----------------------BB---BBB?---XX---------M?X---------------f
--------XX?---------X---BB--------??-XB----o---------------BM-B----MB--BB-------------BBM--XXXBX------B?B----X-?---B-B??---------XBB---BBMo-?XM--BEBB-----------BBM----------BXB--B?XM----------B------f
m--------?B--?B------?B?--?---------------MBM-----------MXBBX-------BX-----XX-M?----------MMXX?----------------------------------BXX--BBX-------?BX--XXX?-----------------E-BBBM----------M--X---------X
B---X----------------------?---------------B------??o----MX??----------------B--?XXXM----------------------B-------------MB-----------------B--------?X----XB---------------?M-------?X------X---------X
XXXXX-X-X--XXXXX--XXXXXX-XX-X|XX-XXX-XXXXX-XXXXXXX-XX|XXXXXXXXXXXXXX|--XXXXXXXXX-XX-XXXXX--XXXX--XXXXXXX|-X-XX--XXX-XXXXXXXXXXXXXXXX---XXX-|-XXXXX-XXXX-XXXXXX-XXXXXXX-X|XXXXXXXXXXXX-XXX--X--XXXX-XX||-
