M---E---X--X-BX--X-XX----B|X-----XoB-X----X------------o-X--X------?X----------B--X-B----o-?B-oM--?--------------o-XX-E-----?X----------?-------X-----o----X-o-o---------E--X-o--------------------XX|--
-X----T-----------X-Xo------?M-B---X--Eo-X-----------X-X----o--X-?-----o---E-oX-------oB--X--X----------X----EX--------X---MX----?-X------o-----E---X--------X-----E--?--X------X-E-T-------X--------B|-
---B--|-X----------M-BXX-X-----X------?-----E-o----M-XoooX----Xo----BE----o-X---E-----BX------BX|X--------X--------oXE--B---?|--E-X--------BX----o-X-|----BX----|---X-----XXXXM-X-?||B-XEo--XB--X----X--
----X-|----M-----o-------X--M-X----X------XX----T-------B--X-E-E--------XE--X---E-XBX---XEB----?---?----?----o----B--E-----------E------o---|--?B---------o-----MB-B---Bo--E--Bo--o-|------o------------
|----M|-----EB--o-BM---------o------------BX-Xo-|EX-B---X----B--?----o--------?--------------|-X--XX-X--X----------E--------X----o---XE-----------E------------------Xoo--?o-?---?-o|--X-X?-------?---o-
--XB--|----X-Bo----------?--X-M-B---------M--X--B--B-X-----?-X-X-XE-----o---|----|----X|-----------BEB-o--BX-------X-------B---MoXX--oo-----X---B-X-------E--Xo-o----B-----------??-|---EX-o-o-B--B----X
----X-|-EX------XE----B-E---X--E------oX---E-------------------B--XXBX----o----X-B----M-X--o-B-----X?BE---o----B--X--X--BoX------X-------E-EX-XX-X---X-X--------XX------X----?----B?|----o----X--oE----B
-----X|X--oX------------M---X---B-o-E--X-B--B--X----------XXo----B-o--B-o--XX-E--X--E-------?o-----o-M--?-|-----------o---X--oo--B-XB---?X-E----------------------oBX--BXB-E--------|---?X--o--------X|v
--oBX-|-X---X---X------X---------?-oo-----------------M-o-o-o----B--B-X---o---o-------MX--|---?--X-B--X-X----M-----o-X--B---------X----------------------B------------o-X-----o-----|-E----X-X-|--o-o---
--o---|--X-XMo-X----EX|B?--X-B----X?X----|?-----|---B-?----------X---|----o------X--?-X-X--XX-B---E-BX------XXBE------------B-X--X-oX----o--XM-----X-BB--X-X--E---XB-----X?------XX-|--Xo----o---B------
------|--?-----------M-X--?-XX---X--------------E----B---o------?----?o-----------XBoX----E?XM---X--------o-------X-------XoXo-XX-----------X-|-------------XX-----------------X---X|--XEo----E-----X--B
-----B|-----X------?---------------M--XX?o-E----------o-----XBo--X|----------XX--X--o--X--o-----------X----o--X--X-X------X---------o---X----X-----XB-XX-----oXB--X-X---------B-X?--|------X--X--X------
------|-ooXo------XM----------B---XE-XEo--E------------oo-------oo--------B-|---ooXM--------B-X-?--X-o-------------?XXB----X---?B---?-o----B------?---------------B-B-----B-----M-X-|---X--------------X
---X--|--|-|---E----X---X---X------X----------o-o--X--E--o-----XX---------Eo-X-|E---X-----|----B-X-E---XX-----E-B--X------------EX------X-X----X--o-E-X--X--?-------------X-----B---|--?----o-M--E-XX--B
m--ooE|XX-B-o---?MX--X-------------o-XE-----------------X-X-----EX----?-B-oBX--X--B---X--B-M----X---B----EEo---------------------X?-----o-|----------E--XM---------B---E--|--o------|-XX-XX-X---X-X-?BX-
XXXXXXXXXXXXXXXXXXXXXXXXXXXXXXXXXXXXXXXXXXXXXXXXXXXXXXXXXXXXXXXXXXXXXXXXXXXXXXXXXXXXXXXXXXXXXXXXXXXXXXXXXXXXXXXXXXXXXXXXXXXXXXXXXXXXXXXXXXXXXXXXXXXXXXXXXXXXXXXXXXXXXXXXXXXXXXXXXXXXXXXXXXXXXXXXXXXXXXXX
