XX--------X------o-o----X--EX?--o--E------------M--X-----X----Xo-o--oE-o-----?-X----XBBE---??-Eoo-XB--B----------------X-----------X-B-X----?-------o-------?-----o--X---------X---XE-B---------XEX?----
?-----T-----o---B-X----------------M----X---------X-X---X-----X-EB--o----X---X-------B-------XX-?----E-X------X----------------------M--X-Xo------X----------X---X----EX------?-------------X-----------
-----o|----------o-------B---X-----E------B--------------X------?-----X--XX--B-----o----E-X----?oo--X--M---------o---E-B--BXE----X?---X-o---X--o---?--------X-----B--X----B-X--XX----B--E----B-X--B----X
----XX|--E--B---X--------X----------E---B----oE----B---X----------E----------X---B----X-E--X------o---X---EX-----XB-B--o------o--X-X---BBX--X--------X---------X-?--X---X--o----X-------X---?-----oE----
-X----|o---X--X--X-X-X---------o------o-?--------X--X?-Xo----X----o---o-X-E---B--o-----E--o-B-?-?---------------------o---------o?-?------XX---??-?--------X-------o--X-X---B---X-------B---------------
----X-|-E-X-----X---X-X-------?E?XB---E?----X------?o------B-----X---B-------o--XE-------M-o----XB-----X--o-----oX------oE-E----E------o-X-?----X-----B--?-------XX-E------oX-------------EM----oX----X-
X-B--X|---X---------o---X---|---M---B--X---X---o------------X---B-----XX-----M-----o--X----------o-oE----X--M--XE--X----BX----X---X-----o-----XX-?-o-X-B----X----------XX---M--X-o-EoXo--E---XE?-------M
-X----|---X----X------------XX-----M--?----X--X------X----X-X--------X-o-E---X----?---X------X---------B-o----XX---M----X-----X--------X?---M----X---------o---E-XB--M---BX-?---------------?-o--------v
X-----|-------B-E-X-o-XX-o----?--B---X-X-----B---M--------?XX---E-?--X-----------??-B-B----X-X-------Bo--B-X---X---B----------o-----X-X------------?--E-X-----?-------------------B-XB----B---X--o----B-
---X--|------X?----------X--XX-oo--o---XXXX----o-oB------o--------------X----B-X-?--o--------BX-------------Xo----------?---X--XX--oBoX------B-------X-X-EX-o--X------E--X----X--X-B---o--o---XE?X-X--X-
------|---------X----X------------X--X---X--X------o----------X-----X----XX--X--EX--X-X-E----XX----------------X---o---M---X--------XX--X-BX----?-----X------X----X-E--------X--oX--E---o---XXEXB--X---o
B--X--|----X--X----o?--X-X-------E--X--M--o---------E--o?oE-o--B-----X---X--X-----------------o-X---------------------------XB---X-X--------M-------M-XM---X---o----------MXX-X-X--X-X---X------------X-
---|--|XX-X-----E----------B--X-X----M--------X---X?-------?-B-----------B-XE----------------X--X--X----X-?-B------B-------o-X-----XX---X----------X------o?--B----X--------?----X------X-------M-EMB-B-
?-||-X|--|--X-X-B-BX----------------?----M------oB-M------X----o-----------XXX----o------------------------X--X-----B-------------oX--X-B--BX---------X------XoB--B---o-------X---XM-?-B--------------o-
mo||--|--|----M------M-----B----------X--B---X--X-M------X--------M-----X-----o-----E----o------X--E--M-?----X----X----o-o---TX-E---|o-X--oX---|B----o-X----MB------X--X-o-oo--------?-X-E-------X-XX-X-
XXXXXXXXXXXXXXXXXXXXXXXXXXXXXXXXXXXXXXXXXXXXXXXXXXXXXXXXXXXXXXXXXXXXXXXXXXXXXXXXXXXXXXXXXXXXXXXXXXXXXXXXXXXXXXXXXXXXXXXXXXXXXXXXXXXXXXXXXXXXXXXXXXXXXXXXXXXXXXXXXXXXXXXXXXXXXXXXXXXXXXXXXXXXXXXXXXXXXXXX
