---?-BB--B----B-B-o----B-----o------------------?-B--B--E----E---B--------------------|-----B----E?--------------------Eo--o--------------B------o--------M-------------B---------------o---------------
--B--------E-|---T-----o------------B---o----EE-------------------------------------------o-E--------E----------------E?---?-----o----B-M------T--o-T----------------E-TE----o--------B--o-BB---|----B--
-----------o-----------|------E---B-------E-------B----?---o-|---E---------------------o---B-?BE-------------E-------M--------oo--?----------o-----?-|-----B----?M-X----X----------T-------T--X--------E
-?--------o---M---E-o------------BE--------B-----M-|----B-o---|---------------XB-----E--------T--------o----TB-------------o--E-B---?----B-----T---------E--?-----B--------o--BB----------M------?-M---B
----B----?----E----T--X-E----B-------E--------------M---oB------B--E------B---o-E---------------B-B-----Bo-------------|--|----------T---------X------E----------------E--o----X-----?-------?---B----B-
------M-o---EB------T------------|--B--B----|-----------?-----------------B------?----oB--Eo-----------T---E------B----B?-----T-----?--o------?-----------------o|-B------E-o-------------?--T----------
----?-----------M---T----B--T--T-----------E-|-----X-------E---------------T---M---------M-----o-----------------------o--------------------------?--?B---------o----------------E----|--|-|------------
---------E-------------|-----------X-----------B--------------E-o|-------B---------BE-M------?--Eo-----------M-----------------------------E|------o?--?-------?-o-------B-------------------------E---v
-E-------?-----Eo---B------T--------?-------------B--BB---------?---?o---------------X------------------------------o--------B--o-B-------------B--?-------------M----------M-?----------------------o--
------E---oM----?-----------BB?--M---E-----------------E-----------T---------------------B--------M-----X--Mo--------------------------E-----------?-----T---?-----B-?---B----------B-B------|B--------|
---o-o--------E----------|-----oo----X------------o-----------------------?---o----o---o---oE-----E-----oo-----------------------|-----E-B---------------X----o--B|----|--E------E-o--E---X-o----oo---E-
-------B----------------------EoB----?--B-----------?X--------?--------M----------------B------------------B----------------------E-----o-X---o---------M----------B-----E-------o----------------------
------------|------B---------|-------------B-------?----------------o----------------B---T------o-T---E-|oB-------B-------E----o----B-M------?-------------o----------o---B----------------o--------M---
---------o----------------------------B--------o-M--E--B---|----------E-M----E--------------o---?o-----o--X------o-----oE---M-B-------|---XB----------B----------M-|----B------?-X-B----------E---|-----
m-----B-------E-----------------------B-o--E-o---o-?------------------o-----E------------------EE----o--T---------|o---T---o----T-?-----------B---E-B--M---------o----------------------o---------------
-------------B---X-------------------M-o------oT-------B?---E--------M-----------E---X---B---M------------------------o-----?-TE?------------------o--------oo-----?------------------------------------
