---T-o----------------|B-----X------------TB?XB--oX---B----------------X-----X---------T--------T-------E--TX---T-B---X------T-----------------MM--X--XX-XM?---?B-----B-|------oX-X-----T---------------
---B--------------?---------B---B?X---X-------XM----EB------?----------------o------------o----XB-E----?X?------X------------------B------------------------?-B------TB---X----------------oB--TMBB-----
-------B-------------------T--X-B--T-----------?---------oX----------------X-----oM------------------------T-------------------------------------B---XX------o------M|--XBB?X??--XXX------T-o-----------
-----B--------------------------B?-B------X----------X------X----------X------------BX-------B-----oBX-----MB--E------------------------------------E-------T------------oB-------o-----X-BM------------
---------BTB---------BTB----T----------EBB?---------XB--------X-------o---X----oB-------------------X-----------------------o-----E-?B------B-------oXB-----B----XXX----B-XB--------?BBXB--------X------
-EB-X-TB--------------|XX---MX--------------o----------------------------T-----------BX--------B-------------MB-------o?---------TB-----oT-----M---o-----------------------X----M---------------T-------
|XM------XB--------MX------X---------------B------MX----------------oXB--BM-----------BBX------T-----B--------------X-----B--------------|?X--------X------o---B-----B------XXXB-----X-B---B--MX|--B----
-----B-------?XBXM-------T-----X?B-------??----------B----o--X--------------------M?-----BB------------BX--------?o------T-BMo----?---------------------B-----------XBB----T-----T?--TB-T-------BBB----v
XXX---------------M?B----X-----B---B--T-------------------M----X--------------X?-----------M----B-----------------------TX-B-----------------------------X---B-------------|B-BBT-----X-B-BM--------T--f
---------o------M------------T-----T-?|X-------------------X------------XX-o---------EB-------MB-------X-----------?----------------B---?B--MB-----oX??----------------BM--?-?----?X----------B-M-EX|?-f
-----------------------------B-o-----------BB?-------------------------B-----------BT--------XB--TB-------?-------XXB------------------o-----------------------------XB----B-B--------B---Eo-BB-----T--f
-----------E-----------------X---XXXX-----------XM---------T---------------------------XoM--------------------------------T----------TTXX----------X-----------oEX---------------X-oB----XXBB-BB-------f
------B-----XT--BM--------------------o---B-------------X--|-BB--BX--BXBX--Mo-----------X-----o--M---TB-------------------|------?------X-Xo?-TB------M--X-X----------------T---------------XM----X----f
-----o--------?--?B--------XXBBB----?----------oB?--oX--BB-E-??--T------------BX-----------M?XBE-------------------X?----T-----------------------X---------?XXB-XM--------o-B-MTM?-B------B------T----of
------?-EB--B-B------------E---B-------T------M-----M-----------X|X-TBX-T?-------BX-T---BBB----X-------------BB---o----BB-BM--X---------B-----------X--TB?--T-M------------X---T------X---------X|?-X-XX
-----------------XM--------------------XB--------MMB?--------------o|-o---B---X?---------------X--?X--X?B---------M--B---o?X----------------BX--o--oB-------|?XX--XE----X------?-----oo---B------------X
XXXXX--X--|X----|XXX-XXXXXX-XX-XX-XX-X|XX-XXXXXXX-X|XXXXXXXXXX--XX-XXXX-XXXXX|-XXX-XX-XXXXXXXXXX-XXXXXXXXXXX-XX|XXXXXX-X-XXX-XXXX|XXX-X|XXXXXX--XXXXXXX-XXXXXX-XXX-XXXX--XXX-X-XXXXXXXXX-XXXXXX--X-X-XXX
