----o----------------------?B?X---------B-XBB?BBX---MB------------------o-----MX---------------XMM-------E------------------X-MBBBX-X--------X-------------------XX?--X?-------------BX------------B----
----?----------------------------?B--BB?-----XBBX-------------------------MX--X-----B------------------X----o----------------BX---------?--------X?BoXM---XX--?BB------------------B--------oB----------
------------------------BB---BBB-BX-----M?X----XB------XBM--oB?------XM-XB?----B?----------------??---?M----------------XXBB-?----------X--------BBXB--------?B----------XX--M-------------------B------
-oBM--------------?XX----------XBBX-----MX?-BXX?--M?B---------------------------------------B?-X------BXMXX-------------------------E---???-----------------BBBBB------M---------------------BBBXB-B----
-BMX-X?XX------------------------------XBM?---------B--------------------------B----B-----BBX-------------------------?XBB------------------------XX----------------o----------------o--B---B-----------
---XB----------------------XXXX------------------BXXB---B--------------------?XB---B?B---------XXX------??---------MBB?XBB--XBB---------------B-----XB??-o-----------?BB-----oXX?BB----?M---B--?B?B?X-?-
----?X?-----------BBX--X----------oXX--------------oB--B----??-------------------------------------------BB--------?-------?MM----B---B---------------X-MB-----X-XX--M--MX?------------M-B?XB?B---------
-----------------------------?X--?BX---MB-------M------------------------X--------XB-----M-------------X-------------B--BB------B?-?EXM-----B-X-B-B------------BX-------------------------o------------v
B-?---------------------------oB-BBB------------o-----------------EB---o-----?BB-------------------------BX---------XB--------------------B------------------------?B-------------EB---------X---------f
?XXXB-----oBXBX?----oX--------------XXBBBBBMMMXX---------------MMXXBB--BMM?B?MB?-------------XM---------------------------------------------------X?-------E?--X---?B------------X-------------------XMf
---------X------------------------B---------o----------X----EBX--------------------------X----------------------E-X------------------BM----------B-------B?-------B?----B-----BB---------B--------?----f
-------oX-------------------oBMB---?--E------X?--oX------------X-----------------o----------------oXBB--MB--------------------------------------??--?X?-B-?X--BB-----oX-B----------B-----ME------------f
--------------------X--------XB--------------BBXM---X-----------B------?BBXX------------MB-XXX----------X----------------------B-------BM-----X----------------------------------------MXXMMBBB--------f
-----?BBBBB-------------------------?X----------------?B-X--------------?--BB----B----XXX----BBBXB---BB-----B-----------------X---------------?XBMB-------------------------B-----?--------------------f
m-----------------------MBBBMX?-----------BX??X------------M-----XT-------------------------------X-------BB----BXB----TX-----B----------------------------BM------------------------------T--X?MM-----X
X----------?BB------o-----------B?-------oBX----------------XBM---|BB?X---X----oBX-?XB----BMBM---------------------------BBBXB--------?BB-----X----oB-----------BBXXXBo?BM-----?EB-----BBB-|---------MXX
X--XXXX--XXXXXXX--XX-XXXXXXX-XXXX-|XXXXXXX|XX--XXX-XXXX|-X-XX-XX-XXXXXX-XX|-X-X|X-XXXXXXXX-XX-XXXX-XXXXXXXXXX-XXXXXXXXXXXXXX|||XXXXXX-XXX-XXX-XXXXXXXXXXXX-XXXXXXXXXXXXXX-XXX-|XXXX-XXXXX|X--XXXXX--X-X-
