-X----M------B----X----o--X-EX-------o---oB-----------X-B-------?X------B----------------X-o-----------X----------X---X---------------X-o---M--XX------------o---XX--XB------E---o--X-o------------X---X
------TEB-----------oXM---------EB-----X---X-----X-X---o--------X----EX--X-----o-------------XX-------oXX-------B--EXB-----B-----X---------B-BB-----o-----X----o------?-XX-XX---o--------XX-X----oo---BB
------|--o------B----------------B-M---M------X-----o--------?-M-X?X----------B---?M------E-----o----o---------------?X------?----X-----X------o-X----X--?---E--B-------X------B-o-X---oB--XBo---XM-----
o---X-|-------------X-------o---X-----B--E--XM---------o---B----E--X--------o-XXX---E--o-----X------X?---?-?------M---?-----XX----o------XX-----oX------Xo-BXo------X----X-----o----X---------o--EX---BX
-----X|--X-X-X--------XE?------o-oo---X---?-X--o--------------X-?--X---XX---------X-B----------B----Xo-----X-----X-----?X-o-?---X----------?--?----B----o---------oXX---M--------------XB-XB-XX------B--
----Bo|-------XX---XX-MX-?-E---X-----------X?---X--------------?-EX--?X----X?-?X------X--E-B-B-?X----X----------X-X----------E---E----E--------X--XB---X----X-o-----------------M----X---X---------o--o-
------|----X-X---XXo---XX--E--------?----XXXB----o--BX-B-------X-?------------XEo--X-----X--X-------o-----E-------------o-o---o------------B---X---X----B----------BoX---X--X----?--X?--X--B-----X---B-X
--X-o-|oXM----X--------------------X--o-?-------------------E---------------------o-----B--------?--o----XoXX---M-Xo-------------X--o--X-----XM-X-----o---Xo-X-o--?-XB-------------XX------------X-X--Xv
--?E--|-X-B--------X------E-E---Xo---oEooB-oX---X---------o--------X-----------------B----------Eo----B-------o----o----B-o--?BE----B----X------B---?-----B-----oM-----X------------M-----------o----oo-
B--E--|-------------o--Bo------------o-------E------X--------E-X-X----E-E------X-------oX-X------X-----X---?-X-XoB--oB--X------X-------B-------X----X---------o-B-X-E-X---------------o----X------------
----MX|------oX-----X------------XX------o----o---X----o---E-----X?------------E---o--E--------X--------o-------?---X--X-------X------o----------B--BE-?-------X----o-X-X----------X---ooX---X-------E--
-----X|E--X------X---B-M----------E--B-------o----------X-B------E-------X--X---------X--------X-BX-----o--X--X-?----X--E----B--------------XoX---X------------------------X------X-o--E-M--X-X--o------
-X-X--|B-T--X---B-----o--------XX-----?---B--B--XoX?----B-o---XX?----B---B-?-XB--?--------------X----X-B----?--?---X--B-Xo-o--M-----E-M--E---MB-----------------X-X---BXo--B---X--B--XB---?----X-o------
X--X--|--|-------B-?-o---------X-X-X------EM-------X-------TMX-------B-X---o---X---------X--T------XXB------------B----X--X--B------E-?BT--X-o----B------oE--X-XM---?---------?---B-----------------B---
m--?-X|--|---------Xo-------X-----------X--XX--X----o------T---------------T---E-XB-X----|-X|-XE----XB----B------------?B-oXEX-XX?------|--|--B--X-?---------X-B------E-XX----?X---XX--o--X--oB-------o-
XXXXXXXXXXXXXXXXXXXXXXXXXXXXXXXXXXXXXXXXXXXXXXXXXXXXXXXXXXXXXXXXXXXXXXXXXXXXXXXXXXXXXXXXXXXXXXXXXXXXXXXXXXXXXXXXXXXXXXXXXXXXXXXXXXXXXXXXXXXXXXXXXXXXXXXXXXXXXXXXXXXXXXXXXXXXXXXXXXXXXXXXXXXXXXXXXXXXXXXX
