X-----------X--X-------E----E-----------o-B------?-X----------?-X--XE-----E---B---Xo---?--X-XE-------E-------XX---E---o-------X-E-X---o-Eo-X--o-----MX---X------X-X--------X----oo-X----------TX--------
X--?-X-oo---XX--?X-----X--X-X----o?---?----X--X-X-o-X--------X--X---X--X-?XXE-Xo------X--?-------X-----------E------o-X--------B-----------EX--B----B-X--X-----XXX--------oX?-----X-------o---X-o---?---
-------B-oo--------X--E-M-------M----------X--X-B-------X-X----o----X----M----------------------o------B----oB---------X--------X----X---------o----B---X------B---X-----X-----?X?--X-----X-X-------X---
-----o--X-X-?BX-X---o---X--X?-----X-B-B--------------------------B---------------Mo----------?----X-----------X-ME----o-----------B------?EEM-MoX-X---E---E----EX-o--E--X--------X------XX-------o-B---B
--o------B-----X-----X-X-?---X----X-----o--X---o---X-X---------XB----o-----M-----------?-B-----X----------o-----------X-X-oB---------------oX-------?-----E--X------?--?--X--o-X---?-E-X-X--------X-----
--X---------?-?----------X-X--------XX-------------X-----------X-o---X---------X---------X|-------Xo-M--B-------------B--X------X------B---------E--X--------X--T----------X--E-XX----------B-?oX--X----
----------------Xo------?-oX---XM---X-Bo-X-----X?-X-----X-----?-------o--X----X-----------X------X--o-E----?------?-----X?-X-?-------oB--B---X-----B------o-----X-------Xo------E-----?o------oX--------
--B----B-o--X-B-------------ooo------------X-X---E-XB-------?--X?-o----X-----X-o--?--X--B---------X--Xo--|---M--?--------X----X-X---XX----o---B--B----?--X--E-X--X------------B-----TE--X-------E-X----v
--B--o---------------X-?--X-------X------E-M-?---------X----o-M--------o---o-------------X--E----?------MX?EEB-----X---------X-----o--E------X--E----X---o---X--X-------X-----------XX---------------M--
EXX?X-------BX----------BX--------X-EB---MXo-E---B--oBo--o-o-------EXXX-------o---o-X-----X--------E----XX-M-----B?-------B---EX----?----X--X--X-o---------X--X--------oM-----B-X--oX----------X--------
X--------------X-XB-----XB----X--M------X-------o-X----X--?---M------------X-------o----------B-Eo--------------Xo?--X---X-B------------------E------M-B-----o-X-X----------X?X-X--M-----To-------o--oB-
-BXB-----o---B?---X-X----X---o----------------X---o--X-----?-E-?---X----X--o--B-E--X-----BX------------X--Mo-BX--EE-M---o-E---X----------E---X-B---XT-X-------------?--X------XX---X---B-X-?------------
B-------XX----o------o-X--X----X----------?X-----------X-------X--------M------X----------X-------Mo--X?----------o--------XB------------?---X--B---XB-X--?o-X---------B-B--oX--X--o?--X--?------------B
B---X--------X-----------------------o----X-X--XB-oo-M--XX--------o--X-----X----E---E---X------------X------?---o---EX---?---E--XB---X--X----E--X------Xoo-T-?X-----B--XB----------B---E--o-------M-----
m?--o-------X-------XEX---X-XX-------B----?-?-----E---------?X-X-X-B-----oE---X----o-------------X---------?B--X-------XX-------BB--------?----M--B-o----X-X-------X--o-o--X-X-X-------------X-----X---X
X--B-TTT--X--EX---X--------XB----BX-o--X--------XXMB-----XX-------X------o-X?--o--M--B----E-----X---XX-----|o-XM-X---|E----B-o---X-B-X--X--XX-------T--X--B-----------M-X---E----o--?--X---X-EXX--X-----
