----B-------------TB---|T--o-------------?--E-B--------------------B---------E------E--o--o--------------------------o----o--B--o--E----o----------B|----------To?B-------T--------E--------B----T------
M-E----ToB---T----o----M-----------?------------o--------?------?--------EBE-------------M-------------------B-------------o---M-----XE-M----o--o---------B-------X-------|-M-----------------??-------E
--BB---B--M---------------------o----o---M-----B-----------------?-----------------o-E-----?-o------------------?----M-----------------E-----------T--T-----------------o--o-------------?---?----------
----E-------------------|-E-M---B-------o-------?-----|M---------------------B----X-----M--?-----o---?----------------------------------------?--------------BEBX------------X----|M---------?-----o----
---T---------B---------oB----|-----------------o-----o-o-----------o-------Bo-------E---E--oB-----?-------o---X-B--------------------B--oE|---------------?o------B--------|-------TM------T----X----E--
-------------M-----?--o--------o-E----B------o--------B-?----------------B-------o------o---------o---B?--X-------o--X---M-BX-------------o---X--------B--------o|--?----T-|M---------oo-B---?--B-------
------oo----------|--------------------E---?-?---------o----o?T--------oo?----o-------------M-BM----M--M?-----------|--o-----------------T-B----------E----M-----------E-X-------?----------B-----------
-----|--------TB-----|----X----------------------------E-o-----E-B-------------------------B----------Eo--B-B----o---------T----B-------E--------------ME---?--------------------------------------o---v
?o--|--M--B----?---o---B--E-----------------?B-|X----E--?------B---T------------M---------------------------------E--------B---oB-----------B--------o---------------o----?-----------oo------------E--E
------------?|--?--------T-----------E---?--?-----------------o-----B--B-E-----------------X----------?-------o-------|-----E------------------?------oE---TB------BB--------------E-------X----------M-
----o---E?-B-------To--------?----M--B-X-E-?-----o---EE--|-------?---------------E----------------oB-------T-----------?------------------------------BM-----------o---------?|-------B-B--------B-o----
-----?M------------X------E------B------?----?------To|--E----------BX---------o---------?--B-E---B-o|-o-X-------------------------M------------T-M-------------B?-----------------------o--E--------o--
-B----------o---BX--B----X------------------------------------------EBB-------|-----o-o--------------BE------------------------?-T---o--o-E----------|----B-----------------|-?---T----B---------?o-----
----------------X-B----------------B-------E---E----B------X-----------o-----B---B-----o---------?-----o----B---?------E--EM-----------------------B-----------------------BTo---------?--E-------------
m------------------------------------------B---------o-|-M----E-----------------T------------------X--B---B---M-?-M--------E---------------------B--B-------o--------?--------------B-------?---o-------
--B-----T-----------BT------o------E-----TX-------B?---------E-?----Eo---o--------B-----T|----B--B--?--oo------------o-o--?-----?-------------------B------?--o---B----------------------B----E-------oB
