B----X--o--X-M---------E---B-----------o---------B|--M--?----X---E--------E--B--B--------------?-------?------------?E--------o-------B----?ET----------BB-------------X-------------------B---------B--
---B-----Bo--B-----------E-----X---------------E-o--------?---------o-------o-------------o----------X-----?----?----B---------------BM------------E---|----M-B------B------------------M-------E-------
|-----------B----o-o----T|---?----T-------T--------------EE-----------M-----o----o--------X---TB---------------B----------o---oM-------------B--------------|----T--------oB-----?--E----o----------E---
-------?-------?--------------------o----------------B---------?---?-?-T------------------X-----ME--o----------E----------------------B----B---------B----B---TM----E----?----------------B---X---B---EB
------------------------------X--------?-----------------Bo-----|----E-----oB----B-T---o----?B-------o---------TB------B-----------------------o---oT--------E-B-----E-------X-------------X---------X-E
----------------------o--E----E-B-------EX---B---?o--?------------B|-----o---T---oo-T-------o-T--------E----o-----------------------|------T------o--M-------Bo-|--?M---T--------------------M------Eo|-
--?---------------------|B------------oE------?X-----------------------------------------B--M--------------------E-----|----|-------X------------o------X--o-------o--------------B------?-o--|---------
B---o-X-B-T--?-o--------------B----B-----M-------B-------------E?-----------B----?--B-T-------------B-o--------------B------o-B----M-B----E-E--B---------------??-X-------T------o---BE--o-B----------ov
-----------o-?------------------E-------------B----XE---o-----------E--------B--o?----o----|----------B-|---X----------------------------E---------T-E--------------B-?-----------------------Eo-M------
----o-------------B------o----MB-----B--------o-------Bo-T--o-----o--XE--------------M----B-----E----?---B-----------------B-T-----B-----|------M-oo--------------|--E-----B-?------------------?---|o--
--------------o--------------------------------------|-M--------------------------X--------XoM--------------------M----M--o-----M----B----?---M--X---------------B--------------E-B-----------?--E------
--------------B?-------------?-?--------------------o---|-|----E--------B----------------MT----o|------------B--B-------X-------------oB---?---------------------------|--M-X-----B-E-------------------
--------------------------|--B------E----B-------------------------------------B?-----------E--------T-T|-o--M-------?--B---?------?-------------------------o--X----------B--------o--T------B--|-----B
-----------|--E----B----------------T---B-----------o---B--o-X--------------E--E--------------|--------------------B---EB-----o-B-----------------------------B--|-X-M----?----o---|-------T-----M-T----
m----------------------B-B----o--?------B---oo---------------?---------o--o-------|---?-M---?------B---------------M-X---o-----------EBo------------?-----|--------B------B------B---------|----E---B---
XXXXXXXXXXXXXXXXXXXXXXXXXXXXXXXXXXXXXXXXXXXXXXXXXXXXXXXXXXXXXXXXXXXXXXXXXXXXXXXXXXXXXXXXXXXXXXXXXXXXXXXXXXXXXXXXXXXXXXXXXXXXXXXXXXXXXXXXXXXXXXXXXXXXXXXXXXXXXXXXXXXXXXXXXXXXXXXXXXXXXXXXXXXXXXXXXXXXXXXX
