X-------|---------M--M--------------X-|---X-------B---------X----EX-----E--X--------X--X------X----X--?Bo---------X-----EXM-X---o----------X----XX---XMX-X-X-X---o-----Xo--------------?----o--X--X--B--
--XM-----B--XB---X-----X-X-----X----o--B-|o-o--XX----------------BX-B----o---B--X-X----oX---XX------------X---E---------X-X-E--|--o-|-B-o--B---X---?-------------------oX---|---X---T--------oX--|Xo----
Xo-------E--X-X-----------XB|-MX---o-o-B-BX-XXX--X------------Bo-o---------o--E--X----o--------Xo-----?|---EX----BB--XX-o---X-X-----X---X-X------X--M---E----BBo-----M-----X-oX-----|o--------------o--o
-X-----X------X---X-|-------?-----------oo-----?--------X--X-M---?B------o--X-B--B----|-BB---|-------o---B-X---o----?-X-----|--M-X------M---------Bo--X----XX--o--?-------X------BE-|?o------X---XXB----
-------X-o-XB--o-X--B------?X-B-?BE-----E------o----X-B--E---X---M----X---XX-?E------X-o---------X-X------?----------XB-X---X------MXX------------o-XB----------------o----E--X-Mo-X|-------B---X-|---E-
--M--o----XB-----X--------XB-Mo-?-----XBX--XM-------X------E-------X|-X-------M---o--------X?-B-----o-X-------XM-?-----------X?--X--E------------X---o----------o------E--X-M-------|--X------XX-B-o--XX
-X--------------X----------?------o-M-----------o---B-X--?--?M--X-?---------X-----X-E-----------X--X----------XX----X---?X-----o--X--XB-B----XX--------B--?---B-----B|B-----X-X-----|?-X--------------B-
-----X------B----------o---B-----------------------BMo------o-----?-------X-----X-X-------------X--------o-o-o-o-----BX-XX--------X-X|o----------MXX-X--EXX---X---B----X-B-----X----|-X------X---------v
-----X-----B--B-------------BEo-o----------X------o-B--X---B------X--oX------o-------M------?M----|---Xo---------X-E--------EX--------M-----X---------XX-B-----X-X---B-E------?-?-X-|oX-?-----X------X--
--X-B--X----------E-XoX-B---X-E---X---o----o-o---?--o-----XX-----X----B--B------------------------M--|----M-----------X--XB---?-----XXX-X-----X-oX-----BX--X-----------B----oBo----X|o----------B---BoX-
-Eoo---?----X---X---B-X----B-------|M----------------?------------E-------B----o---X--B--------X-X-E---X---------E--X--X---B----X----?---X-----X-------------E--------------X----X--|----o--------X-BE--
-------X---M-----E------X-----B-X--?X-?--X------X-XE--------o--B------oX--M---X-----Xo----|-X-E?--------X--BoE?X---BX----------o--E---------BX-------E------o--X---E---E------X--BXX|E-----X?X-X--------
-------------?----------XX-o-----B-----X-o-X---------X---o-X-X-Mo?--X-X-X----B-------X------B-X----|--B----M-----o--B---X----X---X-X------o--------------XMo-|-----B----X------o-o-o|--------X----X-----
------------X----X-------------XX-o--X--X-o-----B---B-XX------X------XB--X-------------X-B--B--M--------X--X-----X-X--XX-X---------B----X-B-B-X-X----E----X-----?X------B--BM-------|-X?--------?-X--|XX
m---o-|-----X-BB--B-------?X-M----B----X-M-?-oX-X---|-----?-----------?|--------------------E-o----------------XX-o--------Mo--X-X-------------X-o--X---|----BB-----|--X---E------o||--o-Xo----X--B----X
XXXXXXXXXXXXXXXXXXXXXXXXXXXXXXXXXXXXXXXXXXXXXXXXXXXXXXXXXXXXXXXXXXXXXXXXXXXXXXXXXXXXXXXXXXXXXXXXXXXXXXXXXXXXXXXXXXXXXXXXXXXXXXXXXXXXXXXXXXXXXXXXXXXXXXXXXXXXXXXXXXXXXXXXXXXXXXXXXXXXXXXXXXXXXXXXXXXXXXXX
