---------BBXXXXX-------------------------------X-------o-----------------------------------------------------MXB-----------Bo-X-MX--MX-------------B-B---B--------XXM---X---------B--------------oB-----
---------B--XM------------------------X----------------------o---B---XoX----------X------------------X-------------------------B------------------BB----M----------X---------------BBM----M-------------
----------------B--?--------?B----?--------------------o-B--XX--------BB-------------o----B----------------B----------------o---------------o---------B--------X?----E--------X--B----------------------
---BBXB-------?----------------EX?-----?-----------XB-------------------------------------XBBo?--oB-----o------XB------B-----X---B-------------------BB----------------BB--------ooBM-------------------
-----------------------------B-X------------BB-?-------?--------B-------------------------X---------o--oB--------------------------?--?-------M--------------o--------------------------------X?-oB-----
------------------------BBBX------------------BXXXBBX---------------XoBBB??B------BB-BX-----------XBB?BB----XXX----MBB---------E-X--XBB----M?XMB------XBX?B-------M?---------?XXM-----------------------
--oBBBBXBB--------?M----------X?M---------M---X----------------------XB-MB--------XX-------B-oM---o-----------BB?X-----MB-MXM-------o---------M?M?------?M----------------------------B---------B------B
--------------------oB------------------oBB-----?B---oB-------B-B??----o-EBM----------------------B?-------XM-----------X----XXX--o----X----XB-----------------------------------BB--MBM---------------v
----------------------------------BB-X----B-----------Bo--------X-----B---XM----------------?X----------------------XBB--------XX--X------------B---------B--------------------X-------------BXX-------f
B-----------M------?X---------B--X-----------------------------------------------?----------------------------?--o--X------------------o---------------XB-------------oB------------------B---B--------f
-------------------X--XB-------X----------------------------XXX--------------------------------BB-------XMX-----------XB---------------------X-------MBB-------------B---XXB----------------BB---------f
--------?B-----------BX----X----oXX------oBXX-------o-------?-------BB------------------------?MB----------B--------XB-XX-------o--?-M?B---------------X-------------MMB---------------?X---XBX----o---f
------B-------?-----------------E--B--------------?X?--B-XB?X---o-----------------M-------------------?X------------------BB---------------------BBX-?B---------o----B--------------------M-------?BBXBf
-----EBBB-------o---------------?------BB-------B------------------------------BX----?---------------B---------------------------B-----BX-BM---------XM-------oB-BB---BB---------------------------BBB-f
m----------T-------------M----X----B----TB-------o--------X-M------X-?---B?-----------?-X--------M----------T--BX?X---?BX-E---------B-----XMB------------XX--?-----?-------EX?--T-?--B----------TB--E--X
--EX--?--o-|-----B-------------?BBX-----|-BB---------------oM---------------X--oXB-E?---X-----XB----B---X---|---X-----X--------------------------o---?-T----------M--T---o?-----|---X------oB----------X
XX-X|XXXXX-XXXXX-XX-XXXXX|XXX-XXXXX-XXXXXXXXXX-XXX-X-X--XXXX-X-XXXX-XXXX---XXXXXX-|XXXXXXXXXXXX-XX-XX-X-X|X-X-XXXXXX-X-XX--X-X----XXXX--XX-XXXXX-XXXXXXX-X-XXXXX-XXXXXXXX-X-XXXXXXXXXXXXXXXXXXXX|XXX--X-
