--B----------MM---------B-----XXX-?XXBB------BB?XB------------------MX?--B------------------?XMMXX----B--X--------------??-------------BB--B---------MBBXoX?XB--------------B------B----BM--------BB----
--------------BBB---?-----------M-------------------M?----------B------B-----------B----?BXB----------X-----BB-----------------------------------??M--------------------------------------ooX--BXXX-----
------BB-------M?X-------------------------?B?MXB?---------?BB----B-oBX-----------------------------E-----B---------B---------?M------------------------------------------XX----------------------------
--X-------BBXX-----------M--------------XX-----------------------BXMB-------EBXXB-------BB----------------------------------------MBB---------?MBB-----B---------XMBX-XXBM-B?XBXX?-----------X------?BB-
-----XBB-------------?BBXB------------------oMB----------MBX------------XB-----BBBMB---BBBX---?-B-----XB------B--oX?X--------------------oBBM----------------XB-------------------X------o---------?----
--MBB?-------B----------------?-----B---XB---------------------BB--------------------------------------------oBXB-------------------------X?------------------------------BB---oB----BB--XXBBB----------
-----------------?X---?B----------------------------B----XBB?------X---------------------------------------BMBB-------------------XXX?B------------BXX--B--BBBBB-------------B----------X??B----XXXBXXB-
-BBB---B----------M?X---------------?XBB----------------------------------------X-------------?BBM?----------X-?B--------------XX--------M------XB-------------------------X---------------------------v
---XMBXB?----------------------BBBBXBB------X----------BBBB---------M------E---------------???B------oXBB----B-E----------------------------E??-------------------------MB--?-X-------------X----------f
--BX?-------------------------------o---------------XM----?--------------------------X--------------B---------------MBXBX----------?BBX-------B-------XXBB-----------M--------X?B----------------------f
-------BBX---------BBB-----------X--BBXB---X----------------M----E?-----------------?M--------?XB----M-------------------------------------E?----oMXo--------------?-------B---------BM----------------f
-----------?B?X----------oBB--BXBBBX------?B----o?-------X-------------------------------X-------------------------X?B------?X---XXXB-------?BBB----------------------------XBB---------BB?------------f
-------------MBX--------X---??-XXXXB----?X?----------?X----M??-------BB----BB?----------------------------------BX---MXXXB-----------------?-----------------BBB?XXX----?--B---BX----o-----------------f
-----X--------------------BB?B--------X------BX---------------------------BB-------------B--B--B--------------------------------BB-----------------------MB--B------X----------------------BMB--------Ef
m---------------XB?--BXXB---------oM-BBB?X---------------------------------------XXB-----------XBM??X--------------TBM-------------------?XXXM--------------M---------------B?----?B------XMBBXB-------X
XX?B-----?---------XXX?-----B---------B??B--------X-----BXX-------B---------------------oM---------X---------------|--BBXBBEX-----B?X?------------------M--M?X-----------B---MTX----------------------BX
XXXXX-XXXXXX|XXX-|X|XXXXX|XX-XXXX-XXXX|XXXXXXXXXXXXXX--XXXXX|-XXXXX-XX-XXXXXXXX-XX-XX-XXX-XXXX|X-XX||XXXX--XXXXX-X-XXXXXXXX|X-XXX|XX--XX--X-X-X---XXXXXXXXXX-XXXX-XXXXXXXX-XXXXXXXX-XXXXXXXX-XXX-XXXXX-X
