--------o-X--------M-E----------------E-------X---X---XE-----B-------X-?---E------MB--o--------M--X-----o-----B------------B---------------?----X--------oo---oE--E----X----------o------------X--------
---------------X--E------XE-X---------X--------------E---------XB--------------------------T-----B---------------M-X---------B--X---E------E--------o---E-B-----o-o---XEB---X-X-------X-?--X----------E-
-oE----------M----B--E?-----?---------o-----------?-B----o-------B----X--------B---M-------|-----M----------------M-----XM--o-o------TXEB-E------E?-----B-X-X---B----------E---X------------B-----o-B---
-o---X-B--oo-------------E--X-B--------BX---------E---------E--B------------------X-?------XX----o-------X---------------?-------B---|---E-E--M---------X----XB----B--o--M---o------------------o-------
o--------o-----?--B-X--o-E-------BB-------X---X---?--M----------------Bo-----------o--o-----------X---------o---------E--------------XX----B--------E--?-----------------X----------EB----------?---X-B-
-----------X-------X----o---------------------B-----X--------E--------o---B------o-X---------B--X-------------X------B--------------------------X--------------------------E-B--B--XE--------?----------
B--E--X--------------------E--o-?------B---?---------------o-----------?-M-E-X-------o--------E---------------o--X--X---------------------------BX--------X?---M------E------XM-----X------M-?----------
?----------------X-o--------o-----XB----------------X-------o----X---------------------E--?-----X------------------o-o--X?-----X---------------X-E---ET-----------o---------------------o-?---E----X---v
?M-X------X--X-B---------X-o----X---------o---------E---B-E----------------------------X---B------------B----------X-----X----X------M---------X---B--|----------------M---E-X-----------M--X---B-o-----
-----E-?----B--------------------X-------------B--o-----------B----o-------------------------------------X---X--------------------E-E----------------XX--oo-----o-?---oE-------------B-----------??--X--
-----B---o--------o-?-------o--------------------BX----M--o------X---------------------------X----B-------------M------------M-------------Bo---o---------------X----o--B------------X------------X-o---
-----------M---M-----B---B----o------B-----o-----------------------------X---X-----X---X--------o-B--X--------------X------T-----M--X-------------?----EE--------?-------------------?-ET-X---oX--------
--T------------?--E---X----------------B---?--T-------------------X--XE----T--------------------o---B-?-------X-------o----|-----o--o------?------o--------B------M---------X------T----|--oB-o--X----XE
T-|T--T-oTXT----TTB--TE---X--------XT----M---T|oME-T-TTTT----E----T--X-T--M|T-T---T-----XT--o--B--------?T-T--------------T|------T--T----T----B-----------o-----T-E-T--T---TT--?E-|TTT-|-T--TT----T--T-
m-||--|--|M|----||---|----E-----E---|--B--X--||-X--|-||||X-BX-----|----|---||-|---|X-----|X------E----B--|-|?--------X----||EX-E-X|M-|--X-|-----B-X--?-X------B?-|---|B-|-X-||X?E--||||-|-|--||----|--|-
XXXXXXXXXXXXXXXXXXXXXXXXXXXXXXXXXXXXXXXXXXXXXXXXXXXXXXXXXXXXXXXXXXXXXXXXXXXXXXXXXXXXXXXXXXXXXXXXXXXXXXXXXXXXXXXXXXXXXXXXXXXXXXXXXXXXXXXXXXXXXXXXXXXXXXXXXXXXXXXXXXXXXXXXXXXXXXXXXXXXXXXXXXXXXXXXXXXXXXXX
