---------------X-----------E---B----E-B---------------?o-oXo---M-----X-X----------o-------B-MBoB------------------o-o-----?-------EX-M-X-X--oE-X---Xo-----X-oB-----B--o----o----XX---------B-o----E-----
------------o?X-----X-X---X----------?-X----X----------X---------X-----oX----X--X---X-------B---o-E--X-------o-o-o-------?------X--E---------o-B-XB--XXB---X------------M-?X--X---o---X---------?----X--
----XX---------E-XE--------B---B-----X---E------EX--------X-----B---X-----XB-------------o-X--M----M-M----------E-X-?--------B----X-----B---M--?-------------o-B--M-X-B---E----------X-----------B--X---
X-----------o-oX---M----X-XX-Xo-X----o----o---X------EB--E-B--------X--------o-------X??-E---XX-B--X----------?-X-BE------o--M-----------X--X----B------o-----B--?E-XXX--Bo---E-----------B--------B-X--
--Xo-o--X-----X---B--X----o----Xo---------------BXX-------X----EB-----XX-----o-o---X---?---?-----?XB-M--?--BB-------X--XX-----X--o-----Xo----------M----o--MX-----E-------E---X-X--B-?-X-----X--X-------
---?--o-----E-X---------------------M--X----B--------M--oM---o--X-------X-o--o-?-o---B------E----X------E----X-o---o--X------X-XX----?--------?X-?-----M---Xo----X----Eo-----oX---XX---XX--EX-X---X-----
XXE-B--X-X---X------E-oX-X---oEX-X---M-E---------X-----BB-XX----X-o-----------o--Xo------------ooX-oB-XE-o-X-o-E----?--E-----X------------X--XX--X-----B---?---X--X---X----BE-X--M--X-X--------------?M-
--M---E--X--------B----B--X---E-----?--?-----X-----?-----X?-B------------M-o-B--X---?X----------XB--o------------------------o--o--B---------X----X--X-Bo--o-X----BX-XX-------------o---X--X-----EX---Xv
-o--X?--------------X------------X-?-B----X-------X-X----X-----X-XX---E-XB--X----X---o----X-B-E---------------------E----X-B--------o-----X----B-oX---X-----------X?-X-Xo---------oX----Xo----E--E------
---M--?--EX----B-----BB---------E-----Xo-?-E-X----X-E-------M----?--X---B--X------B----B----X?-o----ooX---oX---BX----X-----o------------X----o--B-X-X-------X-BE--o-----------X-E--X------------X---X-X-
X--?------X------------------X---X--B--X---X---o---X----X?-BXX-------?--------X-X---?------X-X-------o---------X-----BE--------E-----------o----------o-oEX--oB--o--X----X----o--------XX------B-X------
--------X-BB---B------X--------X-----o-X-B---------M---B-----------X--------X-M-----X--X-oX-M----o-X----B--BX-------Xo--------------B-?-X-----B--------M---------X----EX-X------E---------X-X----X-X--X-
--------X-X-X---------o---XX-?-------X-------?X-------M-X----X--?------o-------X---X----------X------BX---Bo------X-X------XX-E--XX-B--X-?BX--EX---E-o--X--BX-o-B--------X-EX--X--?B---X-X------------M-
-XX---------X------?B---?---MoM-X---X------------X---------X--X---X--oX-----X--?------------X---XE--------E------o-X---X---o--XXBEX-XX-------X--X-------X--o-X-E--o--o--X--X-------X--B---X------X------
mE--X---X--X-M--Xo------X-----?----X------M--X-XMX-------?---B--B---T--------BEEX-X|---X|-E-o---o--X-----XX-X------------?----?--E-X--M-o----o-----o--o--X---X---X-o--?--X-Xo--XX-X----X-X--X-M----o-Bo-
XXXXXXXXXXXXXXXXXXXXXXXXXXXXXXXXXXXXXXXXXXXXXXXXXXXXXXXXXXXXXXXXXXXXXXXXXXXXXXXXXXXXXXXXXXXXXXXXXXXXXXXXXXXXXXXXXXXXXXXXXXXXXXXXXXXXXXXXXXXXXXXXXXXXXXXXXXXXXXXXXXXXXXXXXXXXXXXXXXXXXXXXXXXXXXXXXXXXXXXX
