-X-----X-E--o-----BX--XX-X-o------------------E--------------------XM-XX--------X------Xo??-----B---X-X--?----------------XX----B--o-o-E-----X-?-----------B---Eoo---B---------X-----------?XM-X-------X
-?-B---oB-o----------Xo--oB---B--XX-------?-X------X------------------E--------?--------X-oM----o---o--BoB-o----M--XXB--------------X--XE--o-----Bo?---B-----?--E----o-B---Bo-----------------------X-B-
-?--X----E------X--B----B---------M-------o----------XX-------XX------XX------------X-------------BX------------?-----?-X----X-X----X--------?-B----o-----B----------------------o----B-o------o----o---
X-o--X-------Xo----MX--?-oX------oo-------X--E------------X----XX-X------?------X--X-X--XB-X-----o---------EMoX------o-X-----oX--?--o-E-o-X------E-----------Xo----------X----X--XX-?--X-----XX--X---X--
B-?-o-------XX------XX----XBoXXX----?--?X--B-X--E--B---o------X---E--------------X-B-Xo--o------?---oX---?--B-------------------------------oB-X--E----------E------o----Mo----X-o--X--o----Xo---E-----o
--o----XXE-o-B----M?---?E-B-?o--oB-o---BX--o-X------------oo------------------B--EB-X--BX--X-Eo-M---X--------X-----------o-B----?---BE---B--------B-----B--X-------B----------o-----E--E-oX-XB-X------BX
--------X--X-X--------X---------M--X--X----------o-----o----------X---E---XX-X-E-----X------XXXX----X----------Bo-B-----X--X------B-?X--X-BM-----?------------------X-B-----BE----o-----o--XoX-----B---?
-----X-------------------?-----------------X-------------X--BX-X-Eo--------o--------X---X---BX--o------X-------------o----o-oX--X----XX----Xo-X----X-----------------X?-X---o---B-E--X---X------X------v
--B--o---------E---X------X-----------X---B-X----X--XXoo------E------B-------B-XX------XME-------X--oX------B-------------oX--B-XX-----o--o--X-------X----------------EX-----X-X---------------B------?-
---X-------X-----o----B-B-----?---o-M--------XB-o-------?-B----------XX-Xo---o--o------?----X-X-----E-o--o--EX-------X?--------XB--XB-X-X---X--o--------X---E---?oX--o---B---X-X--?-X----X--?-XEXX-XB---
-B---XBX---?o---------E---o--XoX-?------X-----X-------E-----o----------------X---oX------X??--X---------X---E--X------B---------------B---X---X----X--?X----?X---X-----X--X-B----X-o--o-?-------X?------
--B-XX-----X-?E--o----?B-------M-----X----M--B----------oX-?--E--B-------o-------X-------XB--X-o?-----XM--------XX-X-E--------Xo---?-XXo-X----B--------X--X----E-X------X----------o----B-XB--------X-oo
X----------X?--B-X-o-----------------X--------X---?----X--X-------E---o--X---------X----X-----XB-B-----E-----X--X---B---------B--------E-------X-------?---o-o-------X-----?---X---X--------X------oB---
----X-X-o-X--B---?-o------oE---?-X----XX-X-------------B--oX--X-----X---M---B---X------------X-X---Xo-------Eo--------o---X?--XEo-------B---------Eo---------o---X----X----Xo--B-X----EE----X--------XX-
m-X------X--X-X-X--------oXT-------o-----E--B-BoT------B-----o--X----X-XB--oX----B-------------o----XB-----E-----------------------?--T------X--XB-----X----o-X---XX--T---B?---X----?-?-X--X----o-----X-
XXXXXXXXXXXXXXXXXXXXXXXXXXXXXXXXXXXXXXXXXXXXXXXXXXXXXXXXXXXXXXXXXXXXXXXXXXXXXXXXXXXXXXXXXXXXXXXXXXXXXXXXXXXXXXXXXXXXXXXXXXXXXXXXXXXXXXXXXXXXXXXXXXXXXXXXXXXXXXXXXXXXXXXXXXXXXXXXXXXXXXXXXXXXXXXXXXXXXXXX
