-------?-------------B------E------?-o--------E--o---------M---------------B-------------------------------XT--T--B------?-------o--?---B----?--------BX-----------------MT--?-----------o---B----------
--B----B-oB---------oo---------EoT-----------o-o-------------------Bo----------o-------------o------------X-----M----T------------?----------B----------T------------o------|------?-|--------------B---
o-----------------T--B-------?-------B-------o---XM------------------Boo-?------?-----B-------------------X--------------------------------------M|----?-----M-------------------M---------?---E------?-
------M--------------------------------------E---------o--Eo?-------M-----o-E--------------B---T-----------------BX--------------------------------T------o------------o---------?----------o----X-B-o--
--------|-------------M---------?-E----------oo------?E---X--o-E-o-E-?-----------------------o-B----B?--E-----X-B------B--------------------------------------------E--------------------B-?-------|----
--?---------B-------E-E-|----E-----------B------E-------------------B------E---------------------------Eo---o-?o---B--------------B---B-------B---------E------B?-M--------|BE-----B-B-----B------------
-----E---------ooM-----T---------|---T--------------X------X-----X----------o-----B---?-----------TB-----------Bo-B-M--B-B------------B-----|--o?To-B-----M-----|--MB---?----------?--------------------
--------------------o---------EB--------B-X-----o---------o-B------------------E-------E---|-----o-------------------|-M---|------------o-|--------B-|---------------------|-----T-M--B--------------|Bv
--?------------B--B?-----------M---T-?------------?----------------------------E------?-------B-X-?----------------E-B-----E------------------------o--------------T----?--X-------B--------?--EB-----oE
-EX----o-?--------B-----B-?-----------------?---------BX---o---E--T---B---------BE-?-B---T----?--T|--------T--T-M----?----B----B---?------------------o----o-------E-----o----B-------------Eo-|----X--E
X------B----------------------E---o-E-o---------------------------------BT----?T-------T--o---|---------T-----------o----------------X-------------------?--M--?------------------?-|-----X-B-E---|---o-
--------|------o--T---------B-----------------------|--|--------BB-----E----B--X----------E-----E-----B-----E----------------X-------B--o--?T-M---o|-------?-BE-----------M-----M----|----------------T-
----BBB----------------B---------------M---E-------|--o--X----------------B--o--B--------------?BM------------E-------B-------------------o--B------------B--------B--------------|-------X--?-o-----T-|
---o------------------o----o-B-------------B----------|-------o--|-E-------o------------------B?--------B-----M------?E--M|--o-------BBME-------o-------------------------------------o------o-B--------
m----E-----------o-------------T--o------o---BB-o---------------------B----|--------------?-------B-------o------EXE-----------------------o---------B---o----B-B--------?------------------------------
o--oB------------------B-EoX----o------T-------------------?---------------------T------------------BB----B-o--o------?------M-B------o-?---|-------o-X---X--------------|--T--X----X---o--------B-----o
