--------------------------------------------o--------X--------XMXX-------------BX?-X?----BX--X-------?---------X-------------B-oBB-------------oB-----B?BBBBB--------------oBXB--------oX-----------Xo--
--?XXMXXB--B----------------------BMBB-----------------MBMX-------------BX-----------------BX--------?MMM?---------------?BBX?M--------?BBB------------------------BM?---------X-----------?X---?-----X-
--------BBXXBX-MXX--BB-----------BX--------------------X-------o??M-?XX--------------B--------------X--XXB-------------M----------------------B---------X?---------------------------?------------------
---------BB----X-------B----------MB--------XB----------------B--XX?E------------?B-----------X-----------------------------BX---BB--BXB-----BB--XB-MB-XB----B-B------XX---BX-----------------?XBXBXoB--
-X---?BB---------------------------------X?B--------XXB----XX----------o-----------------------------X?--?B----B?------o-----BB------------XX-----------------BB---------?MB----------------oB--------?-
-------BX-----XBB---------------B-------X----------oB-----------------BB---o------------o?BBX---------------------BBBB--XX------?X---B----------------------?XXMXBM-------------BB----------------------
--XBBXBB---------------------------XX----?M?X-------oBB---XBo--------------B------X?BBBBBB?-----BBXM--XBBB----BXMMXXB------?Bo--?--------------------------XX----------------MMM?--------------BM-------
---B--------------------XBX----?B--?X---B?BXB----------MX?-X-------------M------------BM---B----?BB----------XXXB----------------------???BX------------------B?X-----------B-----B--B--------------XoXv
--B--------BB---------X-------------B-------------BB----------------------BXB-------------?XBX-------------------------------------------------XB?--BB----------------EBBBB----------------------------f
oBM---MB?B--------------BM----BB-----X-----XXX---o--------------XBB-------------------------------BBB---BB---------oB----------------------------------------------------------XX--o-------------XX?BBXf
----XM--XB?BX?BX?M-XXBo------------------B-------?B-------?----o----------XB----------------BBB-------------------MBB-oBB--------M?X----------------------?XB----------MBB--------------------oB--X--BBf
-E---------------BX?M?-----------XXBB-----------oBB---B----oB----------------------------oB---------------------------------------------E-----o--------------------------------------------X----B?BM---f
-----------XMBM--------BX-------------------------------XXX---XX------BBB------BBM--------------------------MB?XXB----------XMX-------?--------------------------?X---B--B?--BXXB-----------XB---?X----f
-------------oXXXBB--XBBB----------------?XBTBXXB---------XB---E?-------BB--------------X?B---------oB-------------------XXBXX----------X----XX---BBXMXB----B------B--------------XB---------?BBB-BB---f
m----XX-X-B--------XBX------TX---BBMTX?-----X?B----T----XX-?X??-------EX----------T------XB---MB-XB------B--------------B??BB---TBBoBXX-XoX--------TB-BBXMBB?o-TB----XXMBBEX--------?XBMM----T---M-----X
X-MM??BXXXXXX--XXXMMXXXXBXX-BXXXXXXX|BXXXBBXXXXXXXXBXBMB?XXXXXX-XXXXXXX-XB--XXB--BBXXXXXXX?M-XXXXX-X-XXXXXXXXXX?XXXXXXXXXXXBB-B?XXXXXMXM---XXXX--XXXXXXXXXX-XXX|BXX--?XBXXXXBXXXX-MXXXXXX-XXXXXX-XXXXXXX
