-----?----------------------------XBB------BXBM------o---------M--X-------------B-------XMB-----------BMXMBMX-----------------XXX--XBX?-----?X----------------------------------?------BXX-----------XB-
---------B-------------------------??-----EX---------------BM-----------------BBXoBB--------XM--X--BBB-XBB-----?B---------EX-----------------------?X-----------?--------MB------------oB------o-----XX-
----------------------MM--BB-----------------------B-----o--------B---------------------------o--B?-oB-------BX------B-?B-------------X---BXB---------------------E-X-----------BMo?B-B---------oXX---BB
XBXM?o---------BBBBXBBX----XXB----E?oB-X?--XBB----------oB??---------M-------------------X---XoBBBBBB-BMMXBBB-------oB---------------------?BBX------------oB??-XXXBBB--------------------------------Bo
-----BBX-----------X------BXBM--------MBB-----X?-o?---------XBX----------BBX----------B-------BB?X-----------BB------o------B-X------------M----------------------BB?BB------BB-----MX-------?B---------
-----------X-----------------M-----------EB--oB------XBXB-----B---------X?---E-------------------------------X----------------------XBBBM---------oXXMB--?XXB--------o??X-----------------BX------------
-----------M---------?--------??------EXB?-MB-------XBB----------XX--------oBMM?X--?o--XX---BB------?-----------------------XBX?B------------?M-----MBX---o-XBB-----?B------------------BX--------------
------------MB----------------BoXXBXB---X------oBX-------------BBB-----X-----------------------o----B?B---------------B---------------?XXB-BMM--------------------BB?XX------BX--------------B---------v
---X-------MMBB---B?----?B-XBB----BM----------------MBXBBEBBBMB---------------------MB?-------------------------------------o-?--------------EBX---XB----o----E--------------------o--------B--------?Bf
---BX-----??-----o?------B-------?------------M-E---X----------------o----------B-----------------BB---o-XB----------MX---------?Boo---EB-----------B---------------B-----------M---oX-----------------f
----------------------BXXXB-----?XX---B----------BMB------------BX-XXXX--B---------BM--------------X--------------------oB-MX--------------------------X-----------XX-----B-----------B------------XBBBf
--------???------------------o--BM-BB----?XB-----oX-------------?MB--------------?BXX-XBB-?---oo-----XXX-------------o?X---B-------------------oXXBB--X-------M-B?BXBBBM-------------------------------f
----------------------------------BoB?XB---------oXXXXM----B---------------------------------------XBBB-X?------M--------------------BX--------?B----BB---------oMXM-----oM------------------B---------f
-----------------------?X----B-----------BX----------------BX---------------BB--X---------MXBB-----?--B?---BBBB----------X--X??B--??--X?-?B-----?BXBXMBX--?XB--------oXB---------XBX?X---?--------BB--Bf
m----------------------------BB-------------------------?----------------------------------X-B----------?X-EX-BX?BB---T----------?-----E------------------------------------XB---TB-----------------XB-X
---------------BX-----BMM-XB------------B------------------X---------BB----MMXB-----BBXXB?----------B------------oMXB-?-----------B------------------M------------oB-------------|XXB?----------BBE-?BXX
XXXX-XXXXXX-X|XX-XXX|XXX-X-XX|X|XX-||||X--XX-XXXXX---X|-X-|XX|XX--XX-|XX-XXXXX-|-XXX--X-X--XXXXXXXXXXXXX-X-||X--XXX-XXXXX-X-XXXX-XXX--X|X-XX|-|XXXX--X|XXX|X-XXXXX|XXXXXXXXXXXX-XXX|XXXXXXX-XX-X-XXX|-X-
