---------XB-XX---------------------------------X-------o----------------------------?X----------------------o----XB---------------MM-------------------------BB--EXE---M----------------------------?-o-
---------M--X-------------------------BM----------------------------B--------------?MMXB--------E------------?---X--M----BB--B--BB---------M----------o---------------o---o-------------------------X---
----------------B--o?-------BB?---?--------------------M-X--X---------?o-------------o----X-----------------B-----------B-------B------------------------------------------------------------?----------
---XBX--------?-----------------BBB----B----------------E--------------?---------XX----------------------------------------X----------------X------------------------XB-----o--------------XB-----MBXX--
-----------------------------B-B------------BB-X-------B--------X-------------------------X---------o--o---------------XX----------M-X-------------------------------------------------oBBX----?--X?----
------------------------BBBB------------------MXXXBBX---------------XoXXBX?-------XB-B------------BBX?X-----BXX----?BB---------E-X--X-B----B?XMX------XBX?--------X?---------?X-----------------------X-
--BBBBBXBB--------?-----------o?B---------B---X----------------------B--M---------XX-------B-oXM--o-----------oM-B-----EB-M---------o?--------M---------?-------------------oBB?-B--------------X--X---B
--------------------o-------------------oBB-----BX?--oB-------o-B------oBEMM----------------------X??------XB-----------X----?XX--o----XB---?B-----------------------------------BB--X-MX--------------v
----------------------------------BB-X?B--?-----------Xo--------X-----B---XXB---------------BX----------------------MBB--------X---XB-----------B---------BB------B?-X---BXXX----o------------B-------Xf
B-----------MM-----?XB--------o--BB----------------------------------------------X----------------------------?B-X--B------------------o---------------?B-------------oB---------------------X--o------f
-------------------X--X--------E----------------------------XXX----------------------------------X----------oB?BXB------B---B----------------------?X---XMB?BB--BXXX---XB--------------XXBX---------M--f
--------EB------------?BB-------o--------B-----M----X-------M-------E---M---------------------?------B---XBXB-----XX---o-----------?XBX------M-----X----M------------o----B?--EB------X----------------f
------BB------B-----------------X?-B--------------?X---XB???----o-----------------BX------------------XX------------------BB---------------------BBBB?---------------?M?-o-X------B--------XXX-----B?--f
-----EBBBX------X---------------?------BM-------BB-----------------------------BX-----B---------B-MB-----?B----------------X--BMB-----B----------MX---X---B-B--X?------------------------------------?-f
m----------TB------------M----X----B----TBB------X--------B-B------XB?XX-E?-----------?-XB-------M----------TB?B-?----BB--E---------BX----XX-------------oXX-X-----B-------E-?X---?BXXB---------T---?--X
--E---B?-B-|-----?B------------MBB?-----MBBX---------------oM---------------MB-BX--Eo---o-----X-----B---X---|B--?--X------B-------oB-?--M---o----oBBBX?--------M---o------BB-XMB----------------|M---X-X
XX-X|XXXXX-XXXXX-XX-XXXXX|XXX-XXXXX-XXXXXXXXXX-XXX-X-X--XXXX-X-XXXX-XXXX---XXXXXX-|XXXXXXXXXXXX-XX-XX-X-X|X-X-XXXXXX-X-XX--X-X----XXXX--XX-XXXXX-XXXXXXX-X-XXXXX-XXXXXXXX-X-XXXXXXXXXXXXXXXXXXXX|XXX--X-
