---------|----------o--------oMo----?-T-|----------------------------------B|------E------o------------B--------|-------------?----?-?--------?----------B------T------------B--------o-----------------
--oEo--------o----------------o--------------------E-o-EE|------E---o----BB---------?B---------------o---E--B-----o-------------------XB-------?----?------o----?----------B----T----|-------E-------oB-
B---M--------------------------?------B----o-----Bo-----T----B--E---T---o----?-E------------o---------B---------|----------M---o---T--------o------------B------------------?-----E--------E-B------E---
-------?----M---T------------------------o-------B-M-------?-BE--?T-----------------------?--o----------------B-E--?B-----------Bo----------o-----------------?---M---o------o--------------------------
-B--------o-?M------oE----E-----X-|--E------------?----To---BX----------------o---E--------------B-o----TT--T--?|--TT---E?------------?---------Bo-------?---M-?------E----o---------T---------B--------
----oB-----B-----|?--------B-----------------E---oo-------o--B------M-?---|-----------------------------B-------B----------M----o?---------------o-------?---M----o-------------?-B----|--B----B---o----
----------T-o-----o---------------E--------------------------------?------X---o-|-o----?-----------------------?---?--o----M----B--------B--o----------------o------?-B------TE---------Bo----M-------?-
--??o-------o----E---E-B--------?-------T----T-B-B--------o---------B---o-------B--------------B----?------------M------E---------------E--------B-----------?------E---------------------B------------v
-o--------------------------------|------E------?----X----B----X------|E---o-B-----?----?----B|------|-------T------------E----o--------B|--------------B-----?-----------------?---o----|----B-----|---
B--------------B-------BoE---oX-----?------------B------o--------------------------T----------B------E--o--------o---M-------------B--B-----E-|-|-o----?----T---------------E---------E---o-X?----?-----
-------o--o---------M-B-----------------Bo-----o-o-------------B---------------M--|----------T--o------------oE------X---------o-------o----------------------|---------------BB--?--Eo---BBo--------B--
X-------------Eo---o---------B---------------E-|-----o---E---------------------------------o-------?---o----B--------------------------------E-E-X--------MTX-oE-------------o--|---------o-----------oo
------|------------------o--------?|------|----|X---B------EB----------------E-------------T------------B-X--B--oE-----oB---Eo-M-------------BM-----T---?o-----X---------------------|E------B-M-B------
--------M----------------------o--------------------E----ME---oo-?------o----?-----------o-----B---?------o--------o----E-----------------B-----------------|---?E-------E-B------o----o----o--B----o-X-
m-----B-------?o-------?-o----o--------o-o----?M-|----XMB--------------BB-?-----?--------Bo-------B------------X--------------B------------------X------E----------------------E---------E-------T-B----
E----------------o------------E--------------|-o----------o----------------------------------------E-----------|T-----------?o---------B------------?--------BB-------------------B-----------------?---
