----------B--BXB------BBBX------X?---X--------------?---------BB-------BB------------------oB--------------X?----------------------------X-------------E-----------------------------------------o------
-B------------BB------------------------BXB---B?------B-------oM----------B--o-B------------------------BB?XBX------?X-M---------------------?BoX-----XB-------BB------B------------EX--oX?-------------
---XM----------E-------------------X------MXM----?--B----------o--X--------------------o-----?X-BB----------------------B---B-----------------oE-----------------X-----XX-----X------BB---------Xo--X---
---------B-oB------o---X---X-------------------XXX----------o-------o----o--oX----------X-----------------B-E-X--------------------------------B?------------BXBX--------X-------BB------X---oXXo-------
--B?XM---------------------------B-------?------B--------B---X----EM----------B---------------------------B-------------?-------------X--------------XXM----------------------XX------B----B--oMBM------
o?X-------B---------BBB---------B--B----?XX-BX----------M?--M----------------------------EX---BX-------------------X---MX-------?-----------------------------------B--------------??-----------XX------
----oXX-----------------------------------------MXX--------------------X--X----X-----------B---XX------------------------------------------oX------BX--XX----------BM?Xo-------------X-----------X----X-
-------------------?--B-X--BXX---------XB-?---------B-----oEB--------------B-?-B----------------------------------?---------B-?------B------o---------B--------Bo------------EX------------------o-----v
---BXB------B--X-XX---------BMB----------?BX-E--------B-----B-------------------------------------------------XB---------------------EB-BBB--oBB-----------oM-----------X?-?-------------------?oBB?---f
------B---------B----------------B-----------BB---------------------X----------o-----B----M--------E--XX-oXXB------Bo------------?--------------------B-------------------------------E?---------?-----f
-----------BB-------------X------------------------------------------------XX--------------------------MX-B-------------?B---------M------XB---X------?--???-----?X---------------------------X--------f
-----o-------------------X-B------------------------------oB-----------o-----?------------------------o-------------------------?-----o----o------------------X----?-----B-------------M------------?--f
-----------MX-------------B-----------------------------?B----BM--o------B-o---B---------MBEB?B-------------------oX---BXBX--------?M----MB------oBB------------o-----EB-------BX----E-------X---------f
-------------BX--------------MB------------------------o------BB----------BX-------o---X-oX-------XXB----M-----------------------oB------------------------------X--------------X------oB-B-XM?-?-BXBB-f
m-----XBXM----ToX?-B--------------------?---o----B--------------M--------o-----------?-------X----X------------X--M---------------------------MM--------------------E-----XX------------------B--------X
-X-XB------?XB|B--------------B-B---?-X--M?-----XT-----?X--X-X---Xo-B--------XXXBX------XX----XX-M------M-------BB---------XBXB--------?--?---------B-----XEBBB-----?---M-----------E-----B??--T-T---??X
XXX-X-XXX|X-XX-|-XX-XXXX-XX-XXXXXXXXXXX-XXXXXXX-XXXX-XX-XX-XX-X-XX|XXXXXXXXXXXXX---XXXXX|X--XXXXXXXX-XXXX-X-XXXX-X--X-XXX-XXXX--|XXXX-XXXXXX-XXXXX|XXXXXXX-XX|X--X|XX|X|X-X|XXX-XX-XXXXX|XXXXX--XXXX-XXX
