-B-?-----?---E-?-----------X---X----X--------XE-----oo----M--o-??----BB-X----E---X-B??----o--XM--X-B---M-?-------oX-----BX------o--?--------X-X-XE------------oX---M----?XEX-----X-X---------B----------
----B-T-----B-?-XoB--X--X----XEB-o--E--M-B--X----------------------E-o-----------?-----X---B--?----oX---B--B---------o---X--E----o---Xo?-------o--?X--------------X------------X----X-o---------X------E
X-----|o----X---X-?--------XX------o---------B--oB---X----XXEX-------o---------X---XX------B--BX----X----X-X--XE---X--M-X---------X-o--X---XX----o-?---o-X-----XB--B-?-------E------o------X-E--o----oBo
-M----|-X-------------------------------X---X------M------X---oE--------------X-----Bo-X------MX----------B---MX----------E-oM-E--X-X---M----XB----E---------B---X-----------BX-------------XX----------
X-----|-------BX-B------X-E--B--XX--X-B--------?X-------------oXX?-----X-----X---------X-----------------X-------X---------X---?-B-----X--E--E--B---o--X-----------------X--X-XB----X-------X-oX--XE----
-----B|-X-----X--XM-X--X----X-----?-oo--XX------------------B-XM------------o-------B----XEE--X-BE---------o--X--X---o---X----X-X---X-X-X---o---XM--------o?---------------------?-X--XB------XX--Xo----
--o---|-o---X------M---X-----B-X---E-----X---X---oXX--o-X---?---o--EoMXXX---X-------------?E--Xo-----------XX---X-XX-------o--------X?-B--?----o-?-XBX?o-XB-M-----Xo--------X----XB-o-----o-------------
X-o---|--X------X--------B--X-X-------X--oo--?--------B--X-----?XX-------------XB-o------X-Xo???-----------------------oX-X------BXB------------X-X----X---X-----------?------Xo----------MX-----------v
--o--X|-X-----X----X-------------MX--------------X-X---?-E---o---------X-o--X--BE--------------------X----E---M--oX------E----X-o----------------XBX----------E------M----X-E------?----X----X-?X-X-----
---B-B|--------?-------X-B?-o-----X-----------X-X--B-----------------EM?-------B---E--o-----X--BE----?-o---o--B-X-----------X---------X--------------E--E---X----------------B---Mo----XX-----E--------X
-----M|X-------XE---------o----X--X-X-----o--------X------XE------XE----o-X--?--X-XM-------XoX----------X-B---------X---o-----o------X--o--X-----------XXX---X----?--B-XX------------XXB------?B-?-o----
------|B---------X---o--o--o------X--X--------X----------X--o--------o----------M---X--------------?------XX----------X----X-------E------X--X----M--X---BX---X---------X---o--E------o-------X---o-----
--XX--|--X----X------?B-------X-----------X----o-X-B---X-----X--------B---M--E-?--XXXB-X-----Xo-B------X--X-XX-X-M---------X---o-XM-------X?X---------?----------X-X----XB-B---------X-?--o---?o-Xo---X-
------|X-|-X---B--Mo------o----o---X---------o--X-----X---------E---o---------X--X-X--BB--X--X-M-------?-----B-X----X---E---------------o----X-B----X----------BX-o---------X---o---XX---X--Xo--X--o----
mBoX--|oX|----E-X-X---X----B----?----X----------E-X---XX-T-----------------------------E--X----XX---------------BX---XX------------T--XXoB-X-------X---?-Xo------E-BX----T--X?--TX-X---B-X--XXX-B--BB-?-
XXXXXXXXXXXXXXXXXXXXXXXXXXXXXXXXXXXXXXXXXXXXXXXXXXXXXXXXXXXXXXXXXXXXXXXXXXXXXXXXXXXXXXXXXXXXXXXXXXXXXXXXXXXXXXXXXXXXXXXXXXXXXXXXXXXXXXXXXXXXXXXXXXXXXXXXXXXXXXXXXXXXXXXXXXXXXXXXXXXXXXXXXXXXXXXXXXXXXXXX
