B-----BX-B----X-------o-X-------------------E-------------------X--------------------X------------------------------X---------E----?----X---------X--------B---M---------------------M-----o-EM-----o-?-
-----o---------B---M--------E-o-BB-------------------EX-------------------------M---M----------?B-------------------o-------?XBXX-BBM-o-----------------X-------------------------------?---------------
----X-----------E-B---BB------M-----------X----??----------------BB---------??BBMo-----XBXo-------------------------------------------------------------BX-BBMB---------------B-o--------o--------------
--E--------------o---BX---------o-------B----------o-----------------------E------------o-Bo------------o-X---------o-------X-------------------------------M---------------------X---E-------oX--------
----------------M-o------------?M------------X-------X----------------------------X----------o-----o-----?o---E-----------o----M--------?M------------M------------------X-------------------o----------
o--------MB--------XXBX---------oXB------?------------------o--o------------X-----X------?-?----------------X-----------------------X-?----------oX-?---o---?------------X----------------X-------------
---oo-----------X------------------X--------------B---------X---------------E--o-------------------------------------------B-o------o----------------------------------B-----------M------o-----------B-
----------------E----XBB-----B---------X------ooBB----------------------------o----------X-?-----------------------B-----------o-B?-------o----------------M----o-------------X------?---BB-------M----v
------B-------X------------X----------------------X-------------X-?-X------------------XX-------B-------------------------X----BX--------------o--X-------------------o---------X---X---o-------o------f
--------------?-----X-----B-X----------?X----------?B-----M---E-------------------------------o-------X----?-----B-X------o--X-----M-------EBM----------B??XM------?--B---?Bo----E-----?XMB-XX?--------f
--------------------------E----------------------------------X----E---------------B---------X--------B-------M--E-----M----o----oBB-o----------------B-----oB-B-----------B-MX-ooo-MX-------o----o-----f
---------?----o---------?--X--------------------B---------?-------X---o--------X-o-----X------o-oX----o-------o---------------------------B-o-----X------E--------B---B--?-----------oB----------------f
------------------------?----------------E----------------------------o-----E----------------------------B--o---------X--E---?-o------------------------------------X------------E-----------M------o--f
-----------------------------??--------X------------X----------------------------------X------------------------M---E---------o-------E-----------------X--------------X----X------------------E-----X-f
m--------o------o----XBo-B---E----------------------------------------T--TX----?----------X------B-----oBX--------------------BB---------------E--?B-?BX--------MB-BB-----X-----B--------X----XT-------X
--X-BXo-------------------------X----E--B--X------------------------X-|-X|---------?B--o--M-------?----E----------o----------------X-?-B------B---?----------?M-M----------------E-----B---XX--|------XX
XXX-X-XXX|X-XX-|-XX-XXXX-XX-XXXXXXXXXXX-XXXXXXX-XXXX-XX-XX-XX-X-XX|XXXXXXXXXXXXX---XXXXX|X--XXXXXXXX-XXXX-X-XXXX-X--X-XXX-XXXX--|XXXX-XXXXXX-XXXXX|XXXXXXX-XX|X--X|XX|X|X-X|XXX-XX-XXXXX|XXXXX--XXXX-XXX
