--------|?|EX--B---o-|E----B--B-----XB-----|o?-----XX--o---X----------------X-o-----o-----X-----|-------B|----?|--?-B--X----------X----B--X-------BB-------------o---X------X------M-X-X---Xo--oB-B-----
MX------------------X----------M----o--o---XX--o-X---XX------B--oE-?--XB------o-----X------X--?-----?---X---------?--X----B---X---o-------X---X--?-----B---XXB--XX------X-----|----?-X---Xo-----o?------
------X--B--B-------o--XX---BB-B-------B------oX?|------o-o----B--X-----X-X------B-----oX-----Xo--X-M---oX---------o?-----Xo--E----M---X---?--?---X----------?-B----X---?X---E-X--XM---------XB---------
---o--EB--B------o---XB---XX-?-----?--E--?---------o------X--?--X---Eo--------Eo-X----------------------X-----X--EoB-------?-X----X--X---M--------B-?B-BX-------X--o---Eo-------oXE---X-------o-------E-
-----?--X-?---X?-X--B---oB--o-E---E---EXX---E--X----------XoX--X--X--X--------------|-oE--X--X--o-----?B--------|-E-----X----B-----X-----Bo--XX-----X-----o------|---o--o-------------o-B-----X---------
B-oX----------o-----X-|-B-XB-----X------X-----TE-----X-------X-X--|-X---X-X-------E---E-----------|-M-?-----X------o-XXX-BB--E-o?B----X---X------X---EBXB------|-E|X---X----B-X----o--B------X------X---
oXB-XX-----XX-------------|-o-----------XX--X-|----?---o---B-oX--B----X-X-X-------------------E----------E--X-----------X------o-------ooE--MB?-----XEoX------------o--?--X--X--X-----------B----o------
----------------B-------X-o-----X-----B--X---o----E------BB-E---X---X|XooE----X----------------------X----X-MM---B--X-o---------X----XX---X-o-------X----X-----X-----X--o-X-E--X-------o---B-----X-X|--v
----X--E-------?---------X-XX----X-o--------B-----oX------------XX--X-X-X-----M------X--M-------------------EX------M--------------?--B----B-BE---X-o----|?--X----XXo--o--BX-X-----------X--o-----EBB---
X--M--X---E-X---B---X--------?E-X--?----B--M--E-----o-----o----X--------oB-----o---E--X--XBo-?X-X---------X--o----X--o-B-----|------XX-X----X-X--X-----?X---------o-----o----X--|--|o--o--o-E-E----X-Xo-
----o--X--X--X----o--MX--o-X-X----BX?-------B----XX----EE--------------o-B-o--X-oM-----------------X-----------X-X---------?XMM-----X---X-X--|-------X--M--M-----XEo-?B----?o--MXB--BX----------------E-
EX----------X--X--------X-------------E---oX---XM?--X----------X------X----------X-XBB--??-----B--o---XX--o------XMX-oo---|X---X----X----X-----X--B------o----------B--o----M-?------X-X-----E?--XMEo---
------o-M--XE-M-----------B-------------X--X---B---o----X-o---Xo-----o--?--o----o-B--------X----------E-B-X--oX-X-X------B----XX--X---o-BX--o----------X--X-X----------------X----E-?-------X-o?---B----
?---E---o--?-----X-X---X--E----|---?M---------------------E?--X----------MX--X-X----?|---?X---XX-B--o-----|-----o----X--Bo-?--M----o----?-----X------oX?-E--?-------X-----Xo--B--------oo---BM-?------X-
m-----B-o--------------X---X|--X---?------X-E-|--|-----------E---X----o---------------oX--------X--X------?-E-?----E-Bo--------------------E-X--X-----E-o---?--E--X-MX-BX-X-?--X------MX--oBX?----EE-E--
XXXXXXXXXXXXXXXXXXXXXXXXXXXXXXXXXXXXXXXXXXXXXXXXXXXXXXXXXXXXXXXXXXXXXXXXXXXXXXXXXXXXXXXXXXXXXXXXXXXXXXXXXXXXXXXXXXXXXXXXXXXXXXXXXXXXXXXXXXXXXXXXXXXXXXXXXXXXXXXXXXXXXXXXXXXXXXXXXXXXXXXXXXXXXXXXXXXXXXXX
