-----?----------------------------XBB------BXXM?BBX------XMB---BB------MMBMB------------XMMBX---XXXB-BB?oX--------------------BBX-------oM------------B---------XM----------------------?EBX?--------oX-
---------B-------------------------??-----EX---------------oM-----------------BBXoXX--------XM--XX-M?B-B-----------------MoBB---B-----------------BX------------------------MBBB-------------------oB---
--------------EX-BBB---------B----B-----------------B------BXXBB?-MB-------------------------------------B--------?B------XB----------------------BBB-------BB-oX---XB---BB---------BB-----------------B
XMX--o---------BBBBXBM---------------------------------------------------------o?B-XX--------??-----------X--oB-----o-----------------B-----?XBBB-----------?---------------o--BX-----B--------?-------o
-----BBX-----------X------BXBX--------MBB-------XXXB-BMB-----BB----M?B-------B??BXX-BX-----------B??BBBB-----XX--------------XEXM?-----------?--------------B------?MB??-XMX?--BB-BXXB??BBB--B----------
-----------X---------M-----M-B-----X-----------------------------------------------------------XBBB------------M---BXoM---?B----B----oXB------------------M?----B---------?--------------M-?BB--XM----X-
-----------M---------?BX------M?------?X---BB-------X?X----------XBMXB-----BBB-------BXX--------EXMBB--------XM----------XB----------XMXXB-?BXB------------B----------------------------BB-BM-BBBX------
------------MB----------------BoX--XB---?------o---------------BBB-----XX----------------------oXB--BXB---------------B---------------?XXBXBB---------------------BX--B------XX-------------------X---Xv
---X-------XMBB---B-----?B-XBBM---B-----------------XBXBB?BBBMBXB-------------------MX-----X?BBX-BB------------MBBMo-?-------?BX-------oX?------------XXM---------X----B-------oB----------------------f
---XX-----?X----------------BX---o??-XXXXXB-----X------BXB?B-----BBM----------------------------------------?BBM---------BBB----------------------------EXXB-----------------X-----------------X-------f
----------------------BXXXB--X--------BB-X-B--o------------------------BM------------------------------o?---X--------XX-------------------X----BX-------X-------------B----M---XX-----------oX---XX---Xf
--------?B?X-----------------o--oM-BB----XXB-----o?-------------XMB------------B?-----BXoBB?BB-------B-??BB?-------?------------BBX------MXX-------X----XB--------X---?B?----------BX-B?--B------------f
----------------------------------BoB?XB---------oXXXXM----B?B----------------MBBXXBBBBB------B-XBB----------------BBXB------XBBBB?BB-------BBB--?XX---------XXBMMM?--------------BXB------B----oBM----f
-----------------------oB----B-----------?B------------X?--BBB?-----X---------------?B-----------------o----BX?-----------------MB----MXB?----X------------oX--------------------o-----------o-M-------f
m----------------------------BB?------------B-----TMB-------------X---------------BE--oXB----oXB-MM------T--------BB------XXMM-------------XBX----?BB----BBX----T?---------oB-MBBB--M---MX----------T--X
---------------BX---oXB------------XX---------?B--BBBX------BB------------oBBBB-----XBX---BB-----------X-|?X----------------BB?B-??----------------??MoX----?-o-|---------------o--B---BB--XB-----B-|--X
XXXX-XXXXXX-X|XX-XXX|XXX-X-XX|X|XX-||||X--XX-XXXXX---X|-X-|XX|XX--XX-|XX-XXXXX-|-XXX--X-X--XXXXXXXXXXXXX-X-||X--XXX-XXXXX-X-XXXX-XXX--X|X-XX|-|XXXX--X|XXX|X-XXXXX|XXXXXXXXXXXX-XXX|XXXXXXX-XX-X-XXX|-X-
