----o------------------oX---BBBBBX-X--X-------------B-?B?-----X-X---------?B?BB-------X---BB----------------------Xo---------X---BMX?XMB---------------BMX--------?-----------X-------B--------XXX------
B------BB------------MB---------------X---------o-------------EB?-??----?------------------BBBM-o----BX?EMB-----XXXX--------------M--------------------------------BB-------------------B--------B?MBB-M
o-----------E------------?X-----------------------------X?---X-------B--------------------------?----------o----------BB-------------E-----B-----B-----M------X---o--X?-------X-B-----o-------X---------
------XB--oBB?-------------------------?X?-----------------XX----------------B--------------X--XX-?-BB----B------------------BMB-?BM-----------------M-E-------X?--------------X-o---------B------------
-----M--oX----o---------?B------------B----------------------------------------X------B-------BB----B-------------?-------XB--B-----oB------oB---X--------------o-----X--------?------------------------
----XXX-----B-----B--BM--------------M?BB-?---------o-----XXBX--------------------BX-------------BX-?B-XBB--?--o------?BXM----------------------?-o---XoM-------------------oB------?-------------------
----E----?----B-oBB------X---------------------------MBX---------X-BB?--------BMBB?----MB?B-B------o---------------------------X-----------------------------o------BX--BB----------------------X-------
BB------------o--------------X---------------------X------------------MB-------------X-BBB-------------------BBXXXX--XBBM-X-B---------------------------?XB------------E------?-oBXX---?-----------BBBXv
E---------------Xo------B--------XB-----------?BBX------B------?BBB-----BXB-----------X---------------------------------------B-----B-X-------------------------BB---------------oXB-------------------f
?-------B------M------------------XB------------------------------------------o---o----B--------------------XM-X----------E---X-BBBXMB-------oB-------------?-----X--X-XBE-----------------------oX----f
-----------------------?-------o?---B--M-Xo------------X---X---------?---------B----M-------B?-----XX---------------o---X---X------------o-??B----o--X---B---?--------------------X--------?-------o?B-f
------Xo--X---XXX----X---------BB-----XB-?BBB----M-----------------B-X--------------o--------------B-------B------B--M--X-------------------------XX-----BXXX?M-X----------X-------------------o-B-----f
---------?-------BMX------------------------BX----------------oX--------------BX------XXBB--------M-------------BB--?-----XBB-----X-----------------------?oM---------------------oXX-----XB-------XB--f
------B-XB-------------------BMM--------------------------BBBoBXMX?---MXB??XXBM-o--------BB-------------------X--------------X-B---------------------XBBX?o-----X-------X--B-------------X-------------f
m-----------BMXM---B----M----------BBX-----------------------------------X----XBo----BB-----B-B--------------MB----B??-------------------?BM---BXB?o-------X------?--BBXBBX----------E?BBB----X-?X-----X
XBXB?---E--XM---o---------------------------XB-X------B------------------------B?-----------TX-----------T-BB---X---X------B--Bo--XBBB--------------B----------------------------o-------------BB------X
X--XXXXXX-X|XXXXXXX-XX-X--X-XXXXXX-X--XX-XXXXXXXXXXXXXX--|XXXXXX-XXXXXXXXX-XXXXXXXXX-X-X-X--XXXXXXXXXX-X-XX-|X-XXXX-XXXXXXXXX|-XXXXX-X-X--X-XXXXXX---XXX--XX-XXXX--XXXX---X-XXX-X-XX--XXXXX|XXXXX-XXXXXX
