---o-o-B--E-|E-------o---X|-----------------------BT-----------------B----T--M|B--?---o------------T----o-T-------o---T---------------------o------T-o-|---|---------------------oB------?-M---B--------
-E-o--------B---------E---M------EE-?o-----------------------EB-X--------T---??---------E-----?-----------BE-----o--E--B-E-B---------------------o-----o-----------?-----Eo--X?---------------B-EB------
--------B------------T----B------------------B---o----EB---?--B---------XE------------o-------------Eo---M----------------------E-----?---M-?-E-----------------B--o--------E--------------|----?-------
---B---?------?----E-X------o------------------------------?-----------T----E---?---------------------X---X-----------Bo---o-E--B---X-------------------------?--------------------------o---------B----
--------------E|-------B---B-----o-----------------------------E-------?----|---------?-----------E---ME-----M-?--------o------T---o-?-------o------B---------o------------------B---o------M-o----B---X
T--o--B---------o----------?----BB-?------------B--B------------|-M--B------------------B----E|----B--o---B-----------------E-B----------M---------E--M------B--|-----E---E------B-------------o--------
-----M?--B--?o-X----B---------------E------M--------------T-----E---X-T-------Eo-------o----?-----------B--X----TE--BB---o------------------M---?---B----------------------------o--------B---------o-MT
----------X-T-----?---?----T---------B--------------?------T---X-------?----EB--------------|E-----M--------------?o-----X--o---------------E------|-E-----------------E-------?------------T-o----o---v
-X--------o---------------o---E-?-B----------B---------------------E----------X-E--------XX-B----B----------------------o-----------?---------------B-E------E--X-----B---M--------M?------XB--B-o-|----
-----------T--------E-----------T-----X--E--B--B-----?-----|o---B---------------------------|---------B-B------M-----BMM-M--------------?-E------MM--------oE?---------------o---|----------?E-E---B--B-
---B-E------T-----X----?--------o---|-------------------?-o-B--M----B--M---X----------|------?-----o-----|------oX-o--M--B-EX-----------T----E----?E--------o--|-X--T-E-----------E---------------------
------------?-o--X---------------------------------------?B----------?-----M-----?MX----M--B------B---o---T-B-----------------?---------M-----B-----B-o------------T-----------------------------E------
----------oMo?------?-----------|EB--------------------B------T---?B-------------B-B-----o-----o|--o---------oM-----E----??-|-------B-----E-o|-------B-----------M--------o------------X-B--B-----------
--o--E--?------o--------------X--?-----Bo----o----B-----B------BEB----|----------X---------------X--M---o--------|------B-------?----------------------------M-----X---B-------?-?-------------B----X---
m------T---------|--o-----X------------B--M-----------------------o-M?-E------E-----M----B-------o-?---------M--------X-?----o-----B-E---|------------E---------------------------|-------------?-------
--------------B---?-------?E-M---------o-----------B-o-------B-E--E-M----|--T-B-------------------?----B?--X-------------------------M-----Eo-----------------------B--|-----------T--------M----B---oE-
