---------BBBXX---------------------------------X-------B----------------------------?-----------------------o----X----------------M?-------------------B-o-BBX-----------o------------EB-------------oB-
---------o--X-------------------X-----------BB-X-------B--o----EX--------B------------?--------------?-------------EX---BB-o--EE--------X---B?o---------------------------------------------------------
----------------B--o--------BB----BB??-----------------o-X--BM--------BB-------------X----X-----------------B-----------BB------?------B----------M---B---?------------B--X----------o------------o-----
---BBX--------?-----------------BBBB---BB---------------E--------B--------?---------------------------------M-------------------------M?X------------?BBB------oB-------B------B-----------------X----?-
-----------------------------B-B------------BB-X-------BXM------X-------------------------X---------o--o---------------X-----------B-X-----------EB------o-----------MoM-Xo-----B-----------------------
------------------------BBBX------------------BXXXBBX---------------?oBBBX?-------BB-B------------XBX?X-----BXX----?BB---------EXX--X-B----M?BXX------XBX?X-------BB-----------oE----------XX-------B---
--oBBBBMBB--------?-----------o?----------M--------------oB-X--B-XXX-X--?X--------o-oX-?BB---oo-----------------BXXX----BB-----X-X-B-----BBX--o--BXBBXBX---------------X-----Xo-BBX--------------------B
--------------------o-------------------oBBBX---?X---oB-------o-XBB----o-EB?X-------MB----------------X--MX?-----?B------------------------------B--------B-----oXB?----------MBX----oMM--M?B-X--------v
----------------------------------BB-B----BX----------Xo--------B-----o---X-----------------BX----------------------?BB--------X---X------------?---------BX------B?-XXBXBXXX----o-------------XB------f
B-----------M------??M--------X?-??X-----X----------------------XX-------XX------X---X-----------------------B----BM-------------------BBX?--B--EXX----X----------?BXB---------------------------------f
-------------------X--XX-------E----------------------------XXXM---------------------------------XX---------oM?BXB------M---B------------------------------B----B--X-----------------------------------f
--------EB------------XB--------o--------o-------------X-------B----------XBBo----------------?X-?-M-----XBB-----?---------X?---------------M----?---M-------------X---------------?--------------X?M--f
------?-------E-----------------E--B--------------?XB--X-X??----o-----------------M-------------------XXXX----------------BB---------------------BBX-?---------------?XB-X-X------M--------X-X-----BB--f
-----MBBB?------o---------------B------B--------BX-----------------------------BX-----B---------?-M------?B----------------XXBXM------BX---------MX---X---X-B--X?-------------BBEB------------------BX-f
m----------T-------------M----XX---?----TB-------o--------X-M?-----X-?---E?-----------?-X--------M--T-------T--B-?M---XB--EB--------B-----X--------------oB--B-----B-------E-?----?X-X------?M---------X
--X?--?--o-|B----?-------------M?BX-----|BB----------------oX---------------M--------B--------------XX--T---------M---------MX-B-----------------?-------------B-------------------XB-X---oX-----------X
XX-X|XXXXX-XXXXX-XX-XXXXX|XXX-XXXXX-XXXXXXXXXX-XXX-X-X--XXXX-X-XXXX-XXXX---XXXXXX-|XXXXXXXXXXXX-XX-XX-X-X|X-X-XXXXXX-X-XX--X-X----XXXX--XX-XXXXX-XXXXXXX-X-XXXXX-XXXXXXXX-X-XXXXXXXXXXXXXXXXXXXX|XXX--X-
