----X----------------------XX-----------XXBM-----------?BXB???oB-----M---------X------------------B?---------------B---oXB--------EXBXB---XX----------------XBBBBB-------------------XBB------BB--------
----E----------------------------?B--------------------------------------------------------------XXXX---------B--------------------oX-------------------M-X----------BB--BBX--------------oB------------
------------------------BB---XBB-BB----------XX--------XM---------B---------BB---EX------------------XBXXBXX-----------X---o----------XBXB-------BB--------oB------BB---BB---BMBMB-----B?BMM------------
-oX---------------BXXX?--------XBXX-----M??-MXX?--M?BX-------------------------------oBBB-----------------BBBB--BX-----------------BB?------XB--------B-----------XXXX--------?XBX?BB-------------------
-XMX-XBXX------------------------------X?M?---------B--------------------------BB?B?B---?BBB---------------?-M----------------------------?-------XM----------------B??B----X-------------------BBMX----
---X-----------------------XXXX------------------BXXB---o--------------------XXB---B?B---------XXXXXBX--BB?--------XBB?M----X?BXB-------------------------X-----------?-----B---XBX--------B------------
----?-------------BB---XXX--------o----------------BM--X----??-------------------------------------------BB--------X-------?MMX---??XMB---------------------BM--------M?------------B-o--------?B-------
-----------------------------?B--?--------------------------------------BBXBM-----?X------------------------------------------------BB--?XB--Bo-BB?--MoX--XX----------BBBB----------------M-BBB-----X--v
B-?BB-------------------------XBBBBB------------o-----------------EB---oX----?BX-------------------------BX---------o?--------------------B-----------------------------------o-----X-------?--BBB-----f
?XXXB-----oBB-X?----oX--------------oXBBBBBXXBXBX--------------MMXXB---BX-???XB--------------XMX------------------------------------XBBB---------------------------?--B----------------XB?------X------f
---------X------------------------B---------oB------------------------------------------------BBMB-XXoBBX?X?-----------EBX-----?BB?---??M-----?MB------------------B?oX------------------X-------------f
-------oB------------------BX------------------?X-------BBXM----B---B-----XBB-----o-BXXB------------------------------------BB?BB?XX--------------M---XB---XX-B?X--?B----B---------oX-------BBXBX---BBBf
--------------------X--------X?--------------BB-----X?----------?B-----BXBB------------B--------B?---------XXX-----BXXB----------X---------------X?X------BBBB--M--------B?B--------------------ooBBBXXf
-----?BBBB--------------------------?X----------------BB-XB?------------B--B-----B----XXX----XBBXB---BB-----BB----XX--MB-----B--------BX----------------BBBB---------?B?BBX-----BXX--BB-MB-------------f
m-----------------------MBBBMB------------BX?X---------------BX------BXX---XB-----T-------BB--------XMBB-?Bo----------BTBBBBBB-MXBX----E?----B-------------XM---TM----------BM----------------------TBBX
X----------BBBB?----o-----------oXMB-MX-------BBXXX-oBX---------M-XXX--------------BXB?---?BBX-------------------B-----|------------XT-----------oX?X----------BB----XB-B---------------------------?X-X
X--XXXX--XXXXXXX--XX-XXXXXXX-XXXX-|XXXXXXX|XX--XXX-XXXX|-X-XX-XX-XXXXXX-XX|-X-X|X-XXXXXXXX-XX-XXXX-XXXXXXXXXX-XXXXXXXXXXXXXX|||XXXXXX-XXX-XXX-XXXXXXXXXXXX-XXXXXXXXXXXXXX-XXX-|XXXX-XXXXX|X--XXXXX--X-X-
