--?---T-TB-----?----?X-----------o----o------------|?T-?--Xo--o--------------o-----------XXB-----B---T-------------------------T-------------B?-----BB------BX---B--------B-E---XX--?---------BBBB------
---?----------o----X------------B---------------------B---M---------M----E---B----------M---M--XB--E----X--E--------------------o----------M---M--T-E-|-------------B--------X-MX--|-T-?--o-------------
-----------------E?---B-X-----?M?X?-----TMMM--------|---B---------?-----MXXBXB---M-------TBB-E-TXB--------------T-o----o-----?-----B?BM-XB----XB-MX-?--------?B?------M-----o------M--o-----B-----?-----
-----------------|-----?---B---------M---E--------------T---o---o-------------E--------X------M----------------B----TX--X--?--?-----|----o---X----------------M---o-B-------?o--M------------T--?E----?-
----??B--?X-X-BXB--B------------------TB---------------X-----------------------------------------B-----oB---T----X---------BM--MT--|--------------------------------------B--B---??-----TXB?-|?BB-----X-
|-------------------B-------------------------------------E?-X-------------?-X---B-----T---------?-T-----Bo-------------B------------------oM----X--ET---------o------------E--------------------X------
---|?----------o--------oXoT--------------T------|------------?-X---|-M-----------T-----MX-----------------------X---------------X----TE|-------B----------M---M-----------B------EX-X-T------B--B------
-----------------T-EXo--------------------|?-?-----------------------------B--|X--|-----?--M--B---------------------|B------BoMXX-X-----B---X??-X-------------------X---------o---BXXMMBB---XoXX------Bv
---B-------------------X-------------B---------T--------------------B-------------------------?-----------------------------B-B----?--?-------T--B--o--o------------?------------------------o--o------f
-BXB--T------MBoX--------------------------B-X---------------------B----B-BX---------E-------BB---XBTXo---------o--X?------------------------------XB----------------------------------B------T--------f
-----------B-X-----o-------------MMX-X-----BB-----XBB----E--B-B------------------------------------?B-XMB--o-----BB-??X?-----------------oX----?T--M------?XB---T------?B-------X-------------|--------f
-------BM----------Xo---o--?-X-M|--------o-MX?-------------------------------o---To------|--------------------------o--------?----------------BB---------T-X-oB-|?X-----------------MM-B-----X----B----f
-------------E-----E-------o----------X--B--------?M|----------|--?-------------?---------B---XM----o-----------?-----M---------------|-----B------------------??-----B-----EM---o------------BXE------f
---------------------------?|--o--X--B?-------------------M---|---------?B-------|----|----E----------------T-----------------------------------X-??------------oB----------------o--------------------f
m---------------EB-X------------o--?-X---TX----------E-----------E--o------MXX-o-------------------oX--o---T-----?------------T|-?---------XX-------B-?---??---------B--?-----X--------BX-------|o--X--X
----o-------XXXo-----------B----B-EXX?---???--------M------XXX--Bo------EoB------------BB-XB?-----------------------------o---|B---------B------------X|BX-?X------------------XB--B-------------------X
XXXXX-|X--XX-XX-XX-XX-X-|X-XXX--XXXXXXXXXXX-|XXXXXXX-XXXXXXXXXXX|XXXX-XXXXX--XXX-XXXX|-XXXX--XX-XXXXXX-XXXXXXXX--XXXXX-XXXXX--X--XXXXX-XXXXXXX|XXXXXXXXXXXXXXX-XXXXXX-XXX-X-X-----X-|XXX-|XXX|XXXXXX---X
