----X----EX-------XX-------------o----o--------oE---X-----------------B-EEX--?-o--E-------X---o-M--------X------X-?-X----?----E--X-?Xo-----X--E--------------E-M--B-?-------X-X--------------X---X------
----------X-----E------?----------X-T--o-----------E--------o---------X------------o---X------o-E--o---o--E---------B---------------X---E-------------------------E----B-?------------?---o-------------
---?--X----------o-B--o-----X----M--|-------E-E----------B-------------X-oo---XEE----?-X?------------------X-----------------------?----X----------?E-----------E-E--------E-X-------XE-----E-----------
---XB-X---------?-----------o-------|Eo------M----X-oX-E-----------------E-------X-------o------?--o----------E---MX----------B--B-X-B----------o--E-----X--XX--o------X-------------B--X-B-----------XE
----------?------MX----------o---?--XX------B-----B-E---------E--------------------X-X----------------------?--------X--o--E--------M-------------------------BX----X--BE-----o----------o------B-------
-------o----------X?-E---------o----oXX--?---?--------------?-B------------------o-XE----E-X--B--------E------------------------M------------?-----X-o----X----o------------------o-E-------X-X---------
B----------XB---X--------------------o--------X-------?---------------X------X------o---X---------------------B----------X-?----------?M--------?--o------o-----------------------B?oo------o---o-------
T---o--B-M-----XB---o-----X-XX--B--E----o-XE---o--------Bo-oB------o----------B-o-------------------------B-------X-------XE-----?-------------o---o---X-----X-E----?------------------B-M--E?E--------v
|---oo--------M-----o---X-E-?E---------o-----------------X---B----E--E--B--E-B----o-----?----o------o-X--------------XE-------o--------X--X-----------E-E---X--------------------------------X---X--o-E-
XX------------------------?M------B-?E-E-----------E-----X----B---E---E---B--o--------------E----B----X-------E------------X-o------?------ME-X--E--------B?-----o------------E---B?E--?M-----E---?-----
X-B-B----------?-------?-------o--M--BTo---X------------o-XX-------------o------M---B-E---X-?-M-E--o------X----------M-?----X--BB-?--o----oX?X---------E----------------o---------B-------E---B------?-X
-XX-Xo-o----T--XM---o------o-----X-?--|--B-E---------Bo--B---XE-----XX----------X-X--E--o---BX--------o---X----------------------T-X---ET--E--------oE-BB------X---------X-X----X----T---------X-----B--
--o?------oB|--M-------------------E?-|---------------------T------E-------o--------------TX----X----BX----E-------o-T-----------|B--E--|----------------------EE--X--o--?-o---T-EE--|--X------E--------
----TX-T--B-|------T--X-T-X---TE------|T-BX-----T-?T--------|---------T-T-M-----B----X--T-|B----T-oXTT-------T---T?-X|-?----B---T|-XT--B|--T-X-T---T----T---E--o-?ToTTTX-BEo--E|--T--|--XT-------BT-MToo
m-o-|X-|---M|E--XE-|----|-----|--o----||--------|-M|--X---E-|--------X|-|--o----oE----X?|-|---X-|---||o--XB--|---|---|-X--o---o-|XXo|--?|-X|B--|---|X-X-|------o--|-|||---?-XX-|--|--|---|-?EEE---|--|--
XXXXXXXXXXXXXXXXXXXXXXXXXXXXXXXXXXXXXXXXXXXXXXXXXXXXXXXXXXXXXXXXXXXXXXXXXXXXXXXXXXXXXXXXXXXXXXXXXXXXXXXXXXXXXXXXXXXXXXXXXXXXXXXXXXXXXXXXXXXXXXXXXXXXXXXXXXXXXXXXXXXXXXXXXXXXXXXXXXXXXXXXXXXXXXXXXXXXXXXX
