---------BBMXX---------------------------------X?B-----o----------------------------?B----------------------o----XMMB------------B----------------------X-------------o??------XX---------------?----?X-
---------o--XB------------------------X-----------------------------oXB?-----------M-M?---------E------------X---X--MB---BM--M--BBB------M------------BMBBBX----------------------BBX-----------B-------
----------------B--o--------BBM---?--------------------o-XXM?XXB------?o-------------B----B?----------------B-----------B-------B------------------------------------------EBBBMB--------XB--------X----
---BBXXX------?-----------------BBB----B----------------BM-------------?X--------Bo----------------------------------------XX---------------M------------------------X------o--------------B----------X-
-----------------------------B-B------------BB-XX------BB-------X----------------------?------------B------------------------o-------------------------------E---B--------X-BB?-------------------------
------------------------?BB?M-----------------MXXX??X---------------XBBBBX?-------BB-BB-----------XBX?XB----BB?B---?BB--MB-----------------------------------------XB-----B--------------------X----XX--
--oBBBB?BB--------B-----------o?----------M---X-----------------------------------B-------???XB-----------------------------------?BX----E?---BX-------------------o--B-------------------------------EB
--------------------o-------------------oBB-----?X---XXB------oBBX-----o?EBM----------------------X?-------B------------X----?XX--o----X----------------X------------------o----------XB---XE-B---o----v
----------------------------------BB-B----B-----------XB--------X-----oB----------?--X-----------------M---B--B?-------X----B-------BX--B---------?---B-------o-------------?X?-------------------X----f
B-----------BXX----X--??o--------?---XXX-B--------------------BM?--------------------------BM------------------o------------------------------------?B----------------BM-------o--X---------------BX---f
-------------------XX----------------E---------XXBX-----XB----XX-----------E------------------------------o---X--X---XB-------------------EB?-oB------------------X------------X---BB?B----------------f
--------EB------------XB--------?M-------BXXB----M--o-------B?------?MB-----------------------------XBX-----?--XM------M?------X--------------------------?X------?-----------------------B-----B------f
------B-------E-----M--BX-------------------------XM--BMXX?-?--MB-------------X-B--o--BB-------oB?--BB--BBBMXX-------BB-E-----o--------M-----------?-----------------B-BB----------o---BM---------M----f
-----EBBB-------X---------------??XXX--B--------B------------------------------XX-----BBX-------?-MB-----?B----------------X--BM------BBBB-------M----X---B-B--B?--------------oB----------oX----------f
m----------T-------------MB---XBB--B----TB-------o--------XTM?-----X-?---EBX----------?-?--------M----------XB-BB?BX--XB--E---------BB----X--------------BX-TX-----B----------M-----------------MMX--TXX
--E---X--o-|-----?-------------MBBB-----|-B-----B--TB------|XXBoM--?B-BMB---oB----------M-B-oX---XXB--E-----B--B-------BMBBBBo-B---MB----------B-B-B?-------?X--------B----B--X------------o--XBX----|-X
XX-X|XXXXX-XXXXX-XX-XXXXX|XXX-XXXXX-XXXXXXXXXX-XXX-X-X--XXXX-X-XXXX-XXXX---XXXXXX-|XXXXXXXXXXXX-XX-XX-X-X|X-X-XXXXXX-X-XX--X-X----XXXX--XX-XXXXX-XXXXXXX-X-XXXXX-XXXXXXXX-X-XXXXXXXXXXXXXXXXXXXX|XXX--X-
