------T-X-X----X-----------------------X-E--?------E--?-MXX----X---o--E-X?---oo--ME-------------M--?---XB--B---------?-------X--oT--XM--X---XB-----X---X?X-X------------E---o---X-BEE?------o--oX-o-B---
------T---X---XB-----X-X--------------o?-E---E----X---------X--?X--B--E----------oX----Xo-----X-?---B------o-----X--------o--EX-XXX--X---------o---?-------X---?-X---X---X--X-B---?--B-X-oX------o-oo---
XX----|--?-----o--o-------------X---E----------XB-----------X--------XX----------?-X----------o----------B------------X-M----XX------o---o-----X-------M--B----X----B---X----E-----X-----------X---BX-?-
X-----|---------Eo--------------------X-----?--B--X---?-o--?-M---------X------o--XX---E?M--?XMB--?----E--B---XE-M-?B--?------X------------E-X---?------X-------------------------------X--------X-------
----B-|X---X-X--?XB--oooX------X---XEXo--oXX------------E--------X---------o--o----Xo---M-X-----E----X------------o----o-----------X---oo-o-X---Bo-----o--X---X---B------o--oo---E-X----------E---------
o--X--|B------o------X----B---o-----Bo-X----------oo-B?-B-------------------X?X-----------XX------o-o-X----XX-?---B-----B---XXoX-oB-----?XE---X--------Xo-Xo--oX-o-X---X------o---X------?---?----X----X
----E-|--B--X---o--M-oBo----MX--?X---B--BB---------X-B----X---o----X--o--M-----o--o---M----B-B-------X-------?--?--o---M---?------E---X-X-B-B-------o-------XXX----o-o---X---------------------o-----X--
----o-|---XE-E----------X------E----X-X-o---M?---?-----X--XBB-------------------E---X---o---X------------XX-Xo-----X-M-?--o----------------o-----B--XX--------XB----B----------M------oX-----------Xo--v
BX----|--------o---XX?B-----XX-?---B-------B--X----------------Xo?-----?oX------X-----B----B-?-X--------------o--------X---X--------M-------B--X-o---------------------M---X---X--B--?------o--X--?--??X
------|-------X-----X-----XXX---o--B---M-----?-------------------X-X----------?--Xo----X-X------Xo-------oo-BX?--X--EX---o-E-------X--------oM---o-----oo----------------X----B-------XX---X--X---------
-B----|-X-----X?--X-----B-------X-X--B--X--B-----B-----X---------B-------X---X-----X-X-Xo--o-----E---------o------o--?-----------------o--o-----X---oXooX-----B--X----E---------B---?--E----------------
--X---|----XE--o----------?--EX----o--X----B---o--?---E----?---X---X-----------BX-XX----?--o-------X---------X--o-E--X---M--X-----E-o-----X-----X-M------X-X---X-----X----X-X--o----X----o-o-?---o------
X---X-|-XTXo-M---------X-o-X---X-E-----EoX-----X---XME-X-X--X------X-X-E---X----o--X------------?------B-X--B--X-------------------------------------o---------XX-o-M---------Bo-X------X-X--X-------E--
-X-B-E|--|-T-BX--E----------o-Xo--B---X-B-----?----X------------------X--o---X--o----T---X---X-X--BX------T-------?-X----?--X-X---TX---BX-?-----EXXXX--X----X-B-o---B--E-----X--T--X---X-----------?---o
m-----|--|-T---o---------Eoo------------XX----?X--X------B---X----X--B-B-X-----?-?oX-|--o---X?-----X--?---TBX-----|--------o-XT---T---X-o----B----------B-----?-----o---X--EX---|--XX--------M----------
XXXXXXXXXXXXXXXXXXXXXXXXXXXXXXXXXXXXXXXXXXXXXXXXXXXXXXXXXXXXXXXXXXXXXXXXXXXXXXXXXXXXXXXXXXXXXXXXXXXXXXXXXXXXXXXXXXXXXXXXXXXXXXXXXXXXXXXXXXXXXXXXXXXXXXXXXXXXXXXXXXXXXXXXXXXXXXXXXXXXXXXXXXXXXXXXXXXXXXXX
