-------oXX------------X--------------------BBo??----------------?B?--------------oM------------B?B---XX------------?B----B-----BMXX-B-----------o??B---------XBB-----B----------------------------------
XX-----XB--BB-----------------BB--E-------------------E-----B-------------o-----------------X?BBBB-------------BBX-----BMB----------------BBXX-----------MBBX----------------------XX-------------------
ooM----------------------BBBXX--------------X-------X------BX-------?M-------------XB?-----------XX?----------M-XX---------BBX?------X-----------------M-------B?------X----BBB-------------o-----------
-------------------------BB??XoBBB-----------------XX----------X?X-------o?-------------B?-------------------------?BBB---------BBB?---XM-------------X-------EXoBB---------------------------------X---
---B?M--------------BBB------BXX--------Bo------------X---------------------??B-------o----------M-----M---------------------------------?BX--MXE----MX-XB---BB----X?-----oBBB------------XX------------
---BB------X----X---------BB--X----------------------BBX?--BBB---BBB-BBX----B------------------XB------BB---------------XB--XX-------------B----------BM--oB---------------------------------------XXXBM
-MB------XX--MB--XXMMB?---------------XX-----------XBBBX--BBB?-------------------oBMB--------?BE??XB---------------X-BBB---------??B---X-----o-------------MB---------BBBB-------------XX-----BX--------
-----------------X---------BBBXMX--X--------------------------------------BBMB---------------XBX----------------------BB--------------??BoB-?B------------------B------?X--?XM----BB-XXB-----MoB-------v
--------BX---?--------BB-----------??XoBXXB----------------------MBE?---?BB--------------BX?X---XB?BBB-----------------------------BX--------X--?---MB----------??-XB-----------------------B-------BX-f
---------------------------------BXX-------------------------------BoXBX------BBB?XB----------BBB----------------oX-----------BMB-oX----------o---------------------------------X----------------------f
----------B??B-X?----------------------------------XB------------------?BM?XBM---------------------------?XX---?M----------------?BB-EBB-----??o?-XM-----BM?------BBBXX??--------------?BX---------M--Bf
------------XMBB?BX-------------------XXB------oBM----------------------------------XBX----EM----------------------o----BBX?------B?X??BB-------------??------------?BXXBXBX-----------------B------o--f
-----BX--------------------------------------------XX--------B-----------------------BM-------------XB----------B--BBB-----BB------MB-EM-MXBBMXXBB-XBMB-XBB??B------------------BXBB-------------------f
----------------XBXXBX-----XE?X-?BBB--------MXBX----------BX----MB--o----M---------------?X-----X-------------------------------------?MBX------BX----X--------------------------------XM-oBBXBBBB-----f
m---------------------------MXXBX---------BB------------------XB--oBMB----------EM-----?B-----oB--oM?-oBBBB------BTX---XX--------BXBX------XB-----------BBBB--o---------E?BXX-?B---XXXo----------------X
X---XX?------------XBMXXMB-----------------------------X---------------------X?-------BXXBB---B-?-B-??X--------------BX?B------------BBB------------BBX?B---BB?B-----X---BX------------BB---T-------B--X
XXXXXXXXXXXX-XXX-XXXXXXX|XXXX--XXXX|||XX-XX-XX-|X|XXXXXX-XXX-|XXXXX|XXX-X-XX|XX-X-XXXX-X-XXXX-XXX-X-X|X|XX-|-XX-XX-XX|-|X-X-XXXX-XXX|-X--XX-XX-|XXXX|XXXXX-|XXX-X-XX-|--XXXX-X-XXXXXX--XXX--XXXXX-XXX--X
