----------X----------MX----------------XBB----------?-X-BB-----------?BB----------------X-----------X-?B----?----------------o-M------XB---M-------X-X-----B-?-oX?XB-------oM----------------X---?-BB---
-------------------------------------?-X-----XX---XXBB--BB---B----------o-------------------------------o-BM?B-B---------------M?oXBBBBX---------------------------------BB--BM-----oX--------M---------
--------------------B---oB-----?--X-----B-----?X-------------------BBX?----oBB-----X-----------X---?------------X---?-----------X----B--------------??X-----------X--------------------------------EB---
---------------XB------XB-----BBXB-------------X---------------------------------X--?BB------------------o---BM---------------------------------------------Xo---X--------E---B----X---------B?B--------
------?----X------------------o---o----B?----o---------B?M?-XXX-B------BBMX?----XB-BE--------------MXB---------------------------X--B-----------o-------X?XBBBBX----B-------X---X?--------------BB-XXBM-
-----------------XXBMB-XXX---------B-----BBBB----B-------------------------BX---------BEBBX-----------?MB--------------BB----E-----------X--------------oB------??BB--B?-X?------XXB-X---XB--BXM-BX-----
----------?------------XX-------X?------E-X---------B----------------------o-------------------X---MBBBM-B?B?B-----X-XBBBB------B---------B-XXB-----------------------X-BB-----------X-X-----B-------B--
BM-X--o--XMXB--B-------?-----------XX---B--------Bo-----------------?X-------BX?------------------X-X-------?X-----------------Mo----X----MBXBBBB?o---oo--?------B-BBBB----MX-XB-----------MB---B------v
---------X-------------------------o----B-----------------oBX-------------------------o------------o-X-?-----------------oE----o----B------B------X------BBB----oX?---------------o--------X-----------f
BB------?-------X----BXX-----------------------------B--B-----BB--XBB---oM----------------------------B-----X---?M--B--XoBBB----X-------------------------?-M----B------------------------------------Bf
-----BX----M----------------BX----------------B--------BBX?-XB-B-------B--?--BB--X-----------B?--------Xo-------MXBB--XB--------------oBB---------------------BB-----------XX-------------------B---B--f
-----BB-------------------------B------------------------M-?B-----X-----X-----------B------B---E--XB---E-----B-E----------------?XB?------?------o----oBB----------------X-------------BBX?MEMXB-----oBf
------------------X---BB-----B?XB--X-----MBB------XooB---------------XXXXXXX---------B-B-X------------------------------------------EXB?BX?B---------MXBB-X--------------------o-------------------oBBBf
--------M-B?MMB--------E-----??-X----X?--B----------oB?----MX--------B----?BBM?X-XMM---X--X?XB------------------------------X---BM---??--B----MM--------------oXX-XBM------oBB---X----XX??-----B-o-MXB-f
m----B-----------?------X-M----------oXBo-------------M??--o---------------------------B-BT----------------------BX?------XB----------------------MB----o-B--------X----XBBB------?BBoM---------o------X
-BBB??-----BBB------BBBTBBB----BXB------------X?XMBBX--------?XBXM?------------?----BB----|--BB-----------------B----XXB?---------o?X-XBBoBXXM?-----------------------M----X--X--------X----oXX-----oX-X
XX|XXXX-XXXXXXXXXXXXXXX|XX-XX-XXXX-X-XXXXX|XXXX|X|XX-XXXX--XXXX|XXXXXXXX|XXXX-XXXX-XXXXX|X---XXXXX-XX--XXXXXXXXXXXX-XX-XXXXXXXX-XXX|-XX--XXXXX||-X-X-|XX-XXXXX-XXXX|X-X-XXX|X|XX|XXXX-XXX|-XXXX-XXXXXX|-
