--------X----B--M----oMM--------------BBBB-------B----------------------------X?---------------o---------MBB?---XB--------B-------------?B------MXMX-X--B----?------------------------------------BBB---
------BE?E----------XBBBX---------------B-----X-------?--B-------XX---XBBB---------------XM---------------------B?B----------------------BB-MB---------M?XXBBXBB--------B--B-BB?----------B-------------
-------BBBXB----------XBX?BB-XBX--BM-----BB?------?---------?MM---------------X--B-?oB-?------X-----B------XB-------BB---------M--B----------------------------------XX----B-----M-------B-----------X--
EB?------o------------X-----------------?--------oXBoBM?--------oXB--------------------------?X-----------E----------------------------BBXBXM---------BBB---?-----BBXX---------B-----BBXXBB-----XB-oXB--
----------BXXB----B------------BB--------B-B-----------B-BX---------oM---------XXX---XB----------------E----?B?------X--oXM-BB------?B--------------------------------------------------------oBM-------
----E-?B----------XXBBX-BB---------BMBB-----------------------------------------------E-B--o----------o-------------------oBB--------------------------BBB?--------------------------------B-?-BXBXBB-o-
--------------------------------M-------------------B-----------------------------------------------XB------------------B?M--------X?---?BMB------oBMBBXXBB?BXB--------BBBB---------------XM-BBB--------
Bo?BX----BBXBX?BB---------------BBX-----------------------------XM------------------?---------------BBXo--------o--XMMB?BBX-B?--MB??X-------------------B?X?B-------------MMBBB--------X-??------------v
--------------X---X----BXB-----------X---BX------EX-X?BBX-------XX--Moo--?---------------?B--BB-----------BB-B---------------E--------------B--------oB---------BM---?-MBM---------MX--------?---------f
---------------------E-M-------------------oMMB-----X--------??BB---BXX-----B?---------------XX-------------B??M-BB------B------BB-M------------------------?----------------MB--B-------------------BBf
--------------------------X-------?B---------??B?-----B---?BB---------MoBBM--B---XX----------------------------------------------------------MXMB?XB?---------------------BMB------X-----------BoBX----f
-----------------------------------?XX-------BBB----------------------o--------X-BBBBB-------XXM--------B--------XBBB------MBBEX--MXBXX------BBBBXB--------BX-----XM---X-------BXBBM----M--------------f
-----------o-------E---------B?------Bo------oB?---B--------XMX-oX----------BMo--BB---M---B-----XM------B---------------------------XX----------------------------B-----------?XBXB---B---BBBBBM-------f
-----------BXM?X------------------X-------MXE----------------E--------------------XBB--E---------------?--X--BBX------------------------BBB-----------------------XB-------TX-----TB---------o--?------f
m---------------o--oBX?------------------------------BXoM------?XX---------------------XX--M--------------o?---------X---X?B?T---EB?-------BBB---B-------B---B?M------?----|------|----------?BX-------X
XX---X?BB--XBXB-----BBBBBBX----XB-------------B-TB-----------XXBXB-------------X----MX--?EX???X--MB?B----------------X-------B----------------B-XB---XMM-----BX?-?XBBBBXXXXT??X-BXX?-XXMB?B-X-XX-BX--X?X
XX|XXXX-XXXXXXXXXXXXXXX|XX-XX-XXXX-X-XXXXX|XXXX|X|XX-XXXX--XXXX|XXXXXXXX|XXXX-XXXX-XXXXX|X---XXXXX-XX--XXXXXXXXXXXX-XX-XXXXXXXX-XXX|-XX--XXXXX||-X-X-|XX-XXXXX-XXXX|X-X-XXX|X|XX|XXXX-XXX|-XXXX-XXXXXX|-
