-o--B-BoE?--X-XXXX--o---Xo--X--------XXX--------------XXBE---MX---X--X-----o--o----o---o-B-B--oo--XX-o---X---B--o--M------o-X----?-X?---------?o-MX--E---oX---?-X-----------M---MX---X-?o---|----------X
----------o?----?X--XX--B-E---------------------X-B------X-XX--o---------X-B----------X-o----o----B-----o----------M----X--------X?-X----------------?-------o--------X------------XT-----------X-------
-?-oX-------XE-X----E----X--E-------E--X-B--M-----X---Eo---X----B-----X----M--B-BX---?-----M--M--X----E?-----o--|----X-B-------o--X--o-X--EX------X-----E---X---Bo-----XX---o-------|--X-X-o--------o---
-----------E-X---------X-M--E--------XX-----X-X-?T-----M-----X---o--B----X-o------XXB?--o-oXX--X-----------X----o------Xo--M-----X-----------B-------?X----E-----E-?B--XE--XX----B--|----E-B|-----B-X---
?--------X-|-----X--X-E-XX--X----Xo-X--M--XXBX-|-|-----------X---X-o-B-----E-M-X-XX---------B----oo-X----MXX--X--E----X-X---X?----------------o---X-X---|----E--X--X---?--X---X--?--|---X-------B-------
---X-------XX-?------------X---o---XB----XE--E-----XB--|---?----o-o--------X-----X--X---o--?----M----X--XBX--EEB-XX-?-o--o--------XX---X------XX--------M-?-M-X--------X-----?-?X---|--X-|B--E-----X-B--
-X---------------------X-X-|o----X-------B-X---B-----------------B----o-M------?EX-----X--oX-BM---o-----X|---------------E----------E----X--X|----oE-------X-oo-B-o----XX-?E--------|-o-B----------?----
X?--------XoX------X-X---X------X---X--X---------?--oE-----?------M-o----X------?--X--------X-X-------B----Xo-?------MM----E---B--|B-X|----------M-XE--B--X-X----X--X---------XE-X-o|------------------v
--X------------X--X-------X----------X------X?--o------o---X-?---------X--X------------------------X--------X-BB---o-------X------------X-------o-B-----------------X---X-B---XXM-o-|X---|----X-X-B---BE
E-------o----------X-o-----|XMX--------------E-X----------o-----B-X-------E---------XX-----------XoE?--|--E-X------X--B----XoE---X---o-?XX-------E--X----XXXX--?---oX----B-?------B-|-|-o-X---------B--E
|--------X---X---o-o--o------X---M---X----X-XX-X-----X----------------------B-B--o-XB-----BB-------------?XX----X--X---XX-o-E--?-ooo--------X----X-XB--XE----B----X-o-----------X--X|------o--------B-oX
-Xo---------B--X---X---o----XBX---BX----------M----X-----X----------X----B--X-----XBX-X-----BX---E-X-------X-------------X-----oX---XX---------?|-----X-X-XBB--oX-----X---------X---|B-----------M-----M
-----?-------XX-----M---EXo-E?E?X-X--X----X------MXT--------------------?---------X-X-MXE--B--XX--------X----B----------Xo||---M--X---------E---X---------o------|X---XX----Bo------|--MX----XE-EM-----X
---------M---X------X-oo--B---X--o---o-----------B-|---BX----BM---|--ME---B-X---X--------o---B-------X--|---o--?------M-oX------E-B------oM--X-X------X--o---?--------X-E-B-B-----X-|-o-------?---X-----
m----X|-B-------BoB----------------X----------X--------o------------o---------X--------B--o-?------X-B-X-o----B-EX-M---X---------X--------o----------B--------------?E-o---o---XE---|----M----X----E----
XXXXXXXXXXXXXXXXXXXXXXXXXXXXXXXXXXXXXXXXXXXXXXXXXXXXXXXXXXXXXXXXXXXXXXXXXXXXXXXXXXXXXXXXXXXXXXXXXXXXXXXXXXXXXXXXXXXXXXXXXXXXXXXXXXXXXXXXXXXXXXXXXXXXXXXXXXXXXXXXXXXXXXXXXXXXXXXXXXXXXXXXXXXXXXXXXXXXXXXX
