-----M------------------------BMMMB-BB----------------------M---------------------------XXB---------BBBX----------MM?X----------------------B-------------X------BM?----BBB-BB-B---B-BBXB----B-------?M-
X?-------------B-------XBBB-o------X-------BXXM----MM?----------------------X---XB-M------MX--B----B--------------------B-------------Bo-----------BX-------BB---------------------------E---X-XX------M
-----BB----------o----------X-BE---------MB----------B--------------XX----B-------------X?----------?Bo--?----------------------o--BX--------o-----------BB-------------X-X-o---------------------?X----
BX?XB----------B----B----------BX-----------------------------------------------XB-----------XX---B-----------o?--BMB----------------BM?-------B---------------X---BB-----XBX-EMB?BXBB-----X------XXXXX-
---------XB--------X-XBX--BB-----------BB----oB---MX------MBBXM-----BXBBM------BBBB------XXX------XX?M-?B-----------------?----?B-------------B-------BXBMX----------------BBMX---MMB------------------o
------B?X-----------------oB------B-B-----?-------oX---X---------------?XB---------BX---------------------XXB--------------B-----------------?------B-M-XX----B------?--------------M-----------oBB-----
-----------------------------------o---XE----oBBX?-----------?X?------------------------X--------EB--?------------BBX-------XB----BB-?--X-XB--BMBX-XoX----X----M----------X----M--------M--XMB------M---
B-MM-----o--B-X---XB--------oEXB-X----------X-B---M--------XB---------------------------BX-BB--B---?----------o-----X?o------X---------E--M--B----------------------?---------------Xo--------o--M-----v
B--X------?----?BMM----M-MX-------------------------------o------------------BB?X---B--o--oB---B----------o------o------BB-E-----BX--------oX----------------------------------X-B-B-X---E----BB---MBB-f
-------------------------------------------BEB-----------BX---------M-B------B-----------------------------------------------------------------------XM-B-------------o-??B-----XB----X-------------XB-f
------------o--------------B?X----------------BXX--M---?-----------o-B----oBB--------------------------o----M?B-------o--o-----------------X----X-oB-------------B??o---------MMXB--BBM---BX----------Xf
-------------------------------o?-----o---XX---------BX-----------o----MB----oBX?--------------------------?B------M---?-------B-----?B-----X--X--BB?-------------------?----------------X------?------f
-------M--X----------------------------MB------------------------B----------BBB?X-------------?M-----oX---------------------BBB------------------X---oBB-B------------B---B--------X-------------------f
----------------BX?XX?------------------------X---XBXXX-------------------------M----------------------BoB---------------------------??XX---------------??--------XXM-?XXXB---------X------------------f
m------BBB-BX--------------------XBM----------X---?M-----------------MBB---BBBBX-------------?-B--BM-----------E?----XM-----------XX---B?-----------o?-----------------B?--------------?BXX?B?----BBXB-X
XXBX----------B---XX--BBM---B--------XX--XXB-------X--X--EB??BX---------------------XX--BB--------XB----BBBBMXXB---EBM?XBX------------M--X--MMXXX-XXXXBXB-BBMXXXB-XXX--XBM-?BBBM---XM?--X?BB?XM-------BX
XXX|--XXXXXXXXXXXXX-XX-XX-X-XXXXXX--XXXXXXXXX--|X-|XXXX--XXXXX---XXX-X----XXX-XXXXXX--XX|XXXX-XXX-X-XX-XXXX|X-X-X-XXXXXXXXXX-X-|XXXX|XXXX|XX-|X-XXXXXXXXXXXXXXXX-XXX|-|--XXXXX-XXXX|-XXXXXXXXX--XXX-XXXX
