--------o-----X---------------------BB---------------XX---B-BMB--------??MBX------X----X?------BX--------------B?B---X--------------X------------?B?------------------B-----------XB--------------------
-----------?-?X---XX-------------------------------------?M----XX?BB--------XX--------BM-------o----BB----------E------?-M--------BBM-----------BXB--BBB-----B-----BBB-----?-----BB?----------XBBB-XM---
-o----------BBM------BB--B----o-----------oBB--------------------------------B----BB-B-----------BB--------BXXM-------------------------B?XX----------X-XB----------oBXXX?B--??------------XB-----------
------------X-BXBXB--------E-----EXE------------X----?--B--oB-----X-------------------MBBXB?------BBBX-------XXB?B----------XBX---------------------------------------------------------BB--------------
--X--BBX----------BBB---?B?------------?oXX?XBM----------B---------o?-------XB-----XB---------XXXX-------------------------BB-------------BM--------------XBB------------BBB?-----------B-------------B-
--------M-X-----------------B-B---X-----------------M?XX----------------------BBX---o?---B?XB--------o-------------------------MB-----XX---XBXX?-------BX---------B-----X---------------B?MMB------BM---
---?BM---M?------E-E?----------------BBBB------------------------M-------------BX---X------------------B--BB-??-----B?-B------------------------o--------------B-------------------B---------------?----
---B-BXB----B?BBB---------------------X------M---------------B-----MXB-B---------B-XX-------MXX-X------X?--?-------XXB?-------?----------------B------XXXBMB--E-B----------------??MBBXMM----BM?BB-----v
-----------------B--M-?--MMB----------------X---o?------XX-----o------XB--XX---XBX------------------XXB------XB-----XBMMX------------------BBB------------------BB--------------------BB--------XBB--BBf
B------B-----B--------------------BBB-----------X-----?XX---o-M-M-----X-----X---------X--------------MXB---------B--------??XX------B--------X----BB??---------BBB----XXBBX-------o------------?B?-----f
---------oBB----------------M---------------?B------B----------XB-oB-----XX----BB-X?M----MB----oBX?X---BM----------------X------------B-B--X------BM----X----X?M-XB--------------B-----------B-----B?--f
------------------------o----------------------------MBB-BBB-X-------o---------------------------------M--BBM?X--------BXBB?------B--------------------------oX-------?X------BMB-----------------BXX--f
-----------XXB------E?--------------------------BM---o-----------o----B?--------X----BM---------?X------??oBBX-------B---------XX?----M?-------XX----------o------------X?B---------------------oB----?f
--------X-------------------MBMX-B?----------------------BX-------------------------BX?BB--------------XBX--------XB--M?X-------?B?M--BBB---B-------BBX?X-------?--BB?---XBX----X-MXB---------------o--f
m----------------XMXX?--TXXBBB-----BB?BMMBX---BB---------------------BXT----BBB--------XXB-?B?M-BBX----XXXB-----XB------M--ooX---------B--------------------------???B--MB----BB-----------------------X
X?--------BMXM--------------------B?--?--BB-M------B-----------BXX-B?X--B-------------M--XXBMBB-MoX--BX-oB-----M?----------BB-------------o----BB?B--BB--------o----------B------------------oX--------X
XXXXX|-XXX-XXXXXXXXXXXXXXXXXXX-X-XX-X-X-|XXX--X-XXXXX-XXXXXXXXXXX-XX|X|XX|X---X--X--X-X-XX-XXXXXXXXXXX-XXXX-X-XXX-XXXXXXXXXXXX|-XXX-XXXXXX-XX-XX-XX-XXXXXXXXX-XX--X|XX-X--XXXXXXXXXX|XXXXXXX-XXXXX-XXX|-
