?-------------------B-----o----------------B---------BX??---BB----------B-----------------------BMBBB?X?-----BB-----------------------------------------------------------------------------------------
----------X?XXXMX------------XMB--oM-X------------------------------------------o-M-----?--ooM-----B---------------o?----BB-------------?X-BBBBX---------------------BB?BBBX----------------------------
---------EB-X--------------------MB?------------X?------------XEBX----BoB--------------o----------?------EBX----------------------------XBB-----MBB------------XX-----BB------------BX------------------
--B----------------B?-?X-X------B-E?M-M-----X-B?-----B-------------------oB------EX-------------------------XMB--X----------------EBXo----B---------------------------------BBBBB--X--XX-o--------------
B?X-?B-B-------M---------M-----??BX-------BXXBX---------------BX---------------------------B--------B-oX-------------X?-o--XB-----------------------XB--------XB----------o?----M--------------?XBB----X
-----BM------M----------------XBBX---------------B--------XXBB--MXBBMX-XBB----M---------X--------oX-------------------------B----------------------X??B----------------------XB?MMXB-oX----BM?------BXB-
-----BoB?----------------oXB---------------o?BB------EB--------B-----------------------------XB-BBB-XXBXB---X-------X?----------BB---o------B-----XB----B--?------E-----M-----o--------XMoBXX-----------
----------------------o---------M-----B-X?X--------?X--------XXX------B----XX-----------MB-----------B---X------------BB----B---X-----------??---------------X?----------B-X?--------?X--------oX------v
BBB--X--XXBEX--------X-------XB-------------M---------BB------------XBBB--------------BX----B--------------M----------------------------MBB------------------------XB?---------------------------------f
---------------o---XB-?X-----------o------------XB?--------------BB?--------XX-----BB-----------------X-----X------B--B-----BB-XB------------------------BM-------E?XXX-------B--------------EB--------f
------------------------------------B--------------?X-------M---XXB-XBX?BX-----------------BX?----B---------BXBXM-?B-------XX?------Bo---BBB-----------------BBXXX-?X------BXXXM-----------------------f
------B-------XB---------??B------------BX?B-----B--X?BBXMX--XXB----XBBX--B-----o--------X---B-B-?BX-o-------M?-----M--B-BXBM------M??X---------X?X---BEB-------XBXB?B------------?XX-----------------Bf
-----------X--------------------M------------Xo--------------oB-X-------?-----BX-----------------o----------BXX-XB-M------------?MBB--MB--------------XXBB?--------------BX---------------------oo-----f
----------------------------?X-------BB-------------B------------XB?--M-----BB-?XB----------------------------------------X?MX---B---------------------------B-----XX-----?----------------------------f
m------------oX----EBoX---X------X-o--?X-XB--------------------BXoMo?-------------BBXBB-BBM-------B------------B-------------------------XTM-B---?-T----BBX--------B-----XB-BX?B------------BM-----?XB-X
X------------------------------XMB-Bo-------BB---o---BX--------------------X-------oMXB--------------?----o----------oB----X------------X-|BXX-M-------------------------X?XB------?------?B-?XBX-X---oX
X--XXXXXXX-XXX--XXXXXX|XXXXX-XXXXX-XX-XXXXXX-XXXXXXXX-XXX-|XX---XXXXX-XX-XXX-XXXXXXXXXXX--X-X-XX-X-XXX|XXX-XX-XX-XXXXXXXXXXXXXXXX|-X-XX-XXXX|X||XX-XXXXXXXX-|XXXXXX-XXXXX-XXXXX-|XXXXXX-X-X-X-X-XXXXXXX-
