-----T--------|--X--o----------------------------T--?-T-----X-------T------------------------------------X----------X----------??-o---?----?-----------E---------------------B------B---------------?---
----T------------X-------------------------------TX---------o--TX-X-------------o-M-------------------------o-----------------------BX--E-X------------B--------To-----------T--BX-|-------o---o--?---X-
--------BBB-T-----------BB-------?-BM---o?MB----TBB-----??-B-E-B---------X-----o---|----MM---X------------Bo-------------------?XMX--X---X-------X--oX----B-XX---T-----?-X----------o---BB----B?--o--X--
-X----------B--------o-?---B-------|------------B--------------B--------------------X?--M---o-X---o---------------X-------M-E----?M--------TX-----------------------X-o-?-B-----------------------------
----M-X---------?BoMBB-T-----|--------T------------------?-----o---T--M-?-o--T----------B--X----------------T------------------BB----------------------B?-?-------E--------------------X----------------
-------------T------T--------------------X---------------------XT------------|----X---------------X---------?------B----------M--X---B-----o-------------------------X--B------------B-------------X----
--M-TX-----M----------o----T---B-----B---------------Xo-----------------M------XB------|-------T------------------?---------??-X---?X-------------------B----------B-----XX?B--M------------------------
---T-BX-M-----------X-----------M-----M--|---------B?M------o---MT?-----EE-----------B-------------E-------?----------?X-X?----------|-----B--------M-----------X-M-----T------E--------B--------------v
M----o-?--o-B------------X--X-------T---------T--------------X----X------------o---o----------o------------E-------------------------|-X--E----o--oo-?--?---?E-----------------------X-T-----|------?--f
-XX---------B------------T----------------E------T--------o-----------o|-?---------B-|---------------o---oT---------B----o-------------------T--T----------XB--------E------------?---------BB--X--|---f
-----o--------------------T--------------------o---------?----------o-E----------B------------T-----------------------X----------------|----------------oX---B-E----------------T-o---||--T----T-------f
-----------XB----------o----BB-----------M---o---X-B----?------------TT---M-B----------o---------?------B------------X-BM-------------------|--------o---X------------E---?---M-BB--B----------X-X---o-f
--------------M--------------B-----------------o-------o--------X--T---X-B-----M-X--E---------------?-------------M--------X--M-oo--o----------------B-B------?-?-----------------B------B------------Bf
---------------------------------------o----------M-----------E----T------o----------?--------------?-B----------X--------M-------------------B---?---------E-----BXT----------------B--|-B-----o------f
m----o-----XT---|-----------T--M--------------o-B------o--------------o-----M----------?-------T-----B-----------o------X---oX-BB--------M--------------------E------------B----------X--o----?--------X
------EX-----------------X-------------------------M---------------------------------------------B------------X-?--------o------------?-----X---------BB--X---|---------------M---B-----------X------o-X
XXXXX-|X--XX-XX-XX-XX-X-|X-XXX--XXXXXXXXXXX-|XXXXXXX-XXXXXXXXXXX|XXXX-XXXXX--XXX-XXXX|-XXXX--XX-XXXXXX-XXXXXXXX--XXXXX-XXXXX--X--XXXXX-XXXXXXX|XXXXXXXXXXXXXXX-XXXXXX-XXX-X-X-----X-|XXX-|XXX|XXXXXX---X
