---X--------XX--?--oXM--?-X--B---------------X--X-----X-Xo-----X-----------X-X-------------?------E----------?-X-----X------X---B---X-----X-BXB---------?o-----X-B----X------------X-M-E---o---?-X------
X-----?X----XB----?---X---o----X---------Xo-------o---B---------------B--X-------X-?---?BXM--X----------B----------?---M-B-o-B-B-----B-X-------X---------------BX-B--?---o------X-B--o---X---------Xo---
--------E?----M-----E----?--------??E--X-X-----------X-----X---oX--X?--X?----X-------B----Xo----X-X---X------X---M----------BX--------X--------Xo----------oX------X--o-----?--M----X---E-o------E-E--X-
?-----o---o-X-------------X-----------o-------------X--X-?--BXX----------------?---X-M--o-----?X--------oX-------------XX-XX---o--X---------------------------------------M--X----X--------------X-X--X-
----------M-----------X---X-------Bo----------E------BX---X--B--E----B-------X-XXM------B-EB-EX--X----B----------B-X-o-X--?-----------X----------o-------XBX---MBX----MXX--X-o--?B-------oo?-------B?--o
o---XB----------X---?-----------X-X-??--X------XX-----B---------B-o---M----?-------B??--XX-B-EB-X-X-?-----EE-----------X-?---X-XXB-o-X-X-B----?X---XB---------M----X--o-o----X---o---X--X-?----B-oX-----
---X------X----E----B----------?------------X---X--X--XMB---EM-----------X----M---X---BX--------------X----Eo---o--oX------------XM-Bo-X------MEX-?--------X------XXXB-X----XX--M----X-----oX-----------
XX---------X-XM---o---------?---X----X--oX-----E---B-Eo---X--X------X-------X--------?------X-B------------EXX--E----o------B---E--?-X------XX---o----B-M--B-o--X----oX----------X------o-XXo---XM--XX-v
-o--X?X-----oX---?-------X?--X--X----X-?------X-----?-X-X-------B------X-B----X------------------X-oX---X---X-XX-o------X----o-X-o---X----------X-----------o-o----oo--B----Mo-----E-X-X-----?----------
----------------B------X-X----X----X--o-o-X-X--EX----X--------?XB-------X-XX-------o---?---?X-Xo-------EB--o--X----XX---B--XB--X-o-E------o--B------?-o--X----o-?E------X--B-B-----B--E-----XM----E---M?
X------------------------X------X---XX---X----XEX----E?-B----o-XB----o---------B---Xo?X?------o--o----B---B--?M-X-X?X---------BX------XB--------X-----B-----o--XE-------X----X-----------B-------X-----X
----------?E---B-----------X-----o--------------X---XXE------X---B-o------X--------------B-B----X-XX--?-XX-----oX--XX--X----?Mo-------------------B--B-------o-o----?----X---------o-----B--------------
--E--o-----X--?o-X-B----------o-------?-X--M-B--oX----o-----o---------Xo---E--------------X--X--XX-------oM-X-MX--BX-XX---?M-X-------?-X----------X-----------------X-?--B-o--------X------?------B-X---
-----B----------XM-XXXo-oBXo----B--o--X----X----X-B-M-X-oo----------Xo-XB-------X-----X--------------------M------------X--------X----E---E-----X-?---?--------?-----E-----X---B-M-------EX---X-?--X--X-
m--?oT--X------oX-X--------oXoXBM-X---o-----o-?--B----Xo----B--?-o--X------T-EX-TX?-B--XB--X---|-?------B------X-T-X----X---X---X---XXT--X--------XX----T--B?-X----o-E-|o-B-X-?---XX----XB-?---E----XX--
XXXXXXXXXXXXXXXXXXXXXXXXXXXXXXXXXXXXXXXXXXXXXXXXXXXXXXXXXXXXXXXXXXXXXXXXXXXXXXXXXXXXXXXXXXXXXXXXXXXXXXXXXXXXXXXXXXXXXXXXXXXXXXXXXXXXXXXXXXXXXXXXXXXXXXXXXXXXXXXXXXXXXXXXXXXXXXXXXXXXXXXXXXXXXXXXXXXXXXXX
