---T-----------MMX-XB|--------------E?B---oB--o-------X--------?o---------BMXXoo--------oo-?X-E------XBX---?-X---?--------X-------------------------------------B-----------B----E-M-M----------------?-
---B-----X---oB?------B---T----?----------o-?------------?--E-----o--------oX-X---X-T------T-----XBB-----T-------------------------XBB-----------T?------B---B-------BB?------oB-------------M-----X----
-------B-------------------B--X-B------T-------XXB--B------------------------o------|-----------B--------|MX----------MBX--X---??B---------MBB---------o-E---------MT-----------------------------------
-----?--------------------------------B|--------------------------------------XX------?---X-----B---------X-----------o-----------?--?X-oB-B---E--------B------------------------M-----??o--------------
----------------------T-----T-----------B----------X----------X-----X-----------BB------XXBXT--------?--------BBMB--------------TM?XBM---MXBX-------XX------BB-B------T---oX??-----E-BX---MX?------T----
-E--X-T---------------X-X---|---------------oBB--------------------------T-----------BXX-------BBBX----------M--------o-------------XBM---oB----XM--o-----X------o----|-T-?------?o-T-------------------
|X-------Bo--------XX------X---T-----------E------oB----------------BXM--|------------oB?------B-----B--------------B-----B?--------X-----EB----XX---------MBX-XXEXX----|X----------?X---------------T--
-----o-------XM--B---------X---|M--T-?B-------------------BB--B----X-------------Xo-----------------------B-----------------M----------------------------X--?XXB-----?B-----?----Bo-------X------X?--|-v
X----------B?----------------------B--T-----------B----T---E---------B---B?----B---oB----??--------------B---?X?o---------------B-------------------B-------------------E------------M------X-BB-------f
---------o------M------------T-----X-X|--------------------X------------X--o---------EB-------XB-------X-----------M----------------B---?---M------o--?B-----------MX----------------------------------f
---------------------------T-M-o-----------MBX-------------------------T-----------BTB-------XB--BBB------?--------------------------X----BM-------B-B-?XXBB----M----oB-B?------------------------BBB?-f
----------o-B------M--?----MM-----------BBX---------XB-----T?------------------------?----?BXoX------------X-X-XB--------------M---------B--------------E--o-XXX-T---------------------?--EX-----------f
------B-----XT--BM--------------------o---B-------------X--|XBX--BX--BBBX--Mo-----------BBX------------X-o--EB--X---------------------?-------------------X--X-BX-EB-BX----------o--------MX-----?X---Tf
-----o--------??B?---------X--B-----?B---------o----oX--BBBEB?---T------------XX-----------??X-M------------oB--o-X------?-----?------XB----B--X--X--?XBM-----MBX--?--?XB-------X-----T---TB?---------|f
------?-EX--BXB?-----------E---EB------T------T-----M-----------X|BBTX--BB-------BX-T---BBB----X-------------BB---o----B--B---XB--------BM----------X--T----T-X------------X---X------XB?X--X----MBB---X
-----------------?M--------------------M---------XX----------------o|XoM--B---Xo---------------X--?X--??B---------M--B---oB-----------------X---o--o--------|-X-B----MBM---------------------oM--------X
XXXXX--X--|X----|XXX-XXXXXX-XX-XX-XX-X|XX-XXXXXXX-X|XXXXXXXXXX--XX-XXXX-XXXXX|-XXX-XX-XXXXXXXXXX-XXXXXXXXXXX-XX|XXXXXX-X-XXX-XXXX|XXX-X|XXXXXX--XXXXXXX-XXXXXX-XXX-XXXX--XXX-X-XXXXXXXXX-XXXXXX--X-X-XXX
