-B----o--X-----X---o|----------X---Xo-?E-oX--XXoMB------X--oT-----X--X--E---?-B----------B----X--o--------X----X-XXT-o-B----------------B?------X---B-----?---o-----X---Mo--E---------X?-----XXEE---E-o-
--oX-X------o--XE-oB--------------|X--o-oX---BXX--o-T--------X---X-----XMXM---E-------------EE----o-M-X-EB---------|--------XB--X-X-------X---------X--B-------------X-X-T---E--------E-M-?---XX----?--o
------------X----------Xo-----------X--X-----T--------XB-----?-?----XE----X-TX-------------o---X---o--B-BE-----XX-------------o--------?--oX-----------o--|B------?BT-MB--X----X---B-o-----?-X-M-BB---E-
-XB-------oX-B-----B----B-?-o-E-------?o---X--XX---------o--------XX---X---o---BB---BB-|X---------X--B---X--X-X----------XE---X-X---------X------------|---X-?X-M--------XX----o----?-T--X-E--o------X--
o--------------o-----XX----------X-X--BBB----X----X--?-X---o----X--T-X-o---oXX---X----B-X-X-BXX---X-----------------o-X----X-----E----------B------X-XB------BoXX----X-Xo-B-X-E------E-----XB-o--------?
------X--------XE-------X-----------|-B---o----------X-XXo---------EB--X--X--?-X----oBo--------------XE|X--X-------o---------o-?----------------|-B---o---B-------B---------T--T-X-MX------X----------XM
XEX--------E-X--E-X------X-----|?----------|---|---X--X-------B-B-E-----E----X------|-o--o-X-X-M-|X-------X------|---B-X---B-----M-X-X-X----------BX----E----------B-X---X-------------XX------B---MX---
------X------X-------o-X-----B-------------oX---------XXX-o-|-------B--o-----XXX-------X-X---EM-----?-B--o-E--?--X-M----XX---?-----XT-----o-------X------o--o------?------ooX-T-------E-X--?--X----T|-Bv
--------XT----o-o--oX----X----E-XX------oT-------X--------o|---?---B-E--o-----oX----o--Xo--X----X-X----|o------XX------E----X--o--X?---?-?---------X--X-?---E-------o-B-o-X------X-X-XX------?---o--B---
-X-X--------------E--B-----o-----|------B?--o--XE----B-------------B-Xo---X-Xo-X-X-------------o--X---------------M-------EX-T-E--X----XX--oE--------------o-o-oX------X----?---E----E--X---------------
-------------------X---M----?--B---------X---X-B-XB---B-X-X----?E-X--------X-o-----?X-----M------oX---E--XX-X-BE----------M-----T?-T--o--?----B-----o-----XXo?--X-M----X-B-------X-?o--oo--------E------
----X-BB-----------?oX---?------------------------X--------B-o--M---XX--X-------?--X---------X-B-ET--------------BX---------?------o--EMX-?-B-X---T-----E-----M-B----o-----X--X-B-X------------------X--
-o---X-----EX-----X?--------o-XX-To----E----|-X|---B---------?--B---XEX--B----|---?-XX-oE-o---X----X|-------X-o-------X--o--o------------XB-------------B------MX---XX-Xo---------E-X----EB------E---X--
---?-XTT-----M---|-------X---E---T-----o--X----------oM-----B--?----X----X-X------Bo--o---MX-----XXE-?--o----|---------X-X-X-?-----------E------------X-X?X----XX-------|-XX-T---X---X----------?oX-X---
m--M-----|---X|-X-------|X--X-X---------------E---X---X-X-o-o---|--o--------X----------BXX-o-XooB--B-----------X--o---?-------o-T-----o----------X--o-XE----X--------------T---o---E-X--------X---XB----
XXXXXXXXXXXXXXXXXXXXXXXXXXXXXXXXXXXXXXXXXXXXXXXXXXXXXXXXXXXXXXXXXXXXXXXXXXXXXXXXXXXXXXXXXXXXXXXXXXXXXXXXXXXXXXXXXXXXXXXXXXXXXXXXXXXXXXXXXXXXXXXXXXXXXXXXXXXXXXXXXXXXXXXXXXXXXXXXXXXXXXXXXXXXXXXXXXXXXXXX
