---------o-------------|--o----------------M-----T--E----------?-------------T--------B---oo--?oBT-T----------o---B-X--o----------B---E--------------|-E-E-----o---------EBo-------------E-T-B----------
-o------T-------------------------------------M-E----------?---------E-----------------?M--------------------B----o-E-------M----------o----|--?B---?--------E--?--------E--E---T-|----------o---------E
----------M-o--?---o--X----|T-E-------B-----E-----M----M--------B---X--------------B---X-------T------o--------X-E------X----?T-----------------------------B-------------o------M-o-oo------TB---B---B-
o--B--EB--B---M--------------M-------B--------T----------E--?---?---------M---------------T-B----------------B---?----o--o----------E-----MMT----------X----X-----E----|--------B--------X---B-o-------B
E-o------------o--o----------B-|--B------------o-E-E-----BE-X----------------B-o-------------------o----|-----B-o-----o-|---------o-----?--B-----------M------|----------?--------------?---B-----------
X---o--------B-T---?-----------------------M-?----------B-----------X--|-X-------EB----------------o------------E-----o----X--------E-------------------------------?B--------|-?------|------B------o--
X--------------------------------------M--B---?-E------------|-----------|---------B-o--------B-----o------------------E-----B-------------------o--?--E------------B---------?M------o--------o---B----
-----------X---------BB--------?--------------E-|o--------------------B--BTE---o--o---------|------B-----EE|o--------?--E--E----o----?--o----E---------------B----------------o----B-----------o----o--v
------X-----------B-----B-------E--B---------------------B---Bo-?-------o---B---------E------B----------------------?-----------------------------B-BT----------------B---------------XoB-------------o-
-----X----E-------?-----Xo--E-o------------------M---T--------------?-----BB---E--------------o-------Eo----------o-------------------?-B-----?---BB----B----?-E-------------E---EE-------|B------ooE-oT
--B-----B---|-E-T-?-------X-?B------B---o-------------B-------------E-o-----?--T--B-|--------------------------o-------E-----------------?-----?-|---------M-X-|------M------|------?X------------------
-------B----?--?--------------------------------TM---B------o-----------------------------?--|-----------BM-----|---oT--E------?------o--------------------o-?---?B-----|---------------M------B-------o
B-E----------E---------E-X----E?X--T-M------?---B--------------------B------------|----M----E------------------Bo-B----------oM-----------------M-----o------------------o-------X------------------?---
------------------o----|B-------------?------E--o--------E-----B-------?----o-------------T------T---|--------X------?--------------|-------?-E-------E-M-----TB-----------o----------------------E--?--
m--T----------------------|-----E---oT------------E----oT--------------o-------------o--M-------------B-------E-X----------X---------B--------oB--|oM------|---------?---E----E---------T-B-------------
XXXXXXXXXXXXXXXXXXXXXXXXXXXXXXXXXXXXXXXXXXXXXXXXXXXXXXXXXXXXXXXXXXXXXXXXXXXXXXXXXXXXXXXXXXXXXXXXXXXXXXXXXXXXXXXXXXXXXXXXXXXXXXXXXXXXXXXXXXXXXXXXXXXXXXXXXXXXXXXXXXXXXXXXXXXXXXXXXXXXXXXXXXXXXXXXXXXXXXXX
