-BMXB------------------------------------M?B-----o---M?---------------X-BBBXX?XX?---------------------------XXB-------------XBBB-B?---------B-BBX-------------------EBBoMMX---EXMXB---------------------
------XBM------------MBX------------BM?----------------------------------------BXXB----?XXB----------B----------XB-----M--EBBBX------------------------------------------------------------------------M
-------MB------------------------B----------------------X----BBMBBX-------------------BBBBXB?B--XMBMX----------------BB-B?------------BMBB---------?------BBXB-------------XBXXMB-XX----?BX-------------
----X?BB--------B-----------------BXX-----------BB----MBB------------------------------MBX---------------------------M-----------------BB----------------------------------------------------------?----
---BB------------------------------o----BBBB---?X---??-------------------XB----BXB--------------------------------------B---XMMB-----------------------------------------------------------BB----o------
---------XX----------BX----------------?BB?----------BB--------BB-------------------------------------X-------------------M----------------------------------B---oBXX----------XBX---B------B?----------
---------BXXB------------------X---BXM?---------------BMXM??ooX---BBoB-------BX?--------------oBXMBB-----MXXX--X------------XBX-----X-X-----XX--MX--BX-------BMBX-----------MBXX--------------?BB-------
----------------------------BXB---------XBBE-----X--------------------------MB--M-BB?------------------------------------------------------------------------------------------------------------------v
------------------------X----oX----------M---BBX?X---oM----------BBM-------oXBB??-----XX-------?---X----------?----B--------MXX?X?BBXXX-------XX-XBX------B---------------XB-------?-o----------------?f
---M------------------X------------BB-------BBBB-------M------------B?--X--?B----------------B-------XBoXBBo-------------------------------------------------?B---XB-----o----oMB------------X---------f
----BX-B-----MXB---E---XXBBBB-----BB----oB-------------XX--------------X-----------BB?------------------------------------XBB------BX---?BB-----------?-------B?M------EMM--------B-M?XXBX--BBX-------Bf
-----------------------------BBBBX---?-------------------------BBB----------XBMB----------------------MXB---BBBM-E-----------MBB---------BX----------------MM?--------------------?BB-------XX----BMX--f
---B--------XX----------------o-----------------------------BBM----?oB----B-------------------------------------------------------------------------------------------------------------------XBM---BBBf
--BB?----------------------B-----------------------------------M--------BMB--------B------EX------------BBB--T--------------------?B-------------oX---------BBX---------------------XX?-----------M----f
m----BB-B----X?X----------------B---XXB-----T?-----T------------E----------MBBXBB----------Xo-----BXMX--BM?XX|----MX?B---BM------MBB--------------------T--TMX??-TBB?---BB-XXTX-------------T?BM---X---X
XMXXXXXXX-XXXXXX-?--XXXXXXXXXX-BXXXX--BBBXXMXXXXXXX|XXXXXXXXXXXXXXXXXXXXXXXXXXXXXXXXXXXXXXXXXXXXXXXX-?XXXXXXXXX----X-BBBBXBXXX--XBBBM?XXXX?XXX-XX?XXXXX-?MXXXXXXX|XXMXXXXXXXX|XXXXXXXXXBBB?XB--BXXXXX-BX
