-X---Xo-BX---o---XXo----?------Xo----o-E------X-Mo--o--X-X-------oXB------E-------o--X--------o-E-----M---------XXBX---M--?----------o--oE--B---B-X-o-------------?--X------------------E?-EM-----B---X-
---o--T----?-X-E--------X-----B-------X-----o-o---X-B--M-X-----------X-Xo-o-----oX--------EX---X-----X----X-------------B-X-B----EM?----XX-------o-EX----X-X----XE------E-X-o--BB---X-X----X-M-----X--o-
--?X-B|-X-----o-B---------------B-----M-?-o-----X-----------------BX--o---X-----B-X----B-B---X---------M------------X-X--M-oX----XB-XX-------X-----o--o---T--o----X-M---X--o----Mo------X-o--XX-XMo--o--
E---?-|-X--X------X------X---MX----E----------------?--X--oX-X--o-X-----------------------------XX--??-?-BoBo?---------o?o-X---EX--Xo-X-X-------E-X-X-----|-------------X-------XM----------X--------E--
--?--o|----X--X-------?B---X--X----o-XX---X-X--B-X-M--X------X--E-E--XoXXX----------------X----o---X--?----M----------------------X?-X-----E--X--BB------XXXX-----oB----X-----B-------B----E?---------M-
--Xo--|--X-XBB---X----B-X----------X------o--X---------X--X-----o--XXX---Xo----B----------------B----B-X--------BB-X---?XMX---?--X---X-----Xo-----X---Eo-----X----EB-----X----MB---X-oo------XX------M-X
X-----|-------X--XM---X--------o-------X-------BXB--------o---o---X-X-E-----B-E---X-----o--------ooE-o----o---o------E-----X--oE---E--X---B--X-E-X-X---B-----o----X-B----Bo-X---B-o-X----E-----o-?-----o
----X-|-------------E------------o----X-B---XB----X?---?B-X-------X----X---X---------X-----E------oB--BB-o--------X-E-o----o?----X---o---X--X-------------------X---X--XBX----X-----------B-X--X-------v
X--B--|--------X?---oX----------B-?X--X------B--EXX-----X-X----?----X--X-X-Xo--o-Mo------?EE-o---X--------B------X-X--------------o--B--XX-o?--B-----------------X-E--B---X--------?--o---oo--------X---
---M--|---EB--o------B---B---X----o---EXXX-X-----B-??------E--B----------X-------B-------------X----X----M--B-------X-------XX--B----------------M----XB--M----B----------------------oo-E-----EX-X--BX-
----B-|-------------B---B------------X?-XMo----------?-B--?B----X-------X-------XE-------B-X---o-X-X--X----o---o----------X-----------XX-X----B----X--------------oX-XX-o-oo----B---BMM-----o-BE--------
---T--|X-------?-------?--X--X------M---?-------M---------o---?-X-X--o---oo-------XM-M----------B-X-------------?X----------------E----?X--E?B----------E--X-----M--M?---B--X------M-B--------M---X-----
?oT|--|--B------------X----------X-M-------?X----XX------B-XoX----X---?B----o-oX-------o----X-XX-X-X-----XB----------------------XEX------?------XX----MB--o?-----------------XX-------X--------E-------
--||--|--|----X-Xo------B---X---M---XM---------Bo-?--X-EXo-------------X---B---TT----oX-?-------X-XE---MX-X--XE----M-M---oM--o-X--X---o----B---------------o----------B----o--------EE-BX-Eo-----?------
m-||--|--|-----X--------X---X--E----?--------Bo-B-X----X-----M-----B-M---------||--B--B---M-X-X-o------------?------?---------Bo-B-X----E--?--X------X--X-------X-X--B-----X---B----B-------?----B-----o
XXXXXXXXXXXXXXXXXXXXXXXXXXXXXXXXXXXXXXXXXXXXXXXXXXXXXXXXXXXXXXXXXXXXXXXXXXXXXXXXXXXXXXXXXXXXXXXXXXXXXXXXXXXXXXXXXXXXXXXXXXXXXXXXXXXXXXXXXXXXXXXXXXXXXXXXXXXXXXXXXXXXXXXXXXXXXXXXXXXXXXXXXXXXXXXXXXXXXXXX
