------E----BB---------------o-----------X----M-----T---B----To--T---oo---B----------E-------E---------o-------?---X-------------|-B--------------------------o-----o-T---------o-B--------------M-------
-----o--?----?----o--?---------------M--|--o-E--------o----|----------X-X---?-----B--B----------o--B--|-B---E-----B---?-E----?o-------B----o----E--o---E--o-?---B---o----B--B--------TBM---------------?
--B--------M----------B------X-----o-----?----B----------M--E---------------o--??--?-------------B-------E---M-----------?--------------M--X------E-------o-B----B---------o---?--o--------B--E-B-------
-----B----MB----B---------------B-?--o----------------ETT----------B--B?-----?--o----|---o-------------?--------------------E------|-------T---B?------------E------B-M--o----o-------------------------
------------E--X|o---B---------------------|----o-----E-T-T--?TB---------------E------E-----o-------BBB---------X---------o--X-------M----B-B--o--?-X-T--------B---------------B-----------------E------
o------oX------M--------o------BT------------B---E--?----E-------------oB-o----?B----------?--------X--------|-T------------------?---------------------------------?B----B--------T-?B-----M---?-------
E------|-----?-----M-oo-----------XM-E-------B------------------T--X---o---------?---------?B-----------|-----------BE---------|-M---B----o--------------------E-------oM-?-----------------------------
------|---B--------B?----?------T?-----o--------------B---------------------B--E-------------------B-------------M--o-------o-------------|?-----B----------ooX---o----------------B---------o-------B-v
T--Mo-?----o-----o----E--B--X----------------E---------M|-----?----------M----?|------------E-E--X----------X-------------B-------EX-------------------|----------------?----?----------------|X------o-
--B-------------M------------o--?----------EX|------o---?--------------B-----------|-|-------|---B--B-----B---??---o---o----M--E------BE--|-----------o------o---------------------E-o?------?--------M-
----------o-------EB------E?------------------|o---------?--------o---------|--------|------T-----o--|?Bo------B-------o-------X--ooo--M---o--T--------------------------B-B------o------?---E---------E
--------X----oo-------------------------------?----------o--E--E----o-------------------o----B-----B-------B-----------BE----E--E---------B-------B?---X----------E--?o---------------?o---BE------B----
----o|?---------------o---------o----------E-----------|-?-B----------E--------B--?------o-oB-?------o-B-----------E-----o-?-------------X----o-------------M-------|XE------o--------------?-------E---
------Eo---XB?---B--o----B--B-----------------?-------------------------T---?-|o?------------o--E--ET---o--o------T---o------o-----------X--B------?-------------------------------?-----------------E--
mo------o-----M--------o-------B---------------XX-------E----M----------------o-T----------------B----------------E--|--Eo-----o-----------B--?--B-----T---o-----E--------E----B---T-----------?--B-----
?-------------B------------E--------------------Mo----oEE--------------------------------B--?----B---------------------o-----B---M------X---------o-----------------E-------o-M-----E------BB----o------
