o---------------------X-----------X-----X----------------o---B--X----------X----------BX-----XXXo?----Xo-----------?--?X--X-----X----------o-BX--------X-B------X?-------X--B-------X-------X--------o--
---X----o--X-?-X----------o--o-----------o-------EX-X--X------------X----XXB--E---X----------------XE----?----?------------X----X-----------X-X-----------XM---------------X--XX-----X--X---X?----X--XEX
-o-------------X---------X--X--E---B-----X-X-E--E--------X------o-BX---o-----o---?B-X-----B--E-------X-BX------o-----X--------X-----M--XB---X--X---?---o---------X--B-------X--XX-------?-o---X------?-M
Bo----XX---M--X----X----B-------B----B-o----o----o?-o---?------------X-------X-----?---------X---------o----------------o-o---------E----?-X---X--X---oXo--E---?---?X-----X-o-----EX------E---X-o-----E-
--X-B----------X-?-X----X-o------X----X-MEX--M-o-----------X-----X---E-------------o-E-?X-XX--------X------------?-----X---------?-X-X-X-B-----o-BX-oE------X--X---X--E----o--X-B---M--Xo----X---------B
-o-------------------------------o-----X------X-----X---X--X---?----XX---XXM--X---------------?X--------EX---------X-X----E-X--o-o-----?--X-?B-B--M-oo---X----o-oB--------------------X---X-?-----------
--E-XX--X-----?-------X-----X-X---X---M--E--BE----EX?--XX---------E---o-------B---?-X----o----X--------E--B----B-------X--B-----?------X---X-o------X---Xo---XB?------o----X----B?-------X---XM---------
X--B-----?o-X----o------E-oX-B---B--XX---B---------------oo-E-----------X-------------o------------XE-E-------B-MB-BB-B-----------B-----------X-oX------X----?------B-XE----X--?--------------X?--B---?v
---o---X?-------X---B------------X---X-?--E---X---B-Xo-X-E-B---?----E----X---X-?----X--X-E--------?o?X-------------------X?-?X----?--------X-----o----B----oE------M-----MM-X--X--XX-----EB---X------M--
----B---?-B-----------o-----B-B------M-X----B--X----X-E--B---------o----X----M------o--o----------o---X---Xo----------------------B--------X----B---E---X-?X-E---oo---BX-oE-oXo-----------o----?B----X--
-----X-X----X-----X--------------o----BEM----X-X--EB--o---Xo--------o--B---B--X-?--B----E-BM-X-----XB------------E--XB??---?--B------------X----------X---E--------X---E----B-X----B-------oX?X---------
X------X---X----B-----X------MX-X--------M------X-XE--?B-X--X--X?XXX---X----E----X--------E--X------X--BB-----o--o-------?MX-------o------X---X---o------X-X--o-X---E----E--XB------X--X---o----?----X--
---X-B--B---XE-oB----?B------------B--X----B---------o--X?----------?B?-X-X--Xo-----?E--X-X----X?----o----------X---------X----XX-------oX---?-X-X--X--o--XE--X?-------E-XXBX----EX-X-X-o-XXB-X--?--E-X-
E------o----------B-----E--------X----X-?----X------B----XE-X-?B--X-------------?----------oX-----X---------XX------X----XB-----X-M-X----o?---o----X----EX-X--oB---B-------------------XoX---oX--o--o-X-
m--X--|-E-----X-X----X--o---X-X-X-?---X---T-X?E-|EX---?MM-?oX----X---X---o--oX-|-o-X--X-----X-----?-XB----XoB--------o-------B--?Bo-oX?----TX--T------XX--o---B--|---X-X----B-------X-------?---------?-
XXXXXXXXXXXXXXXXXXXXXXXXXXXXXXXXXXXXXXXXXXXXXXXXXXXXXXXXXXXXXXXXXXXXXXXXXXXXXXXXXXXXXXXXXXXXXXXXXXXXXXXXXXXXXXXXXXXXXXXXXXXXXXXXXXXXXXXXXXXXXXXXXXXXXXXXXXXXXXXXXXXXXXXXXXXXXXXXXXXXXXXXXXXXXXXXXXXXXXXX
