--BBMBBB------------------------------------------------EB---------XXX----XXB--------------MXBBB--------------------E---------------------------------------oBM-------------------XXB?------------------
-----B?----------BBXX-X----------XX?BMXBB----BB?BXX?-------------------------oB-----MXX?XMB?MBBXX---X?-------------------X----M?X----------------------------------------------------------------------B
------------?B------------BoBBB------BB-XB-------------------------------------------?M-----------------------------------BEXXBX-------------?B-B?---------XXX?----------?---XXB---------------XXB------
X---------------------------o---BBX?B---X??------------------?--------------------------------------------------------------------------------------------------------------------------------------EB?-
-XX----------MB----------B---------------------EBBX?XXXBX?X-------------------------?BBBX-------------------------XXM-?X?-----------------------------?BM--XX---?----EX--BBBBBBB------------BBBoXX--oBB-
-----XXMMB-------------?X--XB?X-MBM-----M-------------BB---------------X--------------------------------------------------------------------------------------------------MB--------------BoBB?---------
-------EBB------MX-------------------------------------BEBX---BB----------------------------------------------?------B-------MXB---------??-------------------???------XXBB---?B--EXXBBBB----?BBB?------
-------------------?-----------XX?M---------------B----?----------------------X?MBX------XBX---------BB-----------------------BM-BBX--------BB--------B----------B?B--BX-------------------------------v
------X?X--------XB---------BBBBMM-----------B----------?-----B-------MX----o?-------------------------BBBX--------------------------o----------------XB---------------o---------MXBXX-----------X?-----
BB-?BBBBB--------------X-------XM------?-----------------------?BX--------?M--------------------------------?-------------------BX-------B?BX?--XB------BBX-X??---BX--------BBBXB----B---XX----BB?----o-
------X--------------------------BB--------X?--B----------------XBXX--------------------XB------------------------X--------X-------B---M?-M----o-----------o----BBXBXMMB------BX----BXB-----------------
--------------------------B?B----------------------oB---------XBB---?---XXMX----------------B?--------------------------B-----BBB?B-BB-------X--BBX-BB--------------------------XBXBX------BB-----------
------?MXXMB---B------BB---------------------------------------------oX-----oX----XBXXM---------XXB---------------XMB--------------------------?B------------B-----------?XXXB--------------------------
----------------?--?B-------------?---MBM------------------------TB--BBB------------------M?XB--BB-----------------M----B-B-------------------EB-X---------------TXB----------------TB?B---XBBB---BB---E
m-B--BM--MMXXX----B-BBM----------T--------X------T-----XXMB-?----|B------B----B-------------XB---oBBMXX-XB-T-------E-----TXX--oXXB?B------------------?B--------XB?X?-------XXX-X---|BB-B-------TXB?-TB-
XXXM-?BBBXXXXXXXXX-BXMX-BXXXXXXX?XXXXXXXXXXXXXXX?XXXXXX-XBXXXBXX?XXXXX-XXXBXXXMBBBBXXXXXX-X--BBXX??MBXXXX?X|XBB?XXXXBBX--|BXB?MXXXXX-XXXXXXXXXXXXMMXXM-?BMBXXXX---XXXXXXXXMB-BB-XXB?MMXXXXM-XXXXXXXXXBB-
