X-----?---Eo-------X--o-XB---o--B--------------------------------B----------XE--------------------------------------------------------------o----------------------------------B--BM------oBB-----------
------B--------B------------E---EB------------------X-------E-------------------------E--------------XX?--------X-B-MXB----oX-----X---------M-----oB----------------------B--B--------------------X-oB--
----X-----------XBX?--XB------?---------------------o------o-----------------E-------?---------------oX-----B-----B---------??-----?------------------------------------?----------------------?-o?-----
---------B-----------------o------------o-------------------------------X----------------B-----M--------------?---------------------------MB-----?----X-----BM-------------------------X?---------------
-------EoX--M----Xo----------o-------------------------------------E--------------M-------?o--------------------E---?------------BX----?-----------------X------------o---------XX--X--------M--X-------
oX-------BB--------XXB--------o-oB-M-----?---E---------------XBo----E--X----o-?---X--------------BXXX----B------------BBXB--X?-o---------M---MooB---------X---------X-----------o-------------X---------
-?-?o-------------X---------?X-------------XB---M---------------o-------------XX----?B--------------------------------M-----------X-----------B----o--------o--------------------------------------o-B--
-------------X-B-----XBBB--M---------MB-X-------------------------------------X--------E------o----------?M--?------------?------------XBB--------------------------ME-----------B?-oX?----------------v
E--X-B---------------------XX-------X---------------------X-------?-----------B?B---B--XB------BM------------------------------o-----o--X--------?----------X---------o---------M--------o-B---X-X-----f
-----------------M--XB----X--------oB--B--?--------M------X------------------------------------MBoX-M---------o-X------M------------------------------------------------M------XB-------BXo----?----X--f
--------------B-B---------------oM---?-----------X-E-X------------------o---------------o----X---------oX--X---M---------------------------------o------------o-----X--B-------------X-----------MB---Ef
---------------------------?-----------------X-------M-------B-X--------M--o--?-----X-M------------------------------------o-----X--------------E-----E---------?------------M-------------------------f
--------B-------B-?----o----?----------?----o-------M------------X---------------X---M----------------o---------o-------------?--X-----------------------------X--B---------o-------X---X-----------oB-f
--------X--------------------?-------------------------oX-----B------------Bo-----B-o--M-----------XX--------?---M---o---BB-o-----------X------B-------------o-----------------------------------------f
m----o---o------B------o--X--E----------o----o-----X-----------o----------X-------EM------------------------------------------------XM----BB---------B-B-BX-------EX?--------Bo------------------------X
-B--------------X-----------------------?-------o-------------X-------E-M-E--E---------o------o-------?----ooB----B--------------oX-oX--?-B--------------o?-----E-B---?--o----?---X------o-------?-----X
XXX-X-XXX|X-XX-|-XX-XXXX-XX-XXXXXXXXXXX-XXXXXXX-XXXX-XX-XX-XX-X-XX|XXXXXXXXXXXXX---XXXXX|X--XXXXXXXX-XXXX-X-XXXX-X--X-XXX-XXXX--|XXXX-XXXXXX-XXXXX|XXXXXXX-XX|X--X|XX|X|X-X|XXX-XX-XXXXX|XXXXX--XXXX-XXX
