------------------X---X?----------------XXBX----X-----XMMBX?BXBBX--------oMM?X-----B?MXXBX----------------------------?o-B----------------X-----------------BM---------------BXX-???B-------------?-----
----------BX--XXB----M---X----------------------------------------------XX----------------MBBMXXB----M----B?XBBBBXB-----------------BBBB-------X-------?B-------X?M--------oBXB----------------B--------
E?----XX-MX-B-------oXB--------------------------B------------MM---MB--------X?-MMXBBB--------------------------------------------------------------BX--oMXM-----------E-----EB--------M--XB-oMMX??-----
BXX---MBB---------MB---XB------------------XX-XBX-----XXB---XXXX--M--------?B?-------BX----------------------------------------?--------------------------------XBB---BB?BXX----X------BX---------BMBX--
---------------?B--M--------MXMB--------oB?X------------------------------??B------------------?B-XXMX-----------X--------------MBBB---------------BX----------------XBXBB-?------------------B?-----XX-
--------B---BBX?XB--XXBXB------------BXXXXXBB-BMBBX-----------BXB---XBB------BXB---------------------------------------------------X---BXBBBBB-----oMB?--------------oBBX??B--BB---EB-----M-BX----o?XX--
----------B--------X---B----------B------------------------XXX---------o------------M-------MBB--XBBoBB-----------------XX?----------------------------BX?MBX---B----X??XM------------------------------
B-------------B------------B----------------X------X?XB-----B----------------------o-----BB-----BBXBBB----------BB---XBX-------X-----B-----------------------------------------------------?B---------Xv
-------M?B--------?XBXX-MM----XXMX--oXB------X--X-B------M-B-------------------BB?-------X----------BBBBoXBB-------------------oBXB------MBMXB----------------?---------------BB---XBBXX---------------f
----------X---------------------------------------------o?BBBBM---XXB--XXB-MXBX---------------?---------------?-oX----------B--BBB------------BB-------------BX----------BBBBB-------------------------f
-----B-BBBXBBB?XB--BB----------------------------------B--------------------XBBX?----------------MBB-------?B------------?XX---??MB-------------XBXXB--oB-BB--------------BBX--------B-----------------f
-------------------o-X--BX-----------BB-----BBB-----------------------BX?XX-----XX?------------X------B------?MX?-----BXXXE--------B?---oBX-B---------BMB----------BB-----------------M?B?--XBB?X-----?f
-------X------X?--------BXMXX--------X--?X-------------------?BB-BB----X-----------------MXX--------XX----B-------------------BB-----------------BX----------BBM-------XXB---??--M---------------------f
--------XBX---------?---BB--------??-XB----oX--------------XMXB----MB--BB-------------BB---MXXXXB-----M?B----X-X---XXX?BX--------XBB---MBMBBXXB--XEBB-----------BB---oX-B?XB-------------XB?XX-?-------f
m--------oX--BB------BB?--?B--------------BB------------X?BXXB------BB-----XXXMX----------BMBB?B---------------------o---------------?B-X--BXXX------------------XX---BB---TBBB-----oBo----------BBB?XXX
B---X----------------------?---------------B------X?o----BMBX----------------?X-?XXX-----------------------B-------------?B-----------?------------EX?X-------??XXX?TM--??X|XBX-------XBMX---------XB--X
XXXXX-X-X--XXXXX--XXXXXX-XX-X|XX-XXX-XXXXX-XXXXXXX-XX|XXXXXXXXXXXXXX|--XXXXXXXXX-XX-XXXXX--XXXX--XXXXXXX|-X-XX--XXX-XXXXXXXXXXXXXXXX---XXX-|-XXXXX-XXXX-XXXXXX-XXXXXXX-X|XXXXXXXXXXXX-XXX--X--XXXX-XX||-
