-------Mo--Eo--oXE-XX-----X------B-------Xo----------X--E--ME-o---X-??--o-X--X-B-oB--B-B-T-M-X---X--B-X---?---?-------X----X----X--?BX--E----------BB----B-------X---X-----EX--BooE--------------XB-o--X
---X-E---EX-X--------XX-B--E------o-X--X----X-X---X------?--B-oX--------E-------oB--X-----EB-o-X-XB---------?-------------X--o----X---B---------Xo---E--B-----------X-X---X----?---?-----X----o---X-----
-XX---------------?------TMX-X-X--o----X-----T-?------X-X-X------?----X----X------X----o----------T----E-------X----o------XXo-X-o--------|EE--X-o--oX--B-o------?-o-E--X-------XX---oE----X-o-X--------
?-M-|---o-----o?--??XoBXXX-----------o---------T--M-----------XX--B---B--o-----?TB-XE---------EE--X---E-------B-XX--B----------B---------------X---X-B-----X----X-T?------o-Bo--X---E---X-oX----E--X--o-
Xo-B----X--X-?--o--X---X-|--X-M---BX---B?---XX-BX---o-X------E------X-|--------|-B---E--o--X----XXB----XX----B---B----------B---X---T-Eo---------E--X----BB--??---B-------?---B--E---X-o--XX-oXX-B---X--
X-----|B-----X-----XT--B--X-E-------o?--XB-----|-X-----X----XT-----X-------B---X------XoX--B-----Bo-X---oT---------|X----M-o----B-----B?---B--B-E-------B---?E----B--T------B----------oX---------TXE-B-
--X-X-----XXX---X---?------X---X----EEX-o-X-T--B---XX--E--X-o-X-?--X-----XBX---X-X--------B-o----------------o-XB-----X--X--------X-B----------X------X------|----------------??-----X---M-------?M--B--
-------X---o----B-----X------X------------X--X---X------X-XXX-T--X----XBX-------X--X---E-o-X-X---E----B--------X---X-Eo-o--X----X-------X-T-X---------B--B---------E---E---B----XT-E--------o-o--B--X-?v
X---XX----|----?X-XB---XoX--------X--EB-XX--------------M------------?------B--------X---------X-XX-----oB--o-----X--X-B-X-X-------------------o---X--E---X--------X----M------------o--X-----X--B--BXE-
-?---------X---------XE----------o-------X------TX-o---Xo---------XMT---||B-B-?--BoX---X-----B-------?--T--o-----E-------X-----------X--X-o---Bo---?-MX-------o-X---E-E-o-----TM--?o--------o------B--o-
--o------X-?---------?T-E-?X-X---------X-B---X-o----X-----M--?|-----Moo----X---B---|--X?X--o-----X-----------?--X-------E---o--X-----X-X--------o---X--B-o-?--Xo-M-----B--X--?o?o---X---------oB--M-----
-B--X----Xo---------------B---T---X----X-----X-E---X--Xo---------X------------?---------XX--------------oX------------X--BX------|?--------X---E---X-XX|---------B----oT----E--------o------E-X---------
---XX-M-Xo--o--?-X--XE-X---?o--X----?--T------------------------o-X----X--o---X-------o------oM-B------X-----E------X-----B---B---TB-----B-----X-o-------o--|-BT--EX----XX--------?-E--X--Xo--XX--X--X-o
-BEX---X?---X---Eo---X--B---T-X--XX-------o-------o-------E----------XB--X?XE----XX-?-------------o------------?----E-------------?o----E-o--B-------X--o----o-E--o-----X-XE--|-T------X-----X----X-----
m-oT--|------?---X---E-----XM----X---XX---------E------X-M-X--E-Xo-X--T------------o----XB-X---------T----------X----o--o------X--------?-----o--X----T-----------oBo-----E---B-XX----?-----XX-------X--
o--X?-X---o-X-----X--oB------|------------XE-X--------X--------X--?-BX--E--XX--E---XX-----XX--Xo----BXB------E?o--E--T------X-----Bo--Xo--------o-------X---|---X---------------X----XX----------|----B?
