-------?-------------o-Xo--o--------?--------------------------------------?--------MMT-------T--B--E---------E--------------o-------oo------X-o--------B--EX----E------o---------------------|---------
--------------o------E------------------?B?-----------------------?---TBE-o---E-------oo----E----E-X-?-T----------B-------o-------M-----BB--B-----------T----B-----M----o--E---o---|---------T----------
---o--o---o-----B--oB----|-------TM-------M---BE?------oB|------------o----?--M--?X----B-----------E----o------|---X-------B-B------?-------------|M---------------------------E--BB-?----------E------T
--B-E-------?----|--------------BM?-----------o------B------E----BE---?--X-------------------------B--?B-----|---?--B--T--B----B----------------E--------------B--------o---------M-----o-------?-?o----
----------o--?------------B----------------------?---B----------X---B-T---B----M--------------T-T---------o-----------------T|------B---------------B---?-----------B--|-o---------o----T--------?---E--
o-----E-X--------|-o------o---?--X----------------M-----E----------|------X----B------------TB----B-|---B---------B-----------o---------?-E-----o-?o---T----Xo---X---------?-----?X-----E-------?-------
--------BT--------oo--------------------B-M----X---------o--?-------B-----?o--------M-------------------M----E---T---T----B-------T--------------B--E--------------------------o----------E-------------
--B-o---B-o?---------|------|-------B------------o---------BB-------T-o----o-----------?--------B------E-o-----------M-----E-B---X------X----?EM---o----------------T------EE-------------E|B----------v
?---X----E--------o----B-?-------------o----|-o--------B-?-------------o---------------|------B-o-----B-B--------------------------------------o----E-------X------------------B-----X-----?-----B------
-BE-----------E-----------EX-------EE--------------?------E----B-E----------B---------------------o-----------?B-Xo--E-------B---------T?---------B---o-----B-------------------------E-----M-----------
--------E------Eo-o----------B---M-|----o-----B--o-o-o----oB---B---o-------o---T--------------------------|T--M----B-----o-------?-o--------BBo-B--------B----o----------o---B---E-M-B------------E-----
--------|------------|o-T-o--------B---o---?-------o-------E|-----------B----E-----E-o------B-----------------------------------o--EM----B-----------T----M-T----------B---------BB-----B-------?--X----
----o--------------o--M---------------X--B-E-------------T?-----o----|----------??---------------?----E------------------B----o-|------B----X--------o---------B-|----------------E---------------X-----
-X--o--B---------M--B-B-|B-B--?-------------B----M---------------o-o--|----------E---o-----B-------o---oM------------------o-----------|----------E-?-----o---o------o--E----?---B-o---M---M-------B----
m---B-----B-----------M----BBB--B---B-----o------E-o--?---Bo-?------------------B-------------o------X---------T----E---------?------------------?----o------------|-|----o------------TM-----|E-----?--
?--------------------?-----------B----------------|--oM------B--T---B?---B---o-----------?----------------------E--------M|-------B-----------o----?-------o---------oTE---E-----E----------T-----------
