--B------------------------------------oB----------------XB--------BBX----??XBX------------BX???------------------------------o------------------------------XBBX?-----X---------BB--------BBB--BXB-----
-----BBXB--------XXBX-B----------?XBXX-------oX----B---------BX?B-------------BBBBXBXXB--------------------XBB?X---------------------XB?X?----------------M?--------?MB--------------------------------B
------------BX----------------BM--------------EB--BB----------------BXMoB----MXX-------BB--B----B---XX?B------------------------------BBXB--------BBE-----------o-----------X?BX---------------B---BBBB-
XX---------------------------------BB----B-----BM?XB---XB-----?BB-BBB-XMB---BBBB--------------EB-----?---?B-------------------------B--B-BB--?BBBM--BXXB??BX---------EX?X------X--BBM---BB??--XX----MBB-
-XXB?X-------BXB---------XBB-------------------XXBB----B?-?M-------------------------M-------------BBX---------?XMXX------oBM---------------BB?-------X----------B??B---BB-XXBX---------------X?XXX-----
-----B----X-----------BM-BX--X------------MX----BBM--MBBX--B--B?-------------------------------------MB--------oBX-----------------------------M---------XXBBMX--?B--------------o----------------------
-------X--------?XB?--------------------------------------------------------------------BX----------------------XXXMB------------------B--------BBMBBBX------------B---------?-------B------BM??B-------
-------------------?BB---------B?-------------B-------------------------------X-XX?BM----XBXXXX------MXX------------------------------------------------BX----X???--EBXBX-----X-----------oBB----------v
------BBM--------B?MBB------BXMB-----?B--XBB-B----XBM-------------MXBM-------XXM-B?-------XB----B----ooBBB?BBB------------???--------B----------?XXX----EXo----BBBB------XB-------------------B?XX------
BX-BB--------------BoBBBoBB----------?XBB--XB-------------------------------------------------------------------------X-----------?XB--------------XX-------XX--------MB-------------oBXX----EXB----BBB-
------BBMX-----------------------M---------?BXMXB-----------------BoB----------------------?------------------------oB---oXXM-----------?BM---B--------XM-----------------------------------------------
------B-------------------B?MM---------------------BB?--------BBMX--XMBXX-------------------?BB?-----------------------------BMXX-------BX---M?B--------B--------B--------------------------------------
------EMB?XBX?BM------B------M?XBX-o-----oX---------X-XBB----------BB--------------------------X---XX--EX---M---------BXBB-----E----------XBB---------XX------XX---------BX-BX?-------------------------
----------------?T-B--------------oB--?B-------------------M?X---T--------------?XBB------------------------------BX------------XBB---------------------------TXB------X-BBX---------------------------E
m-XXXXBXXBX------|--------X-oB------------X------X?----XXMX-BX---|BB-------XXoTX---?B--XBB----XM-----------T--------XXXB-XXB?-B----------oX----B?-------TB?BXXMB-?T--M--MXB--------X?MT----TXB----------
XXXXBBXX-B?XXXXXXXXXXXMXXX-BMMX---B--XXXXXXXBMBXXXXXXXXBBX-----BBXXXXXXXXXBBXXXBBBBXXXXMB-XXBX-BBBXXXXBXXXXBXXXXXXXXXXXXXB?XX-?BXXXXXXXXMBBBXXX??XXXXXXXXX?XXBBXXBB-?XXXXXXXXXXX-XXXXXXXXXXXXXXMBXMXXXX-
