----B----------------------BX-----------M----------------------------M?X----------?---BXB---------------------------------------BBMM----------------------------?XB-------------BX----------------------
----E----------------------------XX--------------------------------------------------------------XX-----------B--------------------XXB------------------MBXB---------B-XX----BB-----------XBX------B----
------------------------BB---XBB-B------??-----BB-----------------XXBXXBXX------BBX-----------BBB-----o--------------EB---------?-----M-MMB-M--oM---X------------oXXBBBB--------------------------------
-oXM--------------?BBX---------XBXXX?---MXB-XXX?BB-B-------------------------------X-------X-----X---B------B-----M----------------X----------BB-------BB---BX------------------------------------------
-BMX-XBXX------------------------------XMM?X--------B--------------------------B----B---XBBX---------------BBMBBX?------------------------BB------------------------------------------------------------
---XX----------------------XXX-------------------BBXB---o--------------------?XB---B?B---------XXX------X?XX---XX----XMB----------M?XX---XBB-----?------BMB----B----------------?----BBXB?--------------
----?-------------BB---X----------o----------------o---X----??-------------------------------------------BB--------?------------------------------------oXXXB--------B?----------B---------EB-?BBM------
-----------------------------?B--?--------------------------------------B---------?------------------------------------------------------------M?BX----------------------------------------------------v
BX?---------------------------oB-BBB------------?-----------------EB---o-----?B--------------------------BB---------o?X-------------------B-----------------------------------o-----B-------?--------BXf
?XXXB-----oBX-X?B---oXXX------------oXBBBBBBMBXB---------------XMXXB---BMB?B?MB--------------oM------------------XX------?-----?B--X--------BB-B---X-----BX---------XX-XBB---------------BBX-----------f
---------B--------oBBX----------------------------B?XB----------------------------------------------------X-----?------o---------?B------------------------BB-------XBB-----B--BB----------------------f
-------oB------------------?B------------------?X-------BB------B---B-----XBB-----X-BX--------------------------------------BB?BB?X---------------B------MB---BB?M----------------X-----B---------?--XMf
--------------------X--------X?--------------?B-----X-----------X------XXBX------------X--------BX---------XXX-----BXBBB------M---------BX----------?------------------------------------------------E-f
-----?BBBBB-------------------------BX----------------BB-?--------------X--BX----B----BBX----XBBMB---BB-----B-----XB--MB-----X--------XBX------MX-B-------------MBBB---XBBM----------------------------f
m-----------------------XXBBXB------------BX??X------------MB----XT-------------------------------M--------B--------XXMBM-BX----------B---BBBXMXB----BBXB?--------XBB----------------------------------X
X----------?B-------oM----------?--------oBX----------------XB?---|--?B---X----oB?-MXB----XM---------------------X-----?------------XT-----------??X-----------B-----XBB?----------------XXXXXXXXXXXXXXX
X--XXXX--XXXXXXX--XX-XXXXXXX-XXXX-|XXXXXXX|XX--XXX-XXXX|-X-XX-XX-XXXXXX-XX|-X-X|X-XXXXXXXX-XX-XXXX-XXXXXXXXXX-XXXXXXXXXXXXXX|||XXXXXX-XXX-XXX-XXXXXXXXXXXX-XXXXXXXXXXXXXX-XXX-|XXXX-XXXXX|X--XXXXX--X-X-
