-------oXB------------X--------------------BBoM-----------------?B---------------o-------------BBB---BX------------?B--BMB-----------BXXX----------------------XXX-------------------------XX-------XB?-
XX-----?---BBB----------------BBB-EB?B----------------E-----BB------------B-----------------BM?--------BX------------MXXB--M??----------------------------------o--M-B---BBXX------------B--------------
ooB?---------------------BBBXX--------------B-------M------BX-------XM-------------XB?-----------XX-------BBBX----M----------------------MB?BB-----------------XBX---------------------------------X-XM-
---------------B---------------------B---------?----------BM-----------MB???B------------X-------------B-----------------BX-?BBB-M-----X--------------X-------EXBBB?-MB--------------o------------------
---o?M--------------BBBM-----BXXX-------Bo------------X---------------------?BB-------o-------------?-BBB---------B???B---------------------?BM?----BB-BBB?----B--------X--XM??--BMX--------------------
-----------MXBBB-------------BBBXXBXBB--------B------XXB---B-----?X??XXX-----------------------------------------?----------XX---------------XM---E---MB--------?BBB?----------BB-X-------BB-----------M
-B-------XX--BB--XXMM-?---------------X------------XXMMX--BBB?-------------------oXMBB?------M-B??XXX---------XXB--------?----BB-o-----------------BX----------------------------BX----MMX--------------
-----------------X---------BBBXBB--X--------------------oMX-----o-----------------X?XXX----?BX--------X------------------BBB?X-------------------------------------------XX----XMB---------------------v
--------BX?--BX-------BBB----------??-oBXBB----------------------MBE?---?BB--------------BXBX---BB?MXBBB?B-------------------------?X------------------X-----------------?X?-----B?------------X-----?-f
---------------------------------BX--------------------------------oo?MBM-----B?BXXB----------BBB----------------o---------BBM----oXX---------X--B--?BX--------XX----BX------------------------------BBf
----------BX?BX?o------------------X?X-------XXX?------------XE------?--XXBX-------BMBB???------------------B?-------X-X--------o----------oBM-------oB?--------BBB----B------------MX--XX-------------f
------------XBX-------o-B--------XXX-----X---------------X---------------?---------------------------------BX----------B?B--------B?B-------?oX??-----BBB-------------MX-----?E?-----MBX------B?B------f
-----BB---------------------------X-------------------------------BX-----------------BX-----------------------------BBX?-----------------?BEXXBX--o------BBXX?B-------BBB-------------------EX?XB------f
----------------XB?XB------BE?X-BXBBB-------MXBX----------B-----BBBXB------------------------------------------------XXXXMBB---------B?----------B-------------------------B-B-------------MB----------f
m---------------------------oXXM?B--------BBB--------------------EB------------------------------?-------BBB---------BXBB-------B------XXB----------B?B------------BB----------------------------EBX---X
XX--XX?XX----------X?MBB?------------------------------B--------------------------?--M-----M-------B----------------------?X------------------------o--------B?B---------------------------------------X
XXXXXXXXXXXX-XXX-XXXXXXX|XXXX--XXXX|||XX-XX-XX-|X|XXXXXX-XXX-|XXXXX|XXX-X-XX|XX-X-XXXX-X-XXXX-XXX-X-X|X|XX-|-XX-XX-XX|-|X-X-XXXX-XXX|-X--XX-XX-|XXXX|XXXXX-|XXX-X-XX-|--XXXX-X-XXXXXX--XXX--XXXXX-XXX--X
