--------------------B-----------------------------------X---BX----------B-M-X---------?-BXX---------------o-----BX----------EX---------------------?----MX-------XXM--------------XB-X--------X---------
-B------------BM--------------o---------------------M---------X---------------X----------B---B-?--B----------------EE------------------B----------B--BB---------?------------B?XX---??X-----MB-?--------
---XX-----------X---BXX----XX----------------?-----------------------------o-----?-?---------B----M---------------------------B--o----------------X---------------------X--M-----X------M---M-X-----M---
---------XBo-------o---X---X-------------------XXXB---------o-------o----o--oB----------X----------------------X-------------------------------o----X-------------X---------------------------BB--------
--B?X----------------------------?-----------------oMMB---B-----o--o---------BX?--BB---------------------?---------X-B-------B?B----------------------------------------------------E-----M-------------
o---------BB--------B-----------o--?----X-XBB---------------BB-------XoBB---------?----------------------------------------XB-----?----------------B------X--------BBM------------------?--M-oB-----oB--
----oX------------------------------------------?XM--------------------o--XX---X-----------B---X---------------------------------------------------BMXB-----------M------------------------X-MM---------
-------------------B--XXX--oXXX--------XB-?---------B-----oEBB-------------B-BMB---------------------MX--------?X--o------------------X---B--E-------BB-----oX--?B--------------EB----MB-----?X-----X--v
---BXB------B--XBXX---------BM-----------??M-MB-------BX----BX------------------------------------------------XB---------------------BBBBB---o-------------------------X-M?B----X------B--------------Bf
------BBBB------X--------------------------?-B-------------------------------------?-XM-------------------B------------------------------MB------------------------B-X-----------------------------XX--f
-----------B--------------B---------------------------------?M---------------X-----------o---o-----------------??--------------------------------X---------------MB---------------------oM----------o--f
-----o-------------------X-B------------------------------o------------XM?---?B------------------------------XB-?-----------XM-----------o-----------B------------------XXB-------B?o--X-B-------------f
-----------MX?------------X?----------------------------BXX---B---o------B-?---B---------M-EX------------B------E-B---------------BX?----------------oX------------XBo--------B-------------B----------f
-------------B---------------X-----------------------BX-oB-------X---------?------?oB--?--oE---------------------------XB----XB------?--------o---------o----E--EX------------------B--oB--------o-----f
m-----X-------To-?-B------------------------------B--------------------------------XX?--------B----B---------------XoM----------------X-------------B----------------------------oB---o-X-o-------oM---X
-X-XB------?B-X---------------B-BX--??EB-X------XTX----?---X-B?--Xo-BB-------XXXMXB-----?X----X?--------------BBBBB--BBXBBB--------------T----TMX--------------XB-------------------XMX----?X----------X
XXX-X-XXX|X-XX-|-XX-XXXX-XX-XXXXXXXXXXX-XXXXXXX-XXXX-XX-XX-XX-X-XX|XXXXXXXXXXXXX---XXXXX|X--XXXXXXXX-XXXX-X-XXXX-X--X-XXX-XXXX--|XXXX-XXXXXX-XXXXX|XXXXXXX-XX|X--X|XX|X|X-X|XXX-XX-XXXXX|XXXXX--XXXX-XXX
