------------o----XBo------X-XMX------|-----X----XXX------o--------o?E---------------XE--X------X-?-------B-------X-|--B-X--B---------?---?-?---M----?o--EX---------X-----B-E--o--------?---------?--XB--
?---X-T-?----E--------------Bo-----X-----XB-------X-------X---?ME----EoX---X|XX--B---o-o--------B-X--?----|---X--------------o-X--?------------o-X---X--M---------o------M-XE-------TX-X---X-XX---------
--X---|o--?-Xo--------B-XX-XX---X?-------X-X-----BXXX----X---o---------o---BX-?XE-------X-E-|----------------?X?--M-o-----oo-----X-X-X-------X--E--X----X---X--X-X-----------X-M-EXE|----B----M--X-Xo---
------|--o---?-------X-----M--X--B------XX-------------o------X-------------X-E----X---?B-B-X----ME-----X--Xo---------XX----X--E---X--X-X---------o------?-----BBEo------XB---X---BX|B----XXX---XM--?EB-
------|----------------X-|------?---B--X---B---EX--B----X--?M-E-X-o---o-------XE-----X---o-----?M-------------XX------------------XE---------X------------B--B--E--------Xo-X---X---|-o-X-X-B-----Xo----
E-X--B|-B---------X-------EX--X-Xo----X--------?X---?----XB-?-----?-----X-X--------o--------?----M--B---X---------------XXX--X---------B---B-B---X------BEX--BX----?--------o-EX----|--E-------o---E----
--X---|---|B--o--X-------X---X------o---?-B-------?-o------X---------E-XM---X-X-X-B------X---X--------X--o-?-MB--?------B--B-|-------------B--X-XB----o-X---Xo---XX----E-XE--XX-----|-----o---X-X-------
---?--|X----E-------XX----------X-M-B---B-E------X---X--oXX?----------------B-----E-X-X-------BoX--o-E----?---X-B----------MEo---X-------E--X-----o----XX-------?-----o-------------|----EM-----X-E----v
------|--BX--X------X--------X--?--X?------B--?E-B--------o--------X---M-----B-----X-----------------------X--X---?--o-----M---o-------X---X|o------o-o--M--B-E----X---X-B--|----MXX|-|--B-----?|----B-X
----oo||-E-----E|X-----M-o--X--B-oX----X--E---X-----------------oX--X---M---o-X---------EX-------XXX----M--------------X----X-X--o--X|-------|--X---X--X----X-----------------o---?-|---EB---------B--X-
------|o-----E--X---X-----E-X----?-X?------Xo----------?-X------E-|-X---o--------B--X----X------BX---X---B---------B--X--E----?-----o---oE-----oX------B-o---Xo--------?B?---M------|-------?-B-X-------
-E---B|-B------------B-----X--o---X--------|o------o-----?---X----X-o-----E--B-XEEMXoB----E-----X?---X--XM---------B-E-?----X--X--X-----------o--------X-X---X-B---?------?------XXB|-------X--o--------
o--X|-|-BXB--------X---E--------X--B----------------------X-----B--------XB-X-o------B---o-----|X-o---------------X-E?B--B-MX--------B-------?X-|-o---------EE---|----M-B---B----X--|-------B-X--X-o----
---o--|--o---------X---B--------|---M-----XX-o?--o-?--?----X-XX--X--------X-X------------E-o---X-o---X------o-X-|--?-oo--XX-----------X-----oo--X-X--B--X-------XX----?---E-oX----X-|----X-X-X-o--B-M---
m-----|-----?-EE-----------X---?-----------?--B-X-BX---B--B------X---|M----X-X?-E-o-?--X--B---M---B-------------------------Mo----o------B---X-X---XM----X-XBo---B------o---E-X-----|----X-------X-----M
XXXXXXXXXXXXXXXXXXXXXXXXXXXXXXXXXXXXXXXXXXXXXXXXXXXXXXXXXXXXXXXXXXXXXXXXXXXXXXXXXXXXXXXXXXXXXXXXXXXXXXXXXXXXXXXXXXXXXXXXXXXXXXXXXXXXXXXXXXXXXXXXXXXXXXXXXXXXXXXXXXXXXXXXXXXXXXXXXXXXXXXXXXXXXXXXXXXXXXXX
