--BBMBBB?B-----------------------------------------------B---------BB-----o?B-----------------------MBB-----------------------oBX---------BMM-----------------oB--------B----------o?M----MBX-B-----X?B-
--------------BB--------BBXM-?MXBXBBX?-----XBXB------BM-?B?BoBX?-?---------?BX---XX---B?-BMXB----------EX--------BB?X------M------------------------B----B-----------------MB?B-----X-------------------
--?BB-----o-------------------BXX-------------B---X?----------------BXMXXXM--MMXB------BX--------------B?B-------?X-------BBB----------------BX----oMM??X---BXM?----?-o?-------------BXoXoB?X-----BoXX--
-----------XB-------------oXX-----------o--------------------------?------------------o--oXB?-----------?BM--------M------MXX-------------------BM?-------------------------------BoBX-B---------XB?----
-----X---X?X?---BBoX-------------------------------------------X-EXX----------------XM-------BBXXXM----------------XBBMX-BBXB-o----------XB--------EBM?BBBEBB------------BB---BB------------------------
-o---B----X?BBMB------BBXBX--XBM----------BMXM--BXX--BBBB--MB-BM----------------------------------------BBB?---M--B-----------EX-------MMX?-X??--MBXB??-------------B------------------BB---------EX----
---------------------------------MoX----------------------------------------------------------------------------XBB-----------------------??-BB?--B??BBMX---oB-XXXMBBB---------X--BXXBEXXB--B-----BBB---
----------o-----------MM----XMXBBBBB?B--MXXBBB--------------------------------B-XM?------BBB---------BBX---------------------------MB-----------------XB------B?B--------------------------------------v
--------X--------------E-------BBB----------------XX---------------BB----------o---------------------?oXXBBXMM----XMX----BB----------o-------BX-------------o?--?BB----------XB-XX----XB?X------------X-
-------------------X?--BBXBX---------BBB---MB----------XXXX---------------------XXBBMoB--?M-----------------X----------MB------------------X-------BX-----------------XXBB---?XM----B-------------------
----oo??B---------------------------------------------------------BBX-------------XMBBX---BBBB-----------BXB---oXB-------MXB------------oMXX----------?BBBBMB------BB?X------oB------o------------------
MBBB-BBBB-----------------B?BXX--------------------XBX--------X?----BM--B-------------------??--------------------------XB----------------BX------------?BBBX-XX-----BX---------------------------------
--------B-----------??--------------B-----------BX-----------------XX--------------------------BB---------------------BB?------?XB-------------------------------------------BX----oBBBB?BB-------------
-----?BX--------BT-BB?------------XB--?--------------------???B-----------------?BBXX-----------------------------BXX-----------?BB------------------------------BM?--TBXX--------BM-----TX?MMB?-------o
m-TB-BXBX--------XXBX-------------XBBB?----------X------BTBM---XMX---------XXBTXXM-EX--B----X-BB---BXXB----BMXBBB---XMX--TBMMBMM?BTMB-BBM--------XMBBTBBBB------------|BXX--BBBBBMB-XM---B?BXB---TBM---o
XXXMXXXXXXXXXXXXXXXXX?XXXX-XXXX---X--MXXXXXXB-MBXXXXXXX-XX-----XBXXXXX-XXXXXXX?XMM?BXXXBB-MB?BMXXBXXXX??XMBBBXXXXXXXBMXX-|XBX-XXXXXXXXXXXXXXXXXXXXXXXXXXXXXXXMB-X?XXBXXXXXXXXXXXBBXXXXXXXXXXXXXBMXX-XXX-
