----------------B-----------BB----BBM-----XB--------XB?---B----------E-B-o-----------?BXXX----oT--??----XB----?BMM------------EB-B---X---------------------------|M-------X-----XB--oBXXBXX?BBBT-o?M-TB-
-----------------XX-------T------------E?----BB----M--------------------BB-XXo-o------B--------|--BBB-B?B-------EX-------B---o?------X----B---?------------------------------B--XB----X----?---|-----M--
-----X-M---------X?-------|Xo-------------------T-----------MB------------T?--BX---M----------------------------TBX-M-------o?------XX-----------------------?----oB-X-------------T------------------T-
-------------------------T-X-X?-----?------E---------------BB-----?B------|B------M--------------------B-------X|BX-B-----------EB----------B----------------M---------------------|BB-----TX-----------
--?B-----?XX---BB------BXBB--X-B-B------XB-----------------------------X-------o--BBBXB--XBBB-?--?--E------XT--------------T-----------?-----------o--------------o--------BM?---------XX--BXMM---------
X---B------------oX--------oX---BB----M---M??-----------------?--?-XB----------BB?--------------o----XBM-------------------|-----XX---------X--------------------------------M?XM---TX------BX-BBB--B---
-----------B?X???-----------T----------------XTXB-----BBB----------------B--------------B---T------------X--------BM--------X------BBM------------------TX---------B-----?XB---XoB----------EE----------
-----------------T--------T-----------oX----oB-------------------B?--------BXX-BBX----------|-----------------------------XX----------X------------------------?EB--------o--oXB------TTB----------T---v
-----------------M?B------|XX-----BB?------------------BM-----------T-XX--B---TBX?------M---------?------------B--?---BXX-------------------------------B-----------o--------BB-------E|X--------X-|B--f
-XBXX------oX-B---------------------------B--ooX-------X-------------------BBB|-BBXBB--------X--------------X-------B------------------------------B--?X---------BB----------BX----BB-------------X-M--f
----------------BBM?T------------B?-----------BXX---M-BB-------XXB-------M--------------o-------------XBBBM--------XBBX?-------MXB---B-------XXBT----------X----T------B----------------------X--------f
------oM?----X--oB--BX-----BB?oo----------XB------------------XXB--------B---XTT--oBB------------------?---------B----------------------------B-|B-------o--MB--|---BToT-?B----X---------B-------B-BBB-f
------------B-------?B?TBB-----?-------------X------------------MX----XoB-oX---XBXBXX---------?XXBBT----T--------------oB?o---------------------------XB---------------------------------BX------------f
---------B----BB-------BB?----oMXB---BXB-B------------?X-----B-----------------EBBBBB--------------|?---BB------------------?M?--T----------------??B?--TX--------BXB------B----------o-----o?--------of
m--------B-TXX--T----o---------o---X-Bo-------BX-----BB--BBX-BB??------B---BBBXX--------------------------------------------XXT?-------------------------o-----------------------------B?--E---------o-X
--------------------------------?----------B--------------------BBB---B---------------BMB--BB-----Xo?-------------BX----------B----------X----------------BBBB------XXXXXXXXX---XXXXX-X-X-XXXXXX-BX--XXX
XXXXX-|X--XX-XX-XX-XX-X-|X-XXX--XXXXXXXXXXX-|XXXXXXX-XXXXXXXXXXX|XXXX-XXXXX--XXX-XXXX|-XXXX--XX-XXXXXX-XXXXXXXX--XXXXX-XXXXX--X--XXXXX-XXXXXXX|XXXXXXXXXXXXXXX-XXXXXX-XXX-X-X-----X-|XXX-|XXX|XXXXXX---X
