----------------X----------oBM---BB-----------?-------Xo?BBB----------------?---XX-?X?BB-----XX---------------------oo-------------------------------B----XX---BXXB----------X--M-----------------------
-o------------MBBB?X?BB?--------BBX-----------------X?----------BXX----M?------?M-------XXXB----------XB----?------------------------------------EXBBBB-MBBB--XX------------------X----------------MXB--
-------BB---BXB-------------------------XX-------------------------??BXB-----------------M?X-------------------------------BBB--BBB--X-----MX?BM--BBB--------X-----o?X-B?------BB-----------------------
--------------------------BB-----------------oX--------------E?--?---BB-------------?------BBXB--??MB----------------------B-XXB-MXX---------MX----BX-------------------XX----------------------BXX-----
---------------------MMXX-------------------?-?----------o--------------XB-----BBB?----BMo?XX??-MB----BBXX?B??EB-oX------------BBB--------X?B---------BB------------------------MM-----M---BBBX---------
--------XXX-----BB-XX----------------X--XB---------------------MX-------------------------------------------XM---M-EB------?X--MXB-----XB--------------BXB---------MBBXX-------?BB?B-------MB--M--------
----XXXMM---o?-----BBB-E------BBBBB----B------------B----X?BXB-----MB?-------------------------------------MB---------BBMXX-----EMXB-----------------------------------------X--------------o----BBB----
--------B?XXXX?BBX-----B----?BBB---------------X----------------BB-??-----------?---------------------------------X??B?B--------------XM?BXB?BB---XB----BB-------M-------------------------------------v
o---MMB------------------------BBBB------------X------B?-------------------BBB-----o?---MM?----MXo----------------------------BX?BX?B--BBBBB---------------------------M?XB-?XB----oo------BXM---------f
----?oB-----------BBX-------------------------XB---?MBB-------B-------M--------------BBBX---------------------BB-BMXX-------?B--X--oBX??BBXM---BBX?B---------------XXXXX-------------------------------f
--------------------------------X-----BX--------?--oMo?----------XBBBMB--X----------------XX----------------XXBX----XBXBBBB--BXB-X?X-----------------------------XBB?---oBB---------------------MBXX---f
-----------MX?X----------o?B--MXB---------?B----BBB-----?B-----------------EBX----------o-M---------BMM-------------------?E-Bo----------------------------EM-XXXBX-------------BXBB-XB--o-------------f
------------?X----------------XX??B----------------------B-------o-------BX?E-----------------------------------X----BBBBB-----------------XX----------------B--B------------------o-------BXX---------f
-----------BB----------M--------BB-----------BBB?B------------X?XBBXBX---o-------BXB----B-----------------------oBX---M----BM?----------------------------------------B---------------M----------------f
m-----XB?XB---------B-XB-------B-------BBXXEBo------------MXBX---XB-----BXMMX--B?XB------------E-?X---------------o-------------------------oBX-o-XB?B----------------BB---------X--BB?-EXBB-----------X
X??----?XXXXXXXX---?XX------TB?-------B?----------X-----XX--------X-------------------------------BXB------BB-----------------o---MX--BXB---------X----------XX-------X-----------------BBMX--XB?------X
----X-XX-XXXX-XX--XXXXXXXXXXXXXXXX--X-XXXXXXX-X-XX-XXXX-XX|XXXXXXXX|X-XXXXX-XXXXXXXX-XXXXXXX-XXX|-XXXXXXXXXX|XX|XXX-XXXX|X|XX-XXXXXXXXXXX|XXXXXXXXXXXXXXXX--|XX-X--XX|XXXX-XXXX-XXXXXX-XX-X-X-|XXXXXX-XX
