-----B----?-----------B---------oEBX----------------T-----oM-o---M--------------------------B---------------M---------B---------------o-------BBMXX------BB-TX------BB-X---o-------------?BM--B---------
----------------------oB----M------------?-----?-E-------T------T-?-------MB--------------------------M--------X?--------------------X-------M-----o--------E-------B---o-----------EXo--------------B?-
-------------------?-EMX---T----oM---?B---B-----------X--|----------------------------o--?---------XBXX---------------X-?T?-o----T-----B-BBM---X---------------?X------o-B?----------------XXM----------
-?-------BB----------------|?X--------------oBX--------XXB--------M?--o-----------------ooMBX--------?-----X-M--BBXB-T---|-XBX?XT|X------------------------BB-------B----------B-------o?------BX----Bo-
-------o-----T----XB-E--------M---TXBB-----TE------oX------------------B--T------TM-TB----BB---TX?----------M--------|-----o--BX|BX--T-----------------------BBBBBBB--------------------B-----B?B-----M-
---o--------XMX-X---MBB---o-------|XXXM----|--------B------------T---XET--|---?-----?--------X-------o-o--o----------------M------X-X|B--EXB------------------BoB--o------------------T-----------------
---XXE-XB--MM--------?-----o----T------------T-E-----------M-----|B----|--B-------B-------------oo?B----X------?BM-B-T-oB??MX----B-----BX-X------------BX-------X-B---------------X?-----B---------oB---
----M-----B?--------------------|BBB--------XB-X?---------B---o----XX-------------B?----------------------??----------------B---------------------BXXX?oXT?-X---------TBX--B---------X---XMB-----------v
------------E------B----------M---------------?-------------------------E-XXM?BT---------------------XXB----B----XMB------------oB-------T----------X-----------------BB-T------BXTX-----o-------------f
--?-oXX-------------XX-X----------oBB----------X--TBM-?M-----------------------|XB-----------------------B---EX--MB-------------BB------T----X----X--T------------B-X----BM---MBX-|--oB---------BB?----f
-----EB?-BB------------------?-BB--BB----------------------BB--TT-----------B-B--B---------o----------BX----?M?---------XoB----M--------|E?----------|----Eo----XX---?----?XB---B---o-------------o---Xf
-----M--To------------------------T-----------------------?----||----------------X---------------X--------------------------oBX-B-----------XB---B-------T--------------------------------o--TBBX------f
-----------o-------B---------o----|---------o-----------------o--B-?--------T--E-------------------------------------------------------------------------|-----T----oB------EXo------------------MB----f
----------------------------------o----B-??-------------E----------TX-------BB--------------------------M----T---X--------------------BBB--B?--o?-B--XXB-----?B|------BoM---------------X----------E-TXf
------E------------------B?B-------------oB-----oB-------------T-----?B---B------B?--------oB----XX-XX-X?B-----X----X?---?---------------------BM--T------E-----------B--XBX---------------------------X
X------------------------------------BM-E--------------TX---oB-?-X--------o------B----------B-----------------X--------E-------B------X?-----------------------o?X---------------------------------B---X
XX-XXXXX-X-XXXXX-X|XXXXXXXX-XXXX|XXXXXXXXXXXXXXXXX-X-XXXXX-XX|XX|X|XXXXXXXX|XX--|XXXXXXX-XXX|-XXXXX---XXXXXXX-XXX---XXX--XXX-XXXXX-XXXXXX-XX|XXXXXXX-X--X|X-XXXXX-XXXXXXXXXXXXXX-XXXXXXX--XXXX--X-XXXX-X
