----X-M---X-------------o-o--------------oX--?--o-X-XX------X---Xo-X----E-------------X--X----o----------XX--------B----M--------------X---o-----X-X----------B--EEX----X---X-X--X-E----M--EE-------X-?B
X-X---TX?----------X---?X--------X-------oB------------------?-----o-X--------XB---------------o--------B--XX-XE--X---o--X-X?-o--M-M---Mo----X-XX--E-------oX--?Xo------?X-------o-------?--o-o-----X-oX
------|-----X-X-Xo--X-o-o-X-Bo----X------------o--B--X-----X-----X------E?----B-------------XX------X--oB---X----X----X---XB--------XB-----------------X--Mo---Xo--E---E-------B-o--B-----EXE-?----Xo--o
------|X--?----E-X--X------X----X--B-----M---Xo-Eo--Xo?---------?----o-BB---X?-------?---?---------------X-B---BX-X-MX--X--------B----XXXX-o---------XX--------X------------X-?------XXX-----X-----BX---
--BX-X|oo---------BM--X--?-XX-o-----X-------------------o-----B-----------X--?-----B-X------------o----------E-----Xo---------------X------o-B-X-----------------X------E--B---E-----X---X--X---o---M---
------|o-----------oB-X-B----B----Mo-B---EX--X--o-------EX---X------B--------M-----MMo---M---EX--XX--X--XX--------X-----X-X------------X---M---X--XX-B-XX---------B-XX--X---?--XE--X------X-EE--X---X---
--?---|-E-X----X---X-EB--M---XE---o-X------?-----------oB--Eo--?XXEB-oX-X----X-X--o---?o----------------------X--------B--XX--XE---------------E-X-B-X-------XX---MM-------------X--XBB----E-----oX-E---
o-----|--------X--------B---B--X---------X-E----XE---X-----X--------------o-----------X----X------------E-B-------E--o-------B----BM------------------X----------------------X-MX--------X---X----M--X-v
-X--XB|-Xo-?o---M-o------o?B--------XX-----?-----------o------X---X---X--o-----X-----o----?----Xo--o-------X------?o---------X--X--o-X--MoX-----X------------BEX-X------X-B--?-----X--E-X-o-X-X--B-o---X
---o?-|B--?---o----X-----X----X-o--X-B-?--X-----EEM--M--X----X---------?---BX------XBX-----o-X------------X----------E-------o----X-X-X--EEX?-----o--E------X-X-Xo-----B---M-X---X--oXB-------M--o---?-?
----X-|--?E-M-X-X-------?EX------------X--?MB------?-----oX--X--BX-------B----X-X-----EXoXX----E------------oB-X----------X--B--------B---oX-------X----------o----E-XX?X-------oXo----X----X--B--B-X-B-
----X-|----o------------X-X-o--XX---------X----XX--?-X--X---X-X------------X--------E--Xo------X-------?-------------X-------------X---?-------X-------MXo-----X----------XX--E-------BX?----?-------?B-
-XMX--|--To-----X--X-X--------------o-E-------------------B---o--------X----------X-B----B----X--o---XX--X-XX--o------X-o---XXB----X--------M--------?-X-X---o---Eoo---X--------?-------X--o----?-XX--B-
-X----|--|------X--EM---B-E---T-----------TT---o?--BX----X-----X----XM-?E-------B?-----B-X---X-------Xo----?-----M---X?------B--E--XXE-------B--?--X------?---o-------EX---------X-T----X-o-X----X-?--XX
m-----|--|E----------Xo---X---T--X--o-----||--X---E--------X----o---------E------o?-X-o-----X-M-o---oBo-MB-E-------X------o---------XX-X--BXX--o---oX-------X---------X-X----------T--?--o------------|-
XXXXXXXXXXXXXXXXXXXXXXXXXXXXXXXXXXXXXXXXXXXXXXXXXXXXXXXXXXXXXXXXXXXXXXXXXXXXXXXXXXXXXXXXXXXXXXXXXXXXXXXXXXXXXXXXXXXXXXXXXXXXXXXXXXXXXXXXXXXXXXXXXXXXXXXXXXXXXXXXXXXXXXXXXXXXXXXXXXXXXXXXXXXXXXXXXXXXXXXX
