?-X--BX-o---Xo--------------BX---BB-MXBB----?---------B------XBBX--??-X----X?-----M??XM-----MB------------X--oX------------------------BM?BB------BB-----B?X-BBX---------------------BBB---------------E
-oEX------B----BBB----B-----o-----oXB-XX?------------------B-----------X-BB------BB-----------------------XX--------oBM---------------?MMX---------o-----?--B---------BX?BB------MBBX--BX----BXBXX------
X---M-B--------B-------------------o----?---B------------o---oX--------------M-------------B-----------------------------M----o----?---------------------o?-------XX------------------------------------
-----B-------o---------------------X----BB---E--BB---------------MXXX-B-------?----M-------------------XBo-----------EB-------M-BXB--X-------------E------M---------B---BXo-M-------Bo----B-----------o-
------------------?--X------------BB--------------------------------------B---------------------B----------------------B-------?----BBX------X??BB-------------BX-------B-------MX-----------------X----
E---o-------------------M-------o-------------BB---B?------X---BX------B--------------------------MXXB------------------?--X------B-----o------------------B--o---?-----BM-------X----------------------
-------?BB---B--B-B--------X---??-----B---?B----------------------?------------B-?--BX-------------BX-XB-------MBB-----------------------BB---B---------------------------------------------------------
?-------X-BXB------------------o---oM---------B---MB-X---------------------------------o-------------------------------------------oB-------B---------------oB----------o-------X-B--M--------BB-?----Bv
--------X--------------X-------------?-?--MBX---XB----B---o-----BX--------------?------oX-------EBB-------XMX-----------------------------------------------------------X-----------------------X?-----f
X------X-oX--X?-----M?--B---E-------oM---XB---X-----------------------X----EX---X-------------------------------XB-o--?B??M-oB--------?--B-XB-----?---BBX-----------------X--------XBBBB------------XB-f
--------------XX-------XoX---B---M---BBB?X----MM-------------------------B-----------X-X----M-X?-------------B--------B-------------------XBB------------------BM----E?X--BBB--------XXMM--------------f
----------------X--------------------o--B--XB----------------BB------BX-X?--------------------------------------BBB-XXX-B---?-------------------?X---------------o--------------------BX?-----------?--f
-----------BX-------XBXXBo?-----XX-BBB-ooME-----------------X--E?-------B---MBB--------------?B-----------------------?--------------o------------------XB-----X-oXX-?---------B--M--------------------f
-------o---------------BM------------------XBXX---X----------MB-XXBXBM---??Bo----E---BoBX-------??-----BXXB----B---?--B--MB-----------B----?B--------BX-----XM?BM-------------------MXXX----BB-------?-f
m-------------------------------------------BXX-----------XX----------B-----------------B?-B-----------------------------??B--B-----o--BX?X-------E?--------?B---?X------------T--X---B------------M---X
T-X---?---B--?-B?---------------B-------------MXM-----B---------------------o--------------X?B------?------?XBB--------X-BB-------------?---M-o----XMT------M-------o---B----E-X---------------X----BXXX
-X-X-X|--XXX--XX-XX-X-X-XXX|XXXXXXX|XX-XX--X|XXXXXX|XXXXX-X-X-XXX-|XX||XXXXXXXXXX-XXX-XXXXXXXXXXXXXXXX-XXXXXX-XXXXXXXXX-XXX-XXX-X-XXXXXXXX-XXX-XXXXX-XXXX-XXXXXX-XXXXXXX--X-X||XX-XXXXXXXX-XX--XX--XXXX-
