---------MX-----X------B--------------B-BXXBB--B----------------------------X--B-----??BoBX-------------------o-----B-----Bo---------------------------------------M---------E-X---------------X--XX----
------------M--------------M--X------M-----------------?------------B----B---EoX--------X-EX----------------E--EBB-----E---------------------------oX-----MX---------------XB----o------X---------o-----
BXXX--------X-B--?------------------------X--------------B-BBXB------------?--BX---------------?M------B?---------BBMB-----BBX------Mo--?M----MB?--------------------------XB?-------------XX-----------
M----M----------------X--------------o-----------X---B-------------BBB-----XB------?--o-------------o-E----------------------oBXX-------------E---------------M--BM---------------X-------------------o-
-------??B----------M----BM?------------------MB-----------?B?B--XXBBM-BBXM----BoBM------X----BB?B---B?XXB-MBEXX-B----------B-------B-X-BB--------------------------------------------MB----------BXB---
-XX----oXMX-B-BB-----------B------o--M?------------B--XM----------oXB-XB------------------------o----M-------o-----B-XB---B--------------XX------------o---XBBX---?-----------------X-------------------
X----------------------------------?--------------BM----------------M---X---------------X-BX--B--------------------BEX-oB-------------X-?--XB-------XBB------------------------oB----X--M---------------
B-------X-X------BX----M-------------B----------------------------------BX----------------B---------MX----X-----------M----------------------X--BB--------------------------------------MM-------------v
--------BX----XX-----------------Xo--?X---------------------------------BMMX------M-------?B---------BX----X-----oX-------------------------------------BB?----BXXX-BX-----------o------B--------------f
-X------------XB--B---X-X--------------------------------B-----BB-XX---B-XB-X?B--o----------------------XB?---------M---------------M--------BBMB---------XBX------------?---------------BM?BM---------f
--------X--------------?---------?---------?----o---oXX-------X-------------BE---------------?--B----------BM-?----------------------MX?B---------------o-----X---------MX-XX----X----XE-------------XXf
--------o-----oBX--XX------M-----BB------------X---------------o-?XE--B---------B?X-----------B-------------?------?-----?--o----------o-?--------B?X-------------------------------------o-?-------B--f
------------o-X------E?B--------------------------------------?XX----X------------o-------M?----------M-------o-----------------------------M---o-----------B---------------------X--------------------f
--------?-X-oBB---------------------------------------B--------------------?------------------------------------------------MXB?X------------------------------------------------------------------B?--f
m-------------XB-----oB------------------------------------BX----------------------B-------B----o-----X------------------------------?------X---------------------M------oB----X-----X---------------?-X
-B--M---------------MBoBEX--------------XBXB--X--------BB-BX---------------------B---------------BBX---X?-----BBB-----------BB------B-----o?---------T---X-------EBMBMX-----BMB--BB-EX-----------------X
-XXX-XX-XXXX-XX-XXX--XXXXXXXXX|XXXX-|XXX-XXXXXXX-XXXXX|XXXXXXX-XXXXXXX--XXXX-XXXX--XX-X-XXX-X-XXXXX|-XXX|XXXXX-XXXX-XXX-XX|XXX-X-XX-X-XXXX--X|XX--XXX-X-X---XXX-X-XXXXXX--XXXXXXXXXXXXXXX-X-XXX-|XXXXXX-
