-----X--o------E---oX---------M-XXXX---BX--------o-EX---X?---X--?--------?--?--oE---------o------o-o--------M-----X-----EX-EX---?---X----X---------E-?---??---BX-----X-X----B------X-o---XX--X--------M-
------X-o-X-------o----o-X---X----E-----B----X-----?B--o---X-------E--BoX-------X-E-X----o-M---E------------------X-XX--X----------------X-----------E----------E-X---oBX----B----X---------------------
--------X--------B-----------?--X--------X--E-----B--X----X----------B-X------XX--X----B--X---BX----X----B--M--B-------X---M-----X-----Xo----o------?---E-------B--------------------X--X---------B-XBEo
------X-X--X------------BB-X----------X-----BM--X-B-B--X------o------------X------o-EX--------o-o------X-o-----X-X-XM--oXX-----X-X?----X-?o--o?B-----Eo--E-----X---M-------M-o------X-X-oB--------X----X
-o---X---------X--Xo-----------M--B--X--B-----------EB-----E----X-----o-X------X----XX---B-XX-------------XBX---E---?----------Xo---B--E---------oX-----X-----?-XM--X--?-EX-E--oM---X--------o----------
--o-B--B--B--------------X------------X-----?---------o---E--X---X--X---------XXE-X-o---X--oM---XX-E-BXX----X--B----M-----B---B-B?X-X--o--X-------X--XX-------X------X--------X----------?-X------------
---o----E----------X----oM----------------XB----B---oBX-------oE-X-----B----o-------------o--BX------X---X--------o-----XXBo--?-----------------o-----------BX----M-B-XX-X------XX---X-X---X------oX----
---o-X-----XX------X---------------X-------------X--B?-----?-------B-------?---B-----?-X-X-----X--------------B-o-o-----X---XX------X-----------------o-B--------X------------o--M---------X--X-------Xv
-X--EB-------XM---X-X--E---o--X-------?X?-X----X--------X---------X-----?-----XX-X---E--X------------E--?--o-------------X---X---------------M---------B--------XB-----o--o--X---M---B-BM--------XBX----
---X--X-o------E-o-o----------------?----o------E----E-X------?--X------X----?----X--M----------X--M---oE----X--B-X-----EX-B-------------Xo-X---?--M---X-----XE-----oo----------B--o----X--------oX--BXX
--X-----------XB-------MX-B-?X--M---B---------------X----oM-X-X----E------M----BB-XX-EE----X---o---X---------o-----Xo-----M--o--------X------------oBBXX-----------X-----o----------BX---X--------------
------X----?oM?-?------B---X--X----------E---X----E----MB----------Bo-----E----?------E---------EX--E-X-------X-B-X-----o-?---X-----X------E-----?-----BB-X-----o----Eo--X-------o--M-------E-----E-X---
--------B-----?-X------XE---------X--------------X--BX-----o----X-EX---X-----M----E------o---o----X--X-------X-XoM--------------oE-XXoX---XX-----BXB----------E---------E-X---BX--------E----XX------X--
-?-----XX-----BE--M---X------?X---M--X------X-------M-----------X--E------XX----oX----X-X------M--M---------EX------------XE-oX-----X-X---o---------B-X--E------XXX----------------X--------X-B?------X-
m------E--------------X-o-----M-X---?-----EMX----------X----X---------o--X-----X-----X---X-----?-o-----------------o-X?-X---------EX---X-XM------BX------M------------X----M-E----XB-o-B-M---B-----X-B--
XXXXXXXXXXXXXXXXXXXXXXXXXXXXXXXXXXXXXXXXXXXXXXXXXXXXXXXXXXXXXXXXXXXXXXXXXXXXXXXXXXXXXXXXXXXXXXXXXXXXXXXXXXXXXXXXXXXXXXXXXXXXXXXXXXXXXXXXXXXXXXXXXXXXXXXXXXXXXXXXXXXXXXXXXXXXXXXXXXXXXXXXXXXXXXXXXXXXXXXX
