--B--?----------oB------o---------------?------B----B-----?|----------o-|----------|---------|---?-T-----------o-E?-----------B---o-----------------?----M-----B-------------B-------B------?---------?-
--?----B--E----B---------B---------B---?-B----------?----o-?----------------X-?------X--ME----E-------o--o-E---------------------------o?--X---------------B------M---|-B---------------T-B-----E-------
--E-------------?-----------------------o--M----o-|--E----B---?-----E?---------o------------------------oo---------|o--o|-----M-----|------?------B---------Mo----------B-||T------------------B-----?--
B-----?----?----B----------------------?-----------?--B-------o-----|------o---o------B-------------B-----o-E---B-----?---|-----o---------o----|-----------------B----------------------X-----X---------
--M---B--B-----------X-------------------B-----X------T-o--E-|------------------E------------------B-------------o---E---?----------------------o----o?-------o-------|B-M----B--T-E--B-----|-E---------
------X-B------------------T-T-------T----------------o----E--E-------?----o-----------B-----------E-------------------------------------B---------B-----------------T------------M----B---------T---o--
B----B---B-------------o----------------------------o----o--o--o--o---T--------------?-----o---TB------------M?-------------?-------B-?--B--------BT-------------?--B---------------|------B------EB----
o----X--------------?B--------E---Bo---??--E?----?|-|---o--------|------?-X---------B-----o-E-----M--------|-?-----T------------B-?-o------E--o--B--------------------------B----------E---------------v
-----B-----T-----|-----B----?-X-----?----------------------B-?---?--o-----o---E-------B-o--B--------E--?---?--------E-----------?---------------oo---B---X---?-|-T---?o-o--------------|B------------B--
-------?TE---o--?-X??-B-------|-----------o---------X---E-------?--E------B-----o-B-------M--------ME-----|-E--------?------T--o|-B------MB----?-----|--------BX---T---------------------B--------------
-------------E|--M--T----------------o--------------?-E---------o--|------?--o-------E-B--------------------------B--E------E-------?E---B-----?-oo----B----------?-----------o-----o-B--B--E----o---BB-
-------------------------------EBE-|----E--------M-o--o----------------?------------------|T---?--E-o-------------------------------E-M-------?--------E---E?----B-|-----------B-----o----B-X----?B-B---
---o-----------o----------------o----o---B---------o--B--------?-------?---------------oE---?----|------o------T------------X----------------B--o-B-----o---Boo-----M---------E------------o?------o----
-E-------------------?--M----B--------B---M---------?-------o---------??---X-----o------o-B---------------------------M-M----E-T-------T----------|----?-E------------------------TB-X--B--------?--B---
m--|--------?--o------o----BE------------o--------BE------?---|-----------o--oE--------------------------------------------B---?B-------------o--?--------|-----------------------X-o------o-M----------
-----B--------o--------B-----o-------------o-E-----?-B-----------o----B----X----M----------------M-----------T----o--------------E----?--|-----o-E---------T------B--------------------ET-----BB------X-
