--------M---?-------B-|------------------o--|-----EE-----M----E-o-----------------------BM----------------------X------T---o-|-|------------------EXB-B---------|----------------------------------EB--o
-----B---T------------------------------------------------|-E---T-----B--------------T-----|E------?-B------X-BE---?---------?-----M----?-B-----T--?--o---------------o-B--B----------X------------B----
----o-?-----------------E----------B-----E-------------|------M-----E----------B-------?-----------o--------B?--------------EB------EB---B----B-o-----------X------Eo----------?--o-------?oMo----------
-----------------|--------------X-------B---M--oXB----?--E--------B-----------------T-----|B----?-------B-o----?-----E----M--o----------------------BE------------------------T-|---o--M--------M-X|--o-
------E-------------B-----o----|-------B---T-----B---o----------o----------M-------o--M---o----------X------||---------------------B---|---o------------------X---------E-----E--------------M-T--------
----X-----B-T--B----oBo----o------o-o------E----o---------o---B----B------Xo-B-o------?-----o-----------EM----------B------TE------|-----o|o?-B?----------?M----?--------Xo---oE-E------oT-------B-----E
---B-------o---?--------------o----------X-------------------X-E--|---B-|---BX-X--------B?---------B-------------oB-E-------B-------o---Eo-----o---------o---E-|-------o----?----?-?--E-o---B-o----BB-?-
o-B---M-|----------E---?o-------------o-------------------?-E------o------------o--o-----|-X-----------BTo------X-E----X--------o--------E--o-o--------------------E---T--M------B--ETo--o-----B-------v
------?--------------X--------------T----------o----------------?----B-----o-----------------B----------B----------------?----|-----------|B----E----------?----?-----o---M-------------------?-o-----B-
-----EE---B----------------E---?-------------------BE-------------?-------------------?----B----?-?-------o---E---------o-----?-------X------T---?--?-B--------o--|-----------------|------Xo--MT-------
---------o------------E----------?--|?-------X---------|-o-------E----------?E------B----------------|-----------B|------BB--------------------E---oo----------oMB--T-----------E-----------------------
-?----B----------------E--B----?------------------oX---------o-----X------------------------------B------------B-?---------------?-----X-------o-?----------------?------T----------------EE------B-E---
--B---?----------------?------------Eo----------X----E-------B-------o------------------E--?---Mo-----o-E-----------??-----M--|-----T|--o---o-B-B-----o--------------X|----M--M----------------B------?-
E---|----B-B-?-E------T-o?--?-----X-----X--?---------------------------o-----?------M-o-E---B-X------M-----------?--------------------------------XB---EB-T--B----B----------------B------------?-------
mB-----|---T-E---------E-?------------E----B------?--------oE------------To----?----?--------------E-o-----T-B-----------MB----|---------?-----M-?---X-?------?---------------------------------X-------
XXXXXXXXXXXXXXXXXXXXXXXXXXXXXXXXXXXXXXXXXXXXXXXXXXXXXXXXXXXXXXXXXXXXXXXXXXXXXXXXXXXXXXXXXXXXXXXXXXXXXXXXXXXXXXXXXXXXXXXXXXXXXXXXXXXXXXXXXXXXXXXXXXXXXXXXXXXXXXXXXXXXXXXXXXXXXXXXXXXXXXXXXXXXXXXXXXXXXXXX
