-|E-X--X------o-------B----T--------o-E-X----X-X---------X--o----M---X-o-E---X-----XB--X--X--X--X-oX---M----X-----X?B?--------M-XX--X--BX-X--X?----X----o-o------------------X-------o-M-------?-B-X----
M-BXXX-----B---B---o-----M---------M-----X--X---o--o-----XX--X--oXX-------?oX----X---X----oX-------B-X----B----?-o----?---M-M|X--o--M--------X--E-M--EX---------B-----B-----o-----------XE---X--------X-
--X-B---EX---X--M---------X--X--------X----X------?--o-X-X--X-------------o-X-B-X-----|-X--oo--X-----TX--------|----X-----E--B---E-X-o--oTXB-B-X----------M-----o-X------X---------o?----------X--------
---------E---B-B-X---X----------o------------?|--o-?---|---B--------XXo---oX-----X----X--o-------------------X-B-M---XX-B--?-o--MB--------X-B--------------|-?o----B----EoX-------?----------B----------
-X---T?--------?o------|----B------X-X-B---X-------------T-------X----X----------X-B------------E------XX---X--o---Xo----E--X------T---X--?-----X-o-----Xo-X-B---o--X--------o--oo---E----XX-X--X-B-X---
MT----B--oo--------o-------o----Eo--M---E--M----EoX-----------M---X----EE--X--XX--------B-----T-TX-X-------X-----?--T--------------E---?--|--X---------X----o-----M------X-------X----X----|-B-------|oB
------|X-----XE--E-----o-?-----BB-----X-------X-------------?-------X-M------X----XXX-X----------------XX---------X-------EX--X--o?--X-----M--X-----X-E--?---------M-X---o---X---Bo---X-----?-B--B------
XX-?-B---o---X------------E?---o------T------T-B---X---X--T--o---EBB-------B---X----X------|EM----X-X-X-----X----X--oBX--o------MX--------T--------M?----X------X---XoX---X----X---X---X--B--X--------?v
-------BB-----X-----?-|-o----oX-X-------X------------?---o--X--o-X---o-XBE--------X----------XX--X-X---XX-X---X-X?------------?---X----Xo---------BX---Xo--------------------oo--M----|--oo----oo---X---
X---o------Xo--E-E-X?---oo------X-------|X----X-B------X--EE-----?-XX-Xo-------------?-X-?------X-------o-X--X-X---M-MBM|-----------o----------B-?-XX------------X--oX-----X-X--XB-X-X-BX----X---X-----X
---?M------B-X----o---X----------|-----B-X----X-----E--------------X--X?------o?----X---E----Xoo-XB---X--E--X-------------T--M-B-?---X-X--T------BX-TX-X--------X-------Xo---|------------T-X--X--------
X-----------B----------XX--o?---T------B----X----X--------X--X-oB-------------------E--TXTB---X---------------?-------E----X-----XXT--X---o---XB--X------E-----T-X--BoXX---o-X--M----------X---------X--
---E--X-X-MX----BB-----E------oE-Eo----o-XX--B-------B---?-B---BX-----o-Xo--------Xo---X-X-o?------B--o-------E---B----o---X---------M----o-B----o-------X------B-o--X--oB---------?--X----------X-?oT-T
-----X----T--X----B---BX--XX-M?-o-----E-X----M----T-M---------BB-X--X-------?--?---X--o----X--o?-o---o-|X-o--X---X----EB------E----------X-?-o-----X-----T-----|----X-------ME-----X--X---------------X-
m------XX-X---oo---X---X--------X---XT--------------|-X--E-o---?-o--o-----XX---o?----B------------|-XE?----o---X----|XX---T---TX---X-------X-BX---X-----TX--X------XMB-o---------|--------X-----o-B--EX-
XXXXXXXXXXXXXXXXXXXXXXXXXXXXXXXXXXXXXXXXXXXXXXXXXXXXXXXXXXXXXXXXXXXXXXXXXXXXXXXXXXXXXXXXXXXXXXXXXXXXXXXXXXXXXXXXXXXXXXXXXXXXXXXXXXXXXXXXXXXXXXXXXXXXXXXXXXXXXXXXXXXXXXXXXXXXXXXXXXXXXXXXXXXXXXXXXXXXXXXX
