--------------B----------B-B----E-------E---E-----o---M-----|---o--------X-----------------------------------B--------------B-----------------E-BB-------------B-?-o|M---X----B-M------T--------?-------
--M-B-----------|--------T------------T--------------E-o-----o----B-----E------B------------B---o----E----B---o-------?o-o--------|-----------------o-----B---E---?----------B----|-E--o---------------M
-o?--o--?-M--------E-------B----------------B?--T--X-----B-X------------------------o----?---E-B---------o----------------X---Eo-?-----T----B--B------------oX-------Bo---E--B--------B--oB---?---------
----------------B--E------o--E--------B--------E--------B-----o-------T?o---o------E---o--------M--------------B--------o--E---------o----------B-?B--------X----B-o-------X----------TX-M--------------
T----o-B-------------------o-B-----o-o---E------?oT-?-o-----------?-----M---TT--B--o-----M---?-B-T---|-------------o-------X--------B---?-T---E----?---EB--------o--------?---------?------------------B
---o-------B--------oX------?------M----------------X-----------|----------------X------------MT-----o--------o-------------------B-----E-EE--o-------B|------------------o--MB----?---X-?--------------
-------------------MX-----B--M-B----?-M-oE---------X------B----------------B-----|----T----------------EE-?--------|--o----------------o----EB---o---E-------|------o----o-------?-?--------------------
B?--B?-------------oE--------oE---o-------------o--o-----?-M----B------?--------M--------------T-M--X---------T--B-------?---------oo-M-------------------------|E----?---------?-?--------E----?------v
--E----------?----E---X----MMB---o?-o--------o----T--E--o-B------------M---------|--------B-----T--------------------|M------B---E--------------B----MXM----?------XE-E------B--?-B--?---------------X--
-------------o----oX-----?-----X----------o-E------M-----------------------------------------T-----|M----------o?----E------------------M-----?--------B----------EB-----E---------o----B----o------|---
----------------------X-|o-------MM--M-----T-------?-T-M------B--EE-----------B-------X-T------|--------X-----?B-------B----M-------E-------------o--B----------B--|----B-----oM----B---B----B------B---
-----------------------B----|-----o--M----T------------o-----------?--T---------XB-?----B---|-?------------EM--------B------------------E-------X---------|--------B---------X|-----o-?------|--T----MX-
-oM----------------------------o--|--B-----------B--?-----------o----o----------B------?-------------B-------------------------M-------|-----?--------X-----------oo--o----o--M------------B-B---o--E--?
-B--T-BB-----E-o-E?----B---E----------|---------------------X-----------o------------T-----------------o-------------|----Eo------B-oM--|----oX---------------------?------B-o-----------|-?-------o----
m------T-o--XX-----------XB-------?--------------------------------M-|--B--X--o-o--------------------?------------M------o---o-B-?----M---B-------o-----E--o---------?-------X-E--B---o--X----o-----|-E-
XXXXXXXXXXXXXXXXXXXXXXXXXXXXXXXXXXXXXXXXXXXXXXXXXXXXXXXXXXXXXXXXXXXXXXXXXXXXXXXXXXXXXXXXXXXXXXXXXXXXXXXXXXXXXXXXXXXXXXXXXXXXXXXXXXXXXXXXXXXXXXXXXXXXXXXXXXXXXXXXXXXXXXXXXXXXXXXXXXXXXXXXXXXXXXXXXXXXXXXX
