X--------------------XEX------Xo----X---------X-X--oo--?-----B-o----------EX-B-M-?--XoMoX-X---XBoo-X--X--M-X------M-XEX----X-o-------X-----------X-----------XB------B------B-Xo-Eo-X-----B------o------
-oX--BE-------B--B-M---XXB---?--------o---E---------o---?o---X?X-------X---B-E-------X?-----------oX----M--------------------X-----------X--?--?X---X-------X?o------oX-----------------o-----X--X---X--
---o------?----EE-B--EM-----------o--o----o----------o-o----X-------B-------------XBX------?-?---------X-----------o-----?---X------X------B--X--E-------o----------------X--------X---XX--B--EB----X--?
----E-B---X---?--o--E---o--X------Bo--------X--B--------XX---X-----E------oo-o--XX-o-X-B---------?--E-B-X--------X--X-X---?-E-----X?-X-?--X---B-------o----E?--------M--------X?------B---X--X---X-----X
--X-X----XB-o--XX-o-XX-?------------------X-----------X--X--------?E----------BX--X-----o--X-X------------XBX-X-X-------B-------B-------XEB--M-?----o-----------------?----------?X---------X---B-XBX--B
-----B---E--B---B-o-----X----B-------X-X-B--oX-E---X-X-----?o---E-X------XB-o--------X--?-----EoE------X--MX-XB-----B-X----M----M--B---Bo?------XB-------X---M---X----X------M-----------------M---X?---
Bo------------X--X-o---BX---X------------X-B----------o---X---X----X-----X--o-------B--E?--o----------------X---X------X------X--B----o-oo---------BM-?--?------X-----X------X---------B------------?--o
o--o-X-----Xo------------E--X-?------X--?-X-X--------M-X--XX-----X-----B--XMX--B----M--X---------EX--------------B-----o-E----------X-oX----X----------E-------X-X?X-------B--------------?--X-oXX-X-X-v
--M----X-E---Bo-----B-----Mo--XE-----o----X-----------------?-o-B-------E-E------o---?-----o-B--M--o-?--X-----o---X-o-E-----------------------?-----?-M-------------------X-------o-X-----E-------XX--X-
-?-----X--------EX-----B-E--M?X------------------X-X----E-----E------X--------B--------------------BX--X-o--------X----X--------EBX--------X-------o-----o?----?-X----o---o------E??-E----------------o?
-X-------M-?----X-o-?o---XB----BXX-------EX---X-------------oX---X--------o---?-----X---XX---X-------------Xo----------------X--o-------E---X---------------------------B--o------X---X-E--------B----B-
-----X--XX----XX------------o-X-X------------?---B-B--B-------XX----?----E-----------------X-------E--------------Xo--X-X--Mo--E---------X-------------Xo--X--------?----o-----EE-o---E------X-X-X----X-
?oo-------?--BXX--------o---o----E----XM--X--XoE--o-----X--X----M---X-?-----------o-------------o-----XB---------X---o-----o--B-----XBB-----X----X--X----------o-X------?---o-X---B-----------o--B-----B
---B-M-----X----X------X-X--------------X---oX----XB--o--------oo-X--X------XX------------B---------?-----XXo------B-------EX----MX--oX---X-o-----------------X------------------BB---X-o-X--o---X------
mX----|---E----X-B-o--Xoo--X---------o--XEX------MX--------------B-?--X---?-B----|--------B---o--|---E-----o---Eo--?M----?--X-------o-------X---------B----B-?--E---|----------------XX--X--M--B-?X-o-X-
XXXXXXXXXXXXXXXXXXXXXXXXXXXXXXXXXXXXXXXXXXXXXXXXXXXXXXXXXXXXXXXXXXXXXXXXXXXXXXXXXXXXXXXXXXXXXXXXXXXXXXXXXXXXXXXXXXXXXXXXXXXXXXXXXXXXXXXXXXXXXXXXXXXXXXXXXXXXXXXXXXXXXXXXXXXXXXXXXXXXXXXXXXXXXXXXXXXXXXXX
