--B---------B----------?o-----?-o---------------------BB-M-?--E-M--------B-----------X-M------o------------X-----B-----o--B----?-B--B--B-------XXX--E-B-------E----B---B----XoX-B------E------X-----o-X-
--X-XoT--------Xo-X---X----------B------------M------E-X------?-----oX--o--XX-----X?--XX--X---X-------E---X--Xo------X-o--XB-------B--X--M----------XB--X------X----X----X--------o---Mo-----XE-------B-
-ooBX-|B---B-o---X---?----o--B-XoX-----------------------X--X--------------EXB-----X---------o--o---EX-X--B----X--X-----X-X---X------o-?o-Xo----------B-----B-----------o-----X------X---oX---------?-oX
-E----|---------B?---X?------X--oo---------X--o------X---X--X-------o-o-----o--X------X---------------o---------------?o-----o-BX-X----------X-B------------------------------M----o--X------oX---------
-X-X--|-?E----M-----B----------------?---B-E---?BX-------EE--XX---o---------------o---E-XX-X-------X----o-o-X-B---------B-X--B-o-X-----X---?-----X------X---------X---------------??-o---XXE?---X----X--
--X--X|------X-------------?----X--E-----X-----oX-------o--X---XXX--X---X--XXo---?X---------E-------B-B-X--?o--o---------------X-?------X-o-----X----X-----X------------X---XB-------oXB-X-o---o-BXEX-X-
---X--|-E----EEo--XE-----EXo--X-X-oX------X-----oo-E--E--XMX---------------oX-X-----o--------X----------------X?-------------B?----BE-?-X-------E----X--X----XXX-X-------EX----o-XXX----B-B----X-X-X-?--
X-----|---XX---XX-----MX-o-------X------------XE-----o-------X--o-------X-X--X--XX--------------------o-XX-X-E-----X------o---?X-------M-oBX-X--XX---ooXX------X-X--X-----B--X--------------X---M------v
-B-o--|B---X-------X-M---------X------|-----------X-----------BX------X---?E-X-----X---B---X-----X-----------B-------EXX---o---------?B-----XX--X---X--o--Eo------M----E?X-----o-------X----X---B-------
o----X|X-X---------o-?-X-?-------Xo---XX---B---B----------X---------X----Xo----o-X-------X-X--X--------XM------------?---?oM---o------B---o-X----B------------EX-------o---XB---o--XX-o-----o-------oXX-
-?--E-|-----------?o---?-X-----------------------XB---X----------B---------o----------------oo-------X-XBXX-M--o----------------E----?X-o-E---X--EB-----------E--X-----X--X-------E---o--------X--X-----
----Xo|------XB-o---B----------X--XXX----------------o---------B----------E--Xo--X-B-o-M-X--EB-?------E--------X--------E--X------------X-?----?----o--oX----------X----------------B--B-BXXB----X-E----
------|----------MX-X---------------X-?--X-XX----------o------------E---?BB------XM-----X---MX------------o--X-XoE-?------X-----X-o--XEX-------o-----o--X---X----o-B--X--M------X---X-----E-B-----------
XE----|o-|--E---------------E-----------Xo---EX-----------------XoX--------X-o---M------M-X--------XX----X------X----X-o---E-----------------XX--BX--X-------X-o-X-----B---E--X----X--X----X-----BX---X-
mXB---|--|XX--X-X----T--------E------X---?-E?X-o---E----X-BEXB|-----o--E|B---XXo-X---T--E---TB----X-------X----X---X--------o----o-----XX--X---X---X------X-------XX----X-M-------E-------E--X---X------
XXXXXXXXXXXXXXXXXXXXXXXXXXXXXXXXXXXXXXXXXXXXXXXXXXXXXXXXXXXXXXXXXXXXXXXXXXXXXXXXXXXXXXXXXXXXXXXXXXXXXXXXXXXXXXXXXXXXXXXXXXXXXXXXXXXXXXXXXXXXXXXXXXXXXXXXXXXXXXXXXXXXXXXXXXXXXXXXXXXXXXXXXXXXXXXXXXXXXXXX
