---------E-----------------------B------------oE--o--------Bo-?--------E-----|-B----B--------o-|o---------E----------B-E----o----------E?--o--------??---------------T--B-------T------------------o-Bo-
--B-o-----T-----------B---------------------------------------?-X--------o-T--------------B--------X----M-M---o---XE-------?--B--E-------o----------------T----B-------E----B-----X---------------B-----
-------E--------?----B-B---B--------?----E---X---o-Xo-------B----?B---o-B--------?-----B-----BT--E---M--B??B------|----------X-----T-------M--B------B-T------|-----------E?-----o----------------E-----
-----------------o-o--------o----T--T----|---------|-T-o------E----B-Bo--------o----------------o--TE--|o--------B----?-B----------------------?--------?-?--E---------o---?T----o---------------o-B|---
-----B---?--------?-T---------?-------|-E?---?----o---X-----?-?-?----------T-o-E----------X----------o---------------|----B--------------------------?-?------M-------M---B-B--------B-------BE--o--?---
B--X---------E--E-----------T--------T---------o---o----X---------T---E|------X--------------|-oo-----oEB--o----------B-------B-T------|-----|---------B-M---------------B----B--B---MT-XT---o-B--------
o---o---|B--o-------?---o--|?-------|---B-?---oT------B----------------------------------E-----X----oM--------o--------o?M--------o--------B-?oo-T------------X----B----o?-----E------------M--o------B-
--B-----------oM-----------B-----------B?-------------------------M--o--------------------------------------------T------Bo----o---B------------------E---------------------------o----ME--X-o-----E---v
------o---T-----B-B---M-----------------o--o-----------X-------------?---------E--o---------E------------X-------T-E---?-B--B---M---B----B---E---------------T-B------------------------E----o-E-EB-----
o-B-------------o----------M----------o--------o-----------B-------------o---E-------------T--------o-----?|--M--B--B----------M----M-------BB-B-------|----------------------|-?o----|--------B--------
-------------------------o-B---------o?--------------------?-----------|------------------o--B-B--------------E------B---------------------T----M-oB--|----------------------------o--B-o---------------
--|------o----------T--------B---X-----o----M-oE?---------XB--oB----------------X-----B-----|------B----BB----?---------X------|-----X-B-o--?----------------B--M--------M--B----------|----------BE----
-----|------------------M--------B--------------?--------o|---E---B--?----B-o-o----------------|M---?-------?--o----------B----B-------T-------T------B--------E-------B-----------o----T----------M----
--------E--------B--B--------------------|---B-------E----oM-----E------o-o----------E---Mo---M------B--o-?-----o----------?-----|----------B----E----------oB-------------------?----------B|----?-M---
m--------MB------T--M-----T------B------------EB-|-X-----B--------------BBoM----o-----------------M?-------------?-M------B--X------|-o--B------E----T--------?------X----------EM-------|---o---------?
---------------o-----------XB---B-------Eo-----------E----o--o?o----X--------E----------B----------------------E-----------?-----M--------o--------o----E---E----------------------T|oo---o-X---B-----E-
