----------T------------B-----------|--------o-----X-?--------?-------B------E-|-?-X----------?------------------------|-----------------------o--T-B----------o--E--o----B----o---T-B------------B-B-?--
-------?-E----o--B?-E---E-----|---?---|----T--E--------M----o---------o---o------o---o-----------E-----B--B-X-------o-B--o----M--?---?----------|-o----------------B---------------B---B--------------o-
--------------o-------B----BM-o-----E--B-M------oo--oo-BEB--------------------------B-oB?o-B-----------------o----?X--------?|-B---E---B--------T----E-------?-----o------------?--o-----------X-------E
-----------------------B-----E---B------------------X-o----------T-------------------------E----------E----o-----------E------------M---o----oo-|--X|---E-B-------------T--------|X------------------?--
----------------------X-----M-o-------oM-T-o-----------T-----E---------------------M---T----------------B-o---E---o---?-B---------o-----------------------T---------T-------------?---------o-------o---
M-------X??---E---------|-?----B--B-o-?--?------X-o-B----X---o--Eo---E----T------B-------------------?-X--------------o---?---E---B------B------o---?---------|------XE-?------?--------------o-B-------
--------------X--T-E----TB-------------E------o----B-----X-----EE------EE---|-----------o----------------B---?---------B----------------X-------------MB-M------o---------------o---o----------?-----E--
---o|--------M-B---------------E-B-------||---------B---------B-B-----------M---o---------------------?--------oo--?--o------------E---------M---BB------B------B----------------------o--------------Mv
--------B-B-|----M----B-------X-----o----------------B-?oo----B---------o----------------------o--M----------o---B---------B----------o----------|--------------M-|EE-----------B-----|o--?------B--E---
-----T-------EEM----------X-------------o---------T--|X---------B-?-B-B------------o----E--------B-------oB--o-E---E----------o----B----------|---E---B---o--E----o------o----E-B----M-o----B---o-----o-
-------T------------------X-----?--T--E-o------------o-X--B-----------------------------M-----------o-----oM---------?----|-?----Bo----?-M----?------E-X------o-|----------o----T?------------B---------
--|--|-------------?---------|--------------T-B---------------B-----E-B-B------E----M-------------oM-----------?--o--------X--M----------?-----------B---------B---M---|-----oX------------E-?------T---
B--------o------------B------------B--------------------?-----X---o--------M------?-----------------T----?---o-------?------B----------?B---------o--o----o-------MM-----------||--T---?-----o-B----o?--
-----------T---|--M--------------------B---------Bo-------E----M--Mo---------------X----B-------E-|B--------------B----------------------------B--------E--o-----------E--X--E---o-----B------XX---E----
m-E---M------o-o----------E--------------------------B--------------B----|------------------o-----------------BB--------B--?---------------?-----T---B------|----------------X----o-?-------?---|---?-B-
XXXXXXXXXXXXXXXXXXXXXXXXXXXXXXXXXXXXXXXXXXXXXXXXXXXXXXXXXXXXXXXXXXXXXXXXXXXXXXXXXXXXXXXXXXXXXXXXXXXXXXXXXXXXXXXXXXXXXXXXXXXXXXXXXXXXXXXXXXXXXXXXXXXXXXXXXXXXXXXXXXXXXXXXXXXXXXXXXXXXXXXXXXXXXXXXXXXXXXXX
