------------------X---E---------------B------------------MB?B--------B?--XB-----------------MM--XXB---------------X------------------------------o-----------BXX?XXBB------------B----------------------
----------XX?-BB-----B---B----------------------------------------------XX---------------BBXXB-M?-o----XX--------------?BXXBB-------BB??XB-----BB------BX---------oXXXX---??----------??BBBB------------
EB----XBXMX-B-------oXB------------------------------------------E-X-----------------------------------------?B---BXX--------B?XB----B?-X-B--------------X----------------B---------------------------X-
BX----MX----------MX---X-------------------X--?-------XXB---XX?X--M--------?BMB------B?----------------------------------------X--------------------------------BBBX--BE?BBB----B-----------------------
---------------??--M--------MXM---------oX--------------------------------?--------------------MM---------BB------?--MB--X----------?BX?B----B----------X---?---------B--------------------------?B-----
--------B---BBXBB---BBBXX------------BX?XXXBB-BBBBX-----------B?B---BBB------BX-------------XEX-BBB------------------------------MM-------XBB--------------BB---------BBBX?XXB---XX-?---------XBB-----X-
----------??-------X---X----------M------------------------BMXB--------B-------------X----------------BBBXXM---B----BB----BBB-------------MXB------B?---------BB------X-------B--XBBBBBBX----X----------
B-------------XX-----------X------------B-E---M?--?---------------oX--oXBB----------------BX---BMMBoBXXX--------BB---oX??-----BBMB---B------------------------------------------Bo---------oBB-------BBv
-------M?B--------?XBX--BB----XXMX--oM?------X--X-B------M-BB------------------BBB-------X----------------------------------B--oM------------------------------------------E?M------oXXXB--------------f
--------------------------------------------------------XM--------XX---X?X-MXB----------------?XBB---X--------------------------------------------------------------------?---MBB------------------BBMBf
-----X-BBB-?BBMXB--?B----------------------------------B--------------------XXXXB----------------MBB-------BB---------------------BB-X??----X?---BB-------------BB------B------------B-----------------f
-------------------oX?--o------------------B?--------?MM-o----oB-------------------?XBBB----------X-------XB-?MBB-BBB----XXB--?-B--oMBX---BM------------MXB------EBXXXBBB?o?---------BXXM?X------------f
-------B----------------BXX-----XMB--X--XXM----------------oM-BXXB---X---??B-------oBB---------E----BBB----BBBB-----XXX?-BBBoBB-B?-------------------------------BBB-----M---BBoBBBXXXBBBMB------------f
--------X-----------MXXX-B?------XB--XXBM-----------------XX--X---???X-BBX--------------------------------------------------XXXX-----------------------------------------------------------------------f
m--------oX--XB------BBB--?---------------MB------------MBBBX--------------X--M-----------?XBBX----------------B-----B--?-XBB--------XXBB-BXX----BM----EB---------XMB---X?------MBXBB-XBTX-------XX----X
B?--X----------------------?B--------------B------??B----BBBXX---------------X--BXXX-----------------------B-------------MBX------------------------BB-------------------------X----?Xo?|XX-------B----X
XXXXX-X-X--XXXXX--XXXXXX-XX-X|XX-XXX-XXXXX-XXXXXXX-XX|XXXXXXXXXXXXXX|--XXXXXXXXX-XX-XXXXX--XXXX--XXXXXXX|-X-XX--XXX-XXXXXXXXXXXXXXXX---XXX-|-XXXXX-XXXX-XXXXXX-XXXXXXX-X|XXXXXXXXXXXX-XXX--X--XXXX-XX||-
