---------|-------o-----------B-------M----------------------o----------B---------BB-|--------------B------------M----------|B-------E-----B--------?---------B--B-----o----------|-T-----------B-E------
--------T---------B?---------X-------------o----X-B--ooE-------B-----------|---------------------B---------|---EB--------------------M-----E-------------EE----o-----------o--------------E--M----------
---?B----M--------------------X?----B--------E--------------------------?-----------M-------o--o------o--------E----M--------------BE---B--X-------------X-------?--o-B?--------o---|---------T---------
--o-----T--B--?---------E-------T-----o-------E-E---------B-|---T--------B------------o----------B--B--------X--Bo----------M------B---------------B---?-------------------------o------------------B---
------------B-----------o-------E-----------T-----|---o-----------B---B-----------X-M---------B---To------o---------------B-----------X-------|-X---T------------------B---------------M--------------o-
---------------B-----X--o---------------?--------B-------------?-----?---?----------E-------X-------?-------B--M-------------------T-E------E----------o--M----------X---------|B------o-B--E---------o-
------o-o--o---o---T--------o-B---|------?---TM----B-B---E----|---B-B------E?------T------M|---------?M-------------?---E---Bo----?---E----E-B-o---------M|------------------------------------B-E------
-?X----------o-----E-o-M-E--|----B---------------TE---X----------------E----T---o----Eo-------------------X----------B---------B-?---B----?M--B---------B-M-------------X----o-----o---------------M---v
?------?E-----oE---|-----M--B------------------------B-------B--?-?--E------------------o-M--------BE-M--|----M-BB-----------X------B-----o-----B---------M--?----------o---B----E---X--o----oB--?--?--B
B-----------------------o---------MX----------------------B----------E----E-----B----------o-T-o-----------?-?----??----|-------B-------MB--------o--E---------E-o----------------T-----------o-?-------
X--------o--------B-----B--o---------?-------?B--E?----------M------------Bo-----?--------o----------o-E--------o----------------B-------------------oo--TM--B-------------B------------M--?-o----------
----M---B---------------E---------TT---------------|-|--B---o-------------|------MT------------o----B-o-----T----------B-B-o---E-----M---o---------E--------------B--X--E?--------------------o---T--B--
---E----------------X--o--------------BM------?---o---B---o---B-------------E--B-----X-T--?--o--o-----------T-E-----------B----M--B-XM----------B--?--------------|B-oM--------------------------X----T-
----------X--------B-------|----B--------?-TB------------o--E----X-------o-----o--o--------?-X--o----X-B----------------?B--E---------E---?--X------------EB-----------------X----E-?o--?E-----------M--
m----|o----E--------E-----?--o------B----?-B-------o-----E----------oB-------Bo---B-----?---T?------------E---B-B?-----------------M--X?---X-------------o----E----|--------------|-----------?---------
------------B-------T-----B---o----B-X---------M?---B---------------?M-------o----------------?o---X----B-o-o----|------o------E--E-?----?------EE--E--T---------------------------------------B---M----
