-X--oo----?--X-X---B----o-T---------ooX-----M------E-B-?--B--oB--E-E?----X-?B-----o-------------X---X----B----B--------o--?---------X?----o---o-B------M-------o----o------B?|----------XX--X----T--B--o
---XX-o--B-BX--X--BT------X-----?-------E---o----------XX-----X-X-X---------X---------X---------BX--XX----X---M---|-XB-XX------XX-X---Bo-------XBo---?-oX?--X--X---------------o-----XXM------------B---
--?X----E|-oM------MX------B-----T--X----o-XT-?----XX--M-?---oX----------B---------XM-----------X---X---------M--------o--T-?X------o-------------BX--o--------X---XX------M--M--X-B----o-E----------X--
--------------oXT--X--------Eo-M--BX-----B---oX--X----X--X--XB------o-------MB----------o-----X-------o-X--X--o--------X---M---------B--X----M-XX----B--X--X------X-?-X-X--E-oT--oX---Bo-o-------?-o----
---X-----X|---------||M-X----------X------X------B--B---X--X|-----B----o-M--o--X--o----|X-?-XX---o--B-X------X--B------------M-----?-------------X-B----BX-XB----------Xo------X-E-----------X----B-M|--
--X-M-|----------X--oM-o-|----X---E------XXE-X-E-----------X-?---?--o-X------B----X-X-|--X?-X-----E-XM-----XX-X---oXX----o-o--E-------X-----------------E------X-X--M-oXo--T---------To---------To------
----o---o-X-------X--B--B---Eo-T------------o-Xo-?-o----X----------------------B---B----?-o-----BXE---------o----X|--o--B----X-------B--------BX-X----B-?----|-----------X--X-X--E---?-------o---EX-----
o-------------o----?-M-----X-o----X-----X----o------o--oM--X------X-B--------TX--------X-X-X?---X-----XB-X?--------B--B-----o---XX-----X---X--BX----------o-------------------BBo---Xo-B-X--o----------v
---B-------B---X-------oB----o--?-Xo-----oo--------|-----o-----E--B---E--B-----X-X-X------o--------------X--?--T-o------XX------M---------------------------------?--o---oX----B-----o-----X---------XXo
--------X--o-----X------X|X--E------X-----X------------------o-------X---------BT--X--X----X---o-X-XXT-------X---?-?BE--X?---B-B-----------------Bo?---E------X-------BX-B-B----X---------MX-----------X
-X--X-T-------------?X-To-----|--?X-------o-----------E-------T---------E--EXX--------X---X-------?-?X?--X--------M---B-EB------------X----EMo-----o---B-X---o------B----BBTX---X--X--X---?-----------XX
--X-----X-----------B--B-?----X------|----o--X--B----------XX----------?-Xo|----X----X-E-----|B----------oX|---------oX-----o--X-----X|-----o-----o---X---XBM-----X----B--------XE-o-B---E----X--X------
-----ooo---X----o---oX--XT-Bo--?--X-----o-XBX---XX--Bo----o---X------?X-X---E----------------X--------X----o-?--M---X--------E------------XB------X--XE---T----B---B-o--X?B-X----BX-?B-----oX-X--XXoBX--
-X-|---o--M--|---X-BoB----?-------------E--------?---------?----X-------B----|--oo-Xo--X--|----X-X-X----|-X-?-Too---------------X----X-X--X-T-X----X---o---------X--X-----oo------X-----X----?-Bo--X---o
mX|----B-?-M-----------o-X-----X-----o-X---M------|-X----?-o-------XBX------------------X--------EB--EX--X-----oX--X--XB--X-------X------T--X-?-o---E---M-T--X-------X-----X------X----EB---M-?---------
XXXXXXXXXXXXXXXXXXXXXXXXXXXXXXXXXXXXXXXXXXXXXXXXXXXXXXXXXXXXXXXXXXXXXXXXXXXXXXXXXXXXXXXXXXXXXXXXXXXXXXXXXXXXXXXXXXXXXXXXXXXXXXXXXXXXXXXXXXXXXXXXXXXXXXXXXXXXXXXXXXXXXXXXXXXXXXXXXXXXXXXXXXXXXXXXXXXXXXXX
