----oM---------------------?B--------------------------?-------------XB--------------------------?--------?B--------------XXX----------------------BX-------X-?M------------MXBEXBX----X----------XX----
----EX---------------------------?B--------------------------------------------------------------BB-----------X--------------------oXX------------------M-XBX--------X-XXX---?------------BXBXX---------
------------------------BB---?BB-M------??-----BB-------------------------------------MB?-XM----------X------------------BB--XBX------XX----------BBX---?-BXB?X---M???----B---------oB?----XX---BBX?B---
-?B---------------?XX----------XBXX-----MX?-----?------------------BB---X-----------BB------MX--oB------------BB??------X-------------------XBB-----------??B--------X?--------o------------------MBX---
-BMX-XBBXB?----------------------------XMM?---------B----------------------BX----?M------------------------------------------------X--?-------------BX?X------B-----------------------------BM----------
---BB----------------------XXX-------------------BXXB?BMo--------------------?XB?B-B?B---------XXX------??M--------XBBBXB---XBB---------------X-----BBM--oo---EM--------------M------------BX----MXB?---
----B-------------BBX--X----------XM---------------o---?----??BX-----------------------------------------BB--------?-------?MM----XX--B---------------------BM--------o?B-----------MX----------E-------
-----------------------------?B--X--------------------------------------B---------X-------------------------------------------------X-------?X---------------------X------------------------?----BX?---v
B-?B---------BXBXX----------------oBXX----BBM----------BB-----------------B?--------------oX--??X?-----B------------BB?-----B------XB------B---------------------?----------------B------MM------------f
?XXXB?----oBX-M?----oXB?B-----------oXBBBBBXMB?B---------------?XXXB---BM-?BXMB--------------oM-------------------------------------?BBB-----------------------B--?BBBB--BB-?---B------XMX----?-BXB??--f
---------X------------------------B---------o-------------------------------------------------BB??-XXoBBX--?-----------EBX-----o-----X?-------X--------------------------B?-------B??X----BXX----------f
-------o----------------oBM--X--X-o?-----------XXB----o-??BB-----BX-------------------B------------BX-------------BB-------------X---------oBX----B--BB----o?------------------BB------------BB--------f
--------------------B--------B?--------------BB-----B-----------?------XXBB------------?--------BB---------XXX-----B?XBM---------X-------------------XXXB---------oM-------------------MB--------------f
------------------XXB-----BX------------------------------MXXB-----------B--XB?BX--BX--------XX----XBXBoMX------BE-----XX-------------BBB-------BB-----oBoXX-------------X----XXMMX----X---------------f
m-----------------------MBBBX?------------?XB?X------------M-----?T-------------------------------M-------B-----B------TE-----B----------------------------BM----------------------------B--------X?---X
X----------?B-------o-----------o?-------oBX-------------M--oBBXX-BBBXB-oXBBM----o--------X--BBo-----------?---------------------XBB-----oX--XBBB------------------------------------------BXBBBXXX--XXX
X--XXXX--XXXXXXX--XX-XXXXXXX-XXXX-|XXXXXXX|XX--XXX-XXXX|-X-XX-XX-XXXXXX-XX|-X-X|X-XXXXXXXX-XX-XXXX-XXXXXXXXXX-XXXXXXXXXXXXXX|||XXXXXX-XXX-XXX-XXXXXXXXXXXX-XXXXXXXXXXXXXX-XXX-|XXXX-XXXXX|X--XXXXX--X-X-
