---B-----------T--?--------------------o-----------------B-------B--E?-------o---------o---X---------o--|--o----------------T----------------oXX-----------------------o-X--M----?---------------B--??--
--------------------------B---------BX--B----------M-----X-----X-----------M------------------M--------M---B----------B---------------T------------o-------o-----B--B---------------XXB-----------------
---------X-------------o--oB--o----X----o-------------B-o------o-------M--------o-----------?------T--|TX----------|----------------------------------o-X---------X-o--o--------------------------o--BX-
------?MM-T-------o-----M-------?--?--X----T-XoX------|------------------E-o-X---?--Bo---E-------B----------E-----------?---------o------o-o-B---------------------------------?-------------------|----
--XX-----oo----X--------T--------------------B------------T------------------o--T|o-----------B-----X---T-BE---------------------------MT----------T-------------------o-o----------------------------To
-------------------BM----E------------?--o----?XBX--------B------------B--------M--------T-------------BB---XBXB--------T---|---T-B--BB-B-------o----B-o---X------M----T--------------oM--XB------------
M---------------TXE---M----------B---M-----------------------?-----------------------BBo---T----------------o----------T--BX--------------------X------T---o----------------?------XB-----------T-----M-
-----------------T---------X-----M-----o------BB------------?-|-----?T-------B--M---------------X----------------------------X--o-B--------o-----------X---o-M-----?XB----------o-----?BBB-----T|-----ov
-M-------------B---o--X--T--T-M------o-----------|---MX-------------T|BXB-----------oT--|---------o----------o------T------------------------|--M-XX------------o--X--------o-------B--|---------------f
--------------?B---B-------------M--?---------------?X----B--X----B----o--BX?XMT-?-------------------Bo------------------------?||------T----X?---------?----------M-----B-------------BX--B----------Ef
------------E-----------------------M-------------E----------X--------------------------------?--o------E---X--------------X----o---------TX-?----o--------------------T---------T--------o---ooX-----Ef
-----X-?------o---?----------------MX|-|---T--------------?--B-------------X--XM?---B---|--X----T-------------X-----E-----o---M-----------EE-------X------------o---|-------|o---o--------X------o-----f
----------------|-------X---------oB---M--------|-----------o------B----Xo-------------------------------------|--E----------------B-o-|--------?-----------o-?-T--------o--?-oX-------|----------EoT--f
----------------TB----------------?--B-M------------------------------------------------T----------B-BBB----X-EX---X--------B-X--------------------X---------Bo------B---------XX----B--T----o--o------f
m---------------|---|----o----o-----T--------------E------M--------------X--------------|--XM----------T-M-------X--------------------|o------|----------------------X--------T----------X-------------X
-----------------------B--|-----o----X--------------MM-----------o--------X--?-X-------------------------------------------M-o---X----E---T-------?------------------------------o---------M--oX-----oTX
X--XX---XX-XX-XXXXXX-XXXXXXX-XX|-XX|XXX-XXXXX-XXX|X-X-XXXXXXXX-XXXXXXX|X--XXXXXXX-XXXXX-XX-XXXXX-XXXXXX-X-XX-XXXX|-X-XXXX-X|X-XXX-XXXXXXXXX-X-X--XXXXXXXX|-|XXXX-XX-XXXXXXXX-XXXXXXXXX-XXXXXXXXXXXX-XXXX
