-?------------?X----?---o-o--X-----XXB-XEM------o--o-Eo-----XX--E--X------X---------o----XX--------B-X---o-----E------X--M-o----------------XBX-----------X-XoB---E-X--------X-----oE---E-X--X----------
-?----T----XX----X--X-o--E-B-X----B-X---XEX-XX----------X----------------------XX-------o-o-X--?X-o--------B--X-----o------X-E---E--------Bo--E-o-o-XB----X-X--------M-----X-X-----o?----X----------X---
------|------X------o-X-o----X-?o-o---------------X------X-o-XX--------------?--BX---X------------------Bo--X-B-----o----o?-X-------XX-BB-X--BX----X---oEE------X--o-?------EX---X------------------X---
o--o--|----X?---X--XX---?----B------o-------X-----XX---X--------B-----X-------X----------?Bo-XE---B-?-B---?-----X----X----EE--o---??---?---X--B---X----------X-o----EX--?-----------------X-----o-o----M
---B--|-------X----X------------B------EX---?X--------------X-X----------o-M--EX--X-E--X----?---X-----B--X-?----X--B-X----o----E----o----B----X--X------B----o----XM--------o--------X-------Mo-B-----B-
o-o---|--E------E-?--------XB-X------------X-B---o--------X--XX----E-X-----X----X--X-------X----XB-------------X----X--------X-----X---------------B---------X-o--X-------XoXXXo------------X----o------
-?X--o|XX--X-------X------E--------M-o--X?-------------oX-oB---------Bo--X-X---?-B-X---------?----------XMB-o--M--?---X-------X---E-------X----------X--X------XE---XB--oo--------XX---M-?BX----o----X--
-E--X-|-E--XB--o-------o-X--oXoX--X----------BX-X------------X------XX---X--------?-XX-----X--E------B--XX-X---XM?----oX---X-------E--X-o-XX--?---------------XX-----X?X--B---E-------?------E-BBX-----v
----E-|--------X-X-E------X--------X--------B-----oX---X--XE--------XM-X--------Bo-X-X--X-BB----o--E----?----------M-M-----B--B-----B---XX-----E-------o---X--o-X-----Xo-----X-o---X---------E---o-X---X
-X--Xo|---MB-X----o-X---------X----------------X-oXX---o--------o----XM-oX---X---------X?---o--XB---X-XX------B--o-------------?------------X-----BBX---o------oXB---M-----X?-X----XE-X--X------------B-
o-?---|----o-------E---X-X-X--X---BB-----X-----------o--------B--XB--o-------o-X------------------X-----X-oB-----B--------XX------oB-E-X---------X-o----B-o---------XB-------X--oX---B?---------B---X---
--XX--|--------B---E----------B-------------------------B------------o----------E-B----B-B-----o------------BB--X--?------------o----------B----------X---X---E--?------------X----o-o--------XX---XX-X-
------|--TE---XX--o----o-X------Eo-X-o------o--M-----?-X---M----X----X-------B?---X---X?E--X----E-?-------X-o---o-X---X--X-----B--o--X---------Eo-XXoX-B-X--B-------X-E------B----------?----------X--X-
------|--|B----X---X-B-B-------oo-----?-------T----o?-------------o--X-----o---------B--o-T----Xo-T----------?--XBX-?-M----B--------X---oX-E---X-X----B-X-X-XB---X--X------?-----?-------X---------XX---
m-X---|X-|-------------B----M----B--o---------|-------B--E-o---X-X-------o---XX----X------|X-B----|------?-B----X-----E--------X--o---X----Xo-X--------o-------E-X---o-----E--?----X-----X------------X-
XXXXXXXXXXXXXXXXXXXXXXXXXXXXXXXXXXXXXXXXXXXXXXXXXXXXXXXXXXXXXXXXXXXXXXXXXXXXXXXXXXXXXXXXXXXXXXXXXXXXXXXXXXXXXXXXXXXXXXXXXXXXXXXXXXXXXXXXXXXXXXXXXXXXXXXXXXXXXXXXXXXXXXXXXXXXXXXXXXXXXXXXXXXXXXXXXXXXXXXX
