-XX--o--B-XB---X-ET|-o-----B----X------o-T---X----XX-----B-?------oX------------o----X-----------Xo------?E--------B----?-|----?X-XX------------?-X-----B---X----X-o--E-----------B--B----------?--X----
-----o---Xo-------------?-----To--XX--X-----Xo-------B--------XX---X---X-------B-B--E----E----X-X-MX----X---o|----o-------X------E-----------------------B--------?--o-----B----?X-----M--|----------X--
------------------------X--Xo-B---oEXo-XTEB------X-X--B--o-E---o-----?--------X-------E-----------o--------X?---------------o---?---EB----X--XMM------B---T--|-XXo----X-----M-B---B-Xo-X-o--oX--X-oT-E-B
?E------M--BXE-----?X-------B----XB------?--X----o-----o--X-----B--oXB-----B--------X-X-----------|-----X-o--TX-o------|X-X-EEB-X--------X----X-----T-----X--X--------------------?|-----E---------o----
--X-?-o-X----?-oXEo-o----X--X--|--X--X-B?--B----------T-B---B--X-----------Xo-Xo-o-MB---E-?o------B--------------X--B------X-M--------X---o?---E----XX---------XX----------------X--o--o-T---?X-----X---
X-X---E-----EX----X---------o-----------?---oo---X-----------B-?--------o-|--------B--XXX--o--X|--BX---------------o-EX--------o-----B-Xo--|---------?-------M---X-X---E------B-X----E--o-----------XXE-
--X?--------M--MX|-oXo-------B-X------------X-XEE------X-------o-MT-------T-X----E---?XX|EX-XT---X------X-B------EX-------X----oo---------?-------X--X----X-MX---o---------X----X--M---BX-X-oX-------X--
-XX---|--o-?-X-X--B--------BXX|--------X---o--X-------------X-------X-----------?---E---oX--------X----X-B-------X-M---?X--o--------Xo-BX---------------B-------BE-----T-------X-EX-----B-X----B---X?--v
------oX----?-M---B-?-XX--B------X-------X--o|M-o--XX----B-BX-ooo----|-------Mo------?-X--XB-------X-----X----E--X-X-----X---------Mo-o----o--X----XX------------T--X-X---o---?--o--?X----------X-E--|--
------?---XX-----|-EB--------X--?-X-X-------XXo-X----B----X-o----------E--|X--E---oE-X?-------BE--X---X----------|----XXBE---|----------B------o-X-E------E|o---X-XX---------E--XXo---B--M--------------
-?EXBB--------X-----------X-----X------XoXM--o?-----X-?-----E-----o---B-X----X|E--XE-----X-------X-E-X-?---X-----X------X--B------------B?oB?o?---XEX----------X----X-X----------X---X--B-o?------X-----
X---X---X--o---X----------Xo--o-----E--o--X--E-X----------EE------------X--T--o-oX----E--|----M--T-----------T------?B-----o-B--M------B---BM--X--XX-X---------o---X--X-B---|X-------B-------------X----
-M-----X-|----B-T--------B------?--X-oo--EX----Xo-X---?------B---B-------Xo-----X----B-oX-o-----X--B------oo-oXX----BX-X----X--X-X--XX-B-----|o-----o----|-o----?--X------------X-X------X-o----------o-
-----M--X------E------?-BX----------BM-----EX---E-B---X------XXB-?-Mo-----XXEo----o-----B-?-X------------Eo-X----?------B--|XXo----M-oE----E--------------E-o---------B----------M-----X-X-X---X--------
m-o-o|---?-X-X--B---TB----o--o--XB-----XM-----o-------B?X--?--X----------o-XX--X--X--------?---M-----?---X--X-Xo---------X---E?XXoX--X-o----XX---M----X----------X-----o----E----o----XX-X-T--B-------X-
XXXXXXXXXXXXXXXXXXXXXXXXXXXXXXXXXXXXXXXXXXXXXXXXXXXXXXXXXXXXXXXXXXXXXXXXXXXXXXXXXXXXXXXXXXXXXXXXXXXXXXXXXXXXXXXXXXXXXXXXXXXXXXXXXXXXXXXXXXXXXXXXXXXXXXXXXXXXXXXXXXXXXXXXXXXXXXXXXXXXXXXXXXXXXXXXXXXXXXXX
