---o-B---X----M-----BoE--B--X--BX--o--X--?-----E--X?--X-----XXo--------B------X--------X--------o----------o-----B--Xo---XEM|-X---X-X-----------------X---------?-----ooX---o-----X---X--X--------E-X-XM
-B--B-oT-BX-----------B--X?B--X--B------B--X----------X-------BX----Xo---------X-------------T--o---XX--X---------E---o--oX-X--X-----X-X-X----M---X---------EB---X-----XX---XX-M--X---------?------X--XX
---E----------B-----XM-----X----M-------Eo--X----------X--o------Xo-M--XX-----o-BX-----B-o---------B--X-----X-X---------------XX------B---X-X-M-E-XBX----X--T---X-----BB-X----------B--T----X--B-X--X-X-
-------o-----------B-XBX--X?---B-------o--------X---X------?Eo-X----X-T--------XX---X---B-B-X--------?----B--?-B-----B---M-BX-X--X-X--X----?-B-----------------??---X----------B----X---------Xo-o--XX--
-X--B-----------X-----------X---?-X-----------E------M-o-X--------X-X------XB---B-------------X------T-------E-o----B-E--X---o---------X---X----------X--------E-Mo-----o----B-E-------X----------------
--------EE?---------M---?---E?-?---Xo--------X------o---------X--o-------B-----XXB-o-----B------o-----XX------E----?---------B----Xo-X-X-B-----------Xo--------Eo-----X-----------X-X-o--Xo-X----?------
-----X---B------TB------------?----------XBX-X-----X-o--X------???---------X------X---o-T----Xo?-T------Eo--T-----------X-----------o-B--X-E----------X--o----X-E-o------X-----B-B---E-X----?BE--?M-----
-----?-----o----T----?X--------B--To-X---X-E--X---oE----X------------X-------T------E-X-------X------X--------X--X----?------?---oX-----T------Eo--oo----X--X?--M?---X-o--------E----o-X---X--XB------Mv
---oX-------X-XX-X--B-E----o-?----------B--------------T--ooo---XX-o-E-----XoB---X?-X-o--Mo-------X--------X-X---B-o-BB----T--B--X-B------E-?-X--------Xo-----M---X----------XB--Xo-------XX-?X--------o
---X-X-------X---------oEX--X--------oX-o-X----------E-----------------o--XX---?X?------E--X--------E--?--?-------------B-----?--X----XX--------X-X--?----TX---B---------------X-X-X----------?------?-?
BX-o-BB-oX-----X----X-----------------X---X--oX-o---X-------o-----o---XX-E-----T?XooX----X------X-E-?o--------X-----X-X----o-------------X---o------B---?--Xo--B-B-----B--oBB-----B---------X---------E-
X-X-------B-----TXX-----BB?--X--------X-oB-B--------o---?----Xo-------BX---X----X----XX----E----X-------------T----?-M----X------X-X-?---XT------oo-X-------E---X-B--E-----o--o-E---ME--EB------?-------
-XXX-------X--X--------B--------X---X---B----X-X--X-X------B-M----o-?-X-----?--T---BB---------E---X-----X-----X--TX-------X--------o-----B-oX---o------X---E----?X-X-----------XT-X-MXE------X---------o
--X-M-o----?-------X-X----X-E----XT---------o-----BXXE?o----XT----M-X--M--------------X-X----B---M---------------?---X-----oM?T-----X-X-M----E-EX---?---X---ooX-oM--T--o-X---o-o-XXX-------T-----X----XX
m--X----o----------XXX-T-----XX-E-------X-------BX----------X-------X------------T-------------M--|--B-----X------X----X-----X---X---B------E-?-----M|X--X---o---X-XXE-------------?X----------X-X---o--
XXXXXXXXXXXXXXXXXXXXXXXXXXXXXXXXXXXXXXXXXXXXXXXXXXXXXXXXXXXXXXXXXXXXXXXXXXXXXXXXXXXXXXXXXXXXXXXXXXXXXXXXXXXXXXXXXXXXXXXXXXXXXXXXXXXXXXXXXXXXXXXXXXXXXXXXXXXXXXXXXXXXXXXXXXXXXXXXXXXXXXXXXXXXXXXXXXXXXXXX
