--XX----------------X--------X--X--------X----X-----XB---X--------X--o--------------X-----------------X-------B--E----XX-o--?-X-------X---o------------------BX?--?BoBXo------------o---X-E--M--o-?--B--
--E---T--Xo----------------------o------?X--X---oo------B--X--X-M--o----------X----X-----X-------B-X----B-----X-B-XB-----E-?-X-----------------X?-B-M---o----o-B---o-------------oX----------------?-Bo-
o-----|---------E---X--B----E---XX------oB------XM-------o-X------X-----B--------?--oX-X-----o-EX------------------X-X------------X------------------E--------------?----o----------M-M--X----??--o-----
------|-----XB---o---?--X---B--?-------B--X----------X----M----B---XB---------o-------------------X--------X-------X-o-?-X---------------------------X---oX------o------X------------X-----------B--X--M
---X--|--X---o-------XX-----------X--?-X----oEB--------o----X------X-X--X-------o-M--B---E---XMo-?X-X-X---oX-----------B-X----------o--X---oX----o----?--B-E-X----?-----------X-----X--?-B--?--?-XX--o--
------|----------X-----X--?-------oX----X----o-o-------X---Xo-----------B--E----M-B---X-----E-EE-------------X---------X-X--X--------B-B-------------o-----o-o-XM-X-----o------------------B-M---E-E-E--
----o-|--B---XX--X-Mo-B---------X-------------o------X-X-X---X--------------------X---X---------o-------XX-XX-X-oX-----------?---X----------------o--B--------X-X---o-o-XB------------B---B-----oB-o----
-M-o--|----------Bo------E?-B-M-M-oo---XX--------X----o--X---X--XE------------X---?-------------X------------------XXE-Eo---?-XX---EX-?-----E------X-------o--X-o--X-BM--X--E--------BX---X------------v
----X-|--------X----------B-oX------B-X-----oX-o----XoM--E-----oE?-------B---M--?-o-o--XX-----X--X----X---X-----------X--o---o------B-BX---X----o--M-o-o----XB---X-X--B---o--E--X-----XB---X--------X-B-
------|--EE---?--X--E-----M---oo-X---o--B-----X------o-------M-------------?Bo--E--XX--------------X--E-X-X----X-?--B--X----X?-?------o------B----oo---X--o--X-B------X---X----X------X-B------MX--E----
-M----|---X--------------XX-?--------------oX-------X------o-?---B--?-MoXB----B-o----------Bo-----X--X-EXo-X--o----B-Xo--X-----EX-ME--XXE-XX-----o--------B--E--X------X-------------X-X----?---o-----X-
-X----|--?----oE------?-XXX-o-X--?----X---o-----o--oX----?----X----?---BXE--?X------E---o----X-X--------M----M-------------------X-------EX------?-X?----X--X-----X----X----oXE---X-----X-X--M--------B-
---X--|--T----o------------?--X--------------------oX---Xoo---X---E--Xo------E--------o----?----------------X----?----?X-E------------------XE---------X---?X--X----?Xo---o---?--o-----?----X-----?---XX
--X?--|X-|---TE-----o---?----?---Xo?-----?o-B-X--------o--X---B------XX--M-oX-------X-T------------T-----o----------------X-----B-XB---X---------Bo----X-----X---XTo?E-X--X--?----MX-------X----X----X--
m-E--?|--|---TXX-------oE-------XE--------------?--XE----X---XM---X---E----------EX--oT---o--------T--X-X--------X------XX---oXX-------X--------X-B------o-----Xo-|-XE-----o----------X----B----Boo----?
XXXXXXXXXXXXXXXXXXXXXXXXXXXXXXXXXXXXXXXXXXXXXXXXXXXXXXXXXXXXXXXXXXXXXXXXXXXXXXXXXXXXXXXXXXXXXXXXXXXXXXXXXXXXXXXXXXXXXXXXXXXXXXXXXXXXXXXXXXXXXXXXXXXXXXXXXXXXXXXXXXXXXXXXXXXXXXXXXXXXXXXXXXXXXXXXXXXXXXXX
