-----E-------------------E------------T---------X|------XB-MX---o-X-------B---|--------------------------------B------E------o--X-B----?-----?--o-------o-------------M-------?E-----E-E----------------
----B------------M?---o----------EB---------o------?---X------------|-------------------------E----------B-----o---M|---------T--------?--------oo---?------E-----------------------?X-B--B--?----------
-MB----|---o----------------T----o--------o-----B--B-------------E-----o------B---?T--------------o-BB-------------X------M?-----------B----------o--?-----T-E---|---E---o------------------------------
----T-----------------------Mo-----B------------------BX---E---------T-o--E-Eo-?-|--------o------o--E--------------o------|T--|----------o------B----------X--------?----------?-?-|-----B----E---Eo-?--
M-------------------?----EoT--B-?E---B-----|-------------M-?o-------------B---------------------------|---------------?-EB--|----------------?-------E-----E------------E|--?-----------MT----T-o-------
----X----?--X------E-------BE------M-o----Mo-----------E--B------------------------oE--X-B-----E-M----|-----o-M----------------o---------B------E-|-X---------o--B----E---M---------X----------------o-M
E-B-----X------B----?---?--o------o------B-----BE-----B-------------E----o---?--------X|-------------X------|--?------o--------------?---E-B------E---o------------E--Bo--------B---o---T-----X--B-----o
----------B---------E------------------MT--o--------B-----BE------------------M-----------------o----------------o-To--------B----o-----?-------B--oB-----B----------------------------o---------------v
----------BE-------------o----------E--E------------B--------------------------?o--B--T---B-?---o------------B--------M---?B-------M?--------B------E----B--B---------M-E----?--M----------M-------X----
-----B-----o--X-?---------------|T?---B------------oB--------------B--------------o-----------M------|--------B---------?---B------T------oM----X-o---E--------B-------B------E---------------B?--------
---------------o----?-B-----------------------?-X------o?--B--M---||----M---B----B-?--o-----------?|----oX----------------?--------B-----------------B----------M------T--------------------X---|--oEBTo
------X-M---------B---B------o------------------o---oX--------T--------------E--T--M-T----B------------------o?--------------------E----B---?-B?--------------E-TB--o--------o---T---X-------B----?----E
-----------?------BM----------oo----?------?----------?-----B---B----------------------------B-------B--B-----------T-------------|?-B---?----T----------XB-T-----X--------B-B-T-o-M--MB--------M-EB----
-E------B-?-------------B--------?---|---B------o------------------o--T---------B-------------o---M-------|--BE--T--B-----------------o?|-B------?-B----o---o-------------o-----------X-B-----X---------
m-?----------B----------------E-------------------------B-----------?--------B--T------------------B--?---o------o----E-B----------X------------B---T---o---|----------BB?-----o--------------o---o-----
-----?--B--------------------M---?-----B-M--?---oXB----------?B---E----------------------|----o---------------E--------------?-----------X-T-----E---T--oB--E----T----T---------TM--------------o-------
