----------?---------------------------BBXX-------X?X-------------B?M---------B-----??---------------XM-----------X?X---MX------------------BB--------------------?BB?-------------BB------------------B-
------------B--------------------------X----oMXXXBoXB---BBXBM---BB-------------------------E-------MX------XB--?XB----------XMM?---------------BBMBB-----------------B--B------BBB----------------------
-------BB-------------XMBBB--?BBBBB--------------X-----------XXB?-??--------MX-------BB-------BX--B?B-?B-----BX-------------------------------BoX------------XB------------------BBX----------oX--------
---------------M--BoBXX-------BX------------XX--X--o-XXBX------XBX---o-----------------------o------------B-B----------------BX?------BBBB?BB------------?X-------M?B---------------B?X---------BB------
------??B--X------------------o----------M-B-------------BBB?X------BMB--------M-----EBB---------------EB---?B-------?X-?X--o-------?-----------------------------------------------X?XBM---------------
-----------------BXX?B-BB?BX-------XXB---BBBX----E-------------------------XX---------EE-M-----------------EX?-----------BBBMMXBX-------XMX---------XBBB-------------------------------BX---------XX----
----------------------?---------?B---BB-------------BB---------------------------------------------B--------B-o--------------?X----X?---XXM?B??M-------------------------------------o--XX--BX?BBB------
BoB------BB?XB?BM-----------------------------------------------E?B??X----------------BBX---------X----------------M?MX----------oBMBM----B-------?BX--B?---------o?------------------BX-B--------BB---v
-----oX-------BBX?-----XX-----------X----X---BX-----BMB---------X--?B------XX---------------------XXB---------BXBBBB?---------------------------?----B-----B------------??B--------------oBBX---?XXo?BBf
----------------X----X-----------------------------BMBB?---------XBBM-------B----------------X--------------B?---BB------XBB----o--M-------BBB--------------------------------------B---MX?--MBX------Xf
--------------------------B---------?--------XM-------B---M-B---------Mo--M--X---BX----------X--------B?--------------------------B-------------BB--BM------------MX------?Xo----------------XBXX?B?BX-f
-----?B---BB-----?B---------o?XXB---------------------------------BXM-BXXB----------B---------------------X----XB--X--------------------------------------------X--BB-------B??BB---------------?B-----f
------------------oB--B------XBXX-BBXXBXBBBBB-----BooM--------------XB--XXB----------BB------------B--------------EBX-------???--------B?BB--BB--------BB------XB--MBB-----XBB--XXX------B?XBB---------f
--------MXXX-BBB-------------??BBB---B---B-----------BMBBXB?--------B------BB----------XXXBM----------------------B---------------BB-----?BXX------E?B---Mo?-----------------------X----X???B-X--------f
m------------------XX---T----------------------------------------------------------------BBX--------------XXMXX--XX--T-------TX-??B-----XXXB---BB---XB--M--------------------?-------------??XBEMXoM---X
X?B--?EXX----------------------------------------------------BXBX?-------------XXX--?---?B----M--E-------------------|B------|BM--------------XX---B--?BM?-----------------------------B--------MBXBB--X
XX|XXXX-XXXXXXXXXXXXXXX|XX-XX-XXXX-X-XXXXX|XXXX|X|XX-XXXX--XXXX|XXXXXXXX|XXXX-XXXX-XXXXX|X---XXXXX-XX--XXXXXXXXXXXX-XX-XXXXXXXX-XXX|-XX--XXXXX||-X-X-|XX-XXXXX-XXXX|X-X-XXX|X|XX|XXXX-XXX|-XXXX-XXXXXX|-
