-----?M---------------------------XBB------XXXM------BM--------M--X-------------B--------B-X?---------BB?B-X?XMMB----------B------?-----MBXBX----------B-------------------X------------------XX--?--BB-
---------BX------------------------??B----X----?X-MX-------------?B?BB?-------------------?BBM---------------B??-?B--BB-----------------oX----------------------o?----?BB------------?B---MB?B----------
--------------EB-BBB?X?XM-oB--BB-------MX----------------oB-------X---------------------------------oB------oXBM-----?XX---------------MX---------?XB-------------XMB?------------oXB?B-----XB---XXXBXBB
XBB--M?--------BBBBBBM-----?XB----E?o--XX--XBB----------oM?----------B------------------------------------------------MX----------B?-----------------------XBBBBX?BBBBBB---------------------------X---o
-----BBX-----------X------BXB---------?BBMBB--M--MB---------XBX----------BB-----------B-------BB?X-----------MX-------BBXB--------------------------------BBXXB-----X----B?-----------------------BB----
-----------X-----------------M-----------------------BX----M------------XB---M--------o------?----o----------BBB--------?X----?-----------------M--E?B-----XX--------?-----------EB---------MB----------
-----------MX?-------?BM------??------EM---BB-------XMB----------?BMXBB----XXX-------BXXB-------E--X?XB------------BMBB---------------BBB-------?MBX-BBB------------XBBXBX?B----?B-X---X-B--------?B----
------------BB----------------BoX--XB---X------o---------------B?B-----MB----------------------o----B?B---------------B---------------?XXB-BMB--------------------MX--B------XX--------------oBB?-EBX--v
---XB------MMXXBB-B-----?BBXBBB---B-----------------MBXBBEBBBMBBB-------------------MX-----XMBB--B-------------MBBMo-?-------?BX-------oXB------------XX----------?B---EX------oBX--------X----------MBf
---BMM----?X----------------?----o??BX-XXX------X------BXMB------?BMX?M--------------oB?---------X?------BBB-XX-----------------------------------MBB---X-M?-B-------?X---------X-------X?-----BMB-----f
----------------------BBXXB-----?MB---B----------BMB------------BX-?XXXB?X-------XBB-?XB----------M-oBBB------------B---------------BXBB?-----------BBM?B--X------------BBXX?X--------???--------MBX?--f
--------XM?------------------o--XM-BB----?XBBXB--o?-------------?MB------------B?-----?XoB-----------X-BBBXX-------X------------BBB----------o-------------------------------BBMBB-?-B----X-----BXB----f
------------------------?BB-?BB---------XB?B-----------------------------MBBBX------------------XXM------------B-------X------------?oB---------------B-------------BX--X--BB--------oMB------------M--f
-----------------------oB----BB----------BX----------------?X---------------XB?-B---------MXB------?BBB--BX---B--------------BB-oBB-----------------M----------BBB-----------oB??------------BBX---BBX-f
m----------------------------BB-------------B-----X-----T---------X----------------------XX-XXB-------------------XM-MT------B-XM-------------------------X??-X-----------BBX--------------T----BB-??M-X
---------------BX---oX-------------XXX--------MB--------|-BB?M?------B----B---X-----BB--o-----------------MBBX--------XB-X---------------------------?X-----------------------------------MX--BMBXX--BXX
XXXX-XXXXXX-X|XX-XXX|XXX-X-XX|X|XX-||||X--XX-XXXXX---X|-X-|XX|XX--XX-|XX-XXXXX-|-XXX--X-X--XXXXXXXXXXXXX-X-||X--XXX-XXXXX-X-XXXX-XXX--X|X-XX|-|XXXX--X|XXX|X-XXXXX|XXXXXXXXXXXX-XXX|XXXXXXX-XX-X-XXX|-X-
