M-----BB--------------XB---------------BXBB?-----------XMoX?M-----o---------B-?B------------------MX-----------------X?B----B-X--BB---oB--------XBB-BBBBBX-----------o------X---------------BX-----EX---
--?B------M-----XoX----B-XXB----B----o-MBB----XX-o-----B------?--------------XM---------------------------?B--BX-----XB-B--??---------------------oXE--?--B?----M---------------BX----------------------
----M-----M-----------------------------------?----------------------------B?------------------o----------------E-------B-----o----X-------------------------oBX-B------------------B---------XB--------
-o-oBX------E-----E-o-------B----Bo--------------B-----X---------------E-------BB-------------------------BB---B-------------?----oo-------------B---------B----------------X---X---------------XM------
X---------------XX?--------XXXM--XBB?-------B---------------------------------------X--------------BBBXXBXBX--XXX-?B---------------------------------o-----o-----------X------------BXB-BB-----------Boo
-------?----------oB----B---------XB----------B----------------MXMX----------------B---X------------BB-------------B?Bo---B-BoB--X---?--------o------X----?B--XX-----?---B---oX?-----------?-----XB---o-
------o-XB---B-B---------------B---------------------XBX--X-----M-?-B-------oX------B--------------XBBX-------B------?------------B?----------B--MMBBX--------------------------XMB?BBXXB---------------
-----?MB---B-B--X-------MB----------------XXX----oXXB--B?XBB----------------------B---------XXM----------------------B?------B-----BB--XBBB-----------BBBB-?---M-----------M?---B--E----------M-----BB-v
---X---oM---------oBBB---------MBX----B-------E--------------------------------------------------------o----------------o-B-------------MB--------?X------X-BX--------BXB----------BBB-----oB------BB--f
?-?BBBB--BX---------M--BB----------M?X--------------------------B----MBX?BX----------------MBB---------------------------------------------B------X-BBX------o--XX-------------XB--BBXB------X-B-------f
-------------------X---X---------MBBo-?----B---XB----o---BMXX----------------------------------------------?--EXB???B------B---?--o-------?----?XB----?---B----------oB--XXX-------BXXX-------------B?Bf
------?B----E?X-----XBX--B--BBXBB-------MX?-------------------XXX-------?----B-BB---B-----BB?X--------------------------------oX---X------X--------?---------B-------------------------?---------------f
-----------??-------XX--XXBX---------------------------------XXXX?-------------?BB----BBBB-----------XBB---------?-?-?B--------------XBB-------------------?B-?XXXB-XB----oX--MB------------------MBB--f
--------------------B?----BBB-------------EM--------------------XXM----------------?X--------X-BX----------------X--MB-o------XXXX---X----------------MXM----XB----BBBB??MX-------B-X------------------f
m------------BB?M-----------oBX--?B------------B--BX------BB?MBXBX--MB-----------------o-----------------B-B-----E---------------------------------oBXX------------X----------BBB---B??XoMXBoBB-------MX
--oXoX-------EB-BBX-o--------------------X---------Mo---------XE------M?------------?-----X-----?---------------------oBM?B--BB-----BB--X------XB---------XB------------B-B-----------B----T-----------X
XXXX-XXXXXX-XXX-X|XX---XXXXXXXXXXXXX-XX--XX-X-X-X-XXXXXX-XXXX-X-X-|X-XXXXXXXXXXX-X-XXX--XXXXXX-X---XX-XX--XX-XXX--X-X-XXX-XXX--XXXX--XXXX--XXXXXXXXXXXXXXXXXXXXXX-X--XXXX-XXXX-XXXX-X-XXXXXX--XXXXXXX-XX
