Eo-X--?--o------?---------B--?---XX---o-----M-?------?----o--X-------o-X--o-----------X--X-X---------XX--------X--X----o-----------X------X-B----B----XMB---?E----o-----X----X-----?-------------E-----E
--o--?-X---M--M--oX--o------o-E------------XB--------M---------X-X-X---X-----X-B-----B-o-X----X------XX----X-------oXX--B------XoX---------E-XMX-X--------XE---Xo-?-X--X------X--X----X---B-----B-------
----o----o-----X---M--o---o----B--X----X----E--X----X----B-----X-BM-XoB-----X----------------Xo-X--?--------oX--o-EX-X--M---X-XXX---------B---------B-M---oX----?---XX----B-o--o-X-B--X-?-------X-------
-------B-----B-E-------X--------------Xo-X-MME-X-----BX--X-B--o---o------Eo--------X-----X--Xo--XB-------------X--Xo-----X-M-X-X-o--X----X-o----------X---?---XXXXX--X-----------XX?-----oB---oo--X--oX-
---X-------XEo--------?----------o---X-XM-B-B------o-X-----------o---B?-----o------B----B-----?------X--X?-----X------XX----?-------X----?----o-X?--X----X-------X-------M-oB-------------o--X--B-B--Eo-
-----B---X-o---E-----------------------XX--o----------X-----------X-X----XX--X---------B----------X--------B?------X------B------Bo-M---o--------------?---o-B---------XX-Bo-------?-----X------Bo-?----
-X----?EX-X-X----XX-X------X-E-B--E----XX---o---EX-------------X--Xo----------------------oX-------X-oEX---?----------X-----------X------EX-M-------?--X----X-E--B-?X-E---X----X-E--E--X-o----Bo--------
--X-B?-?--------E-X---?-B------------?---?----------------o-----B-X-X-------XMX--X-----X----X-----X------X---X----o-X-----?X------X----------BXM-?---------X-----?---X---------------------o-B--X------v
-----X-X---------?-----o-B---oM-M------o---o-B----B---------------o----Bo---?o-----X-E---?----------M-----B--------o---X---------XX-------o-----X-X-------X-o-------B---X-----Xo-Eo-----B-X-----E---E---
-X--------B-o-?-----X---------BX----BX----------o--X---X-----o-X-o----X------X----B-----XX---------------X-X-X-X-?B----X---XX---B------------X-----X---------EX---MX-X---o?------------X-X-B------------
?----X--?X--M-X----XB-X--X------o--X----M----------o---------------------------X-----?-B--------------E------------?----oX-------------M--E---------X-B-----------o--?--------o-M----X---o-?Xo-?-BX-----
--------M-------B------------X--------X------X----?o------o----XX----X--BB-------------X------o--EE------?---?--M----------X-------X---------------------E--XB----X--X-----------?-----o-BXo-------X-?--
----X--X------BX----o--o----------B--o---?M-o--X--o----X-X-----XX------XX------o?---oB-oM-B------------?---X---B---------------X-o----EE-------X------------XX-----E----B---------------Bo----X-X-X-X--o
-------o-----------------X-----------X---X---o-----o-B--X------X-------------X-B-o-E--------o-------B--------X---X-----X------E---o------EX------XXE---X------E----------X-X-?--o--XX-?--o--M-------X-BM
m-o---X--X-------X-o|-o-B-------E?T------X-----------------E-------------X--X---o------X----|------?--XT------o-B-B----------------??---XBE-B-X----|--o-X-XB--X-------?------------X-----XB-X--?-X-EX---
XXXXXXXXXXXXXXXXXXXXXXXXXXXXXXXXXXXXXXXXXXXXXXXXXXXXXXXXXXXXXXXXXXXXXXXXXXXXXXXXXXXXXXXXXXXXXXXXXXXXXXXXXXXXXXXXXXXXXXXXXXXXXXXXXXXXXXXXXXXXXXXXXXXXXXXXXXXXXXXXXXXXXXXXXXXXXXXXXXXXXXXXXXXXXXXXXXXXXXXX
