oBX?--------------------------?-------BB--------------Mo-BB------------------B?-----------?B?X-----------B------M?----o-?XM------------XB--BB?-------XXX----------B-B--------B----------------M-M---BB--
---XBX-XXM----------------MBB?-----------M------------------------------BXMX--oBBB---BMBBX?BBBB-----XX----B?---BBB---XB----------------BBM-BX--------BB---------------------BBBB----MX--XBo-------------
o------EX??---BMBB------BB??XB?MXXXX-------Xo--BX----------?X?BX--?XXX------------------------------?-----?X---?XM---------------XX---BBB-----BMB?------------------------B-------------------BB?--M---X
oMB----------M-------------BBB----------XXX----------------------o??B-------XBBBB-------BB----------------------------------------MX------------------oXBB---BX-??BXXX--XM-M?---------------XMMXBB-M?M--
-----B---------------?XoB-------------------B-XXXX-------oBBBB----------------------BBB----------------------------------oBBBX-BBB?-------------------------B-E-X----BBBBBB?--XXEB-B--------------------
EXXBB--BXM----B---BX----------------?---BBB--------------------B?B-------------------------------------------X?BXBXB--------B-------------B-BM--------BMM??B---------oMBX----XX----------XBB-----?X-----
-MBBB-?--o-------------------X---------------B----------B?MX--------------B?-------?BB-----?-M?oBXXX----X?BB-B------?BBBBB------------MXMX---------------BBB--------o?XXMX-------XX-----------X-?X------
--------X---------BMB-----------------BX--------------BBBMX----B---XX-------------------?B?------------------BBBB-----------------o--------XB-----------------MXB-------------XM---X-------------------v
--BXB?oBB---------------?X------------------X----------XB-----X----------MB--------oB--------------------------?-MX---MM-XMB-------EXBB---------B----B--?BB----------------MBB-----o----------o--------f
---------------------------XBB-MB----------------------------------------------------X-------BX-------------------X---------BXXB----XMBB-M-----------E---------B--XB-----B----------------M------------f
---------------MX----XX---XB--BBB-----XB-------B?XXM----------?------BXB------MX---X----------------X----------------------------XBXB-----------------------XX?BB-------------------------------BX-----f
-----------MXXX----------BX---BX----------X-----oBB------B-------------------------------M-------------------------XBBB-----BX---X-----?B?----------------B-E-EB-------o----XX-------------------------f
-----------------BEoB??-------XBXXM-----XB-----------BB----MM--------B-----BBXM---------------------------------B?BX-BBBBB-----------------?--------o--------------------XBM----X?B---------------B??BBf
------XXBBB----------------B----------------------------------------------BBBXXBBBX------?--------------------------------------B------------------------BX--B------BX---------------------X------o?---f
m-------------------MXXX-----B?-------BBBBB--------------TB-oX------oBB-MB--------X----B?----------MBMBXX--XM-----BM---oB------------------X------------??MB--??---------------M-XBB?---------X--------X
X---------------XM--------------------------------BMXMBBB|TX----------------??BB---------BXX--------------oXBB------BB-?-oX---X?-------------------------------------?---------------------------------X
---XXXX-XXXXX-XXX-XXX--X-XX-X-XXXXXXX-XXXXXXXX-X-X-XXXXXX-XXXX|X--XXXXXX-XXX--XXXX|XX-X-XXXX|XXX-X--X-XXXXXXXXXXXXXXXX-XXX-XXXX--X|XXXXXXXX-XXX-XX-XX-|XXXXXXXXX--XXXXXX-XXX-XX-XXXX-X-XXXXXX-XXXX---X-X
