---------T---B---------X------M-------|-----------E---MB-B-?----------o--------o----?-B-----------Eo----------B----?-----?-----T-o----B--------M----------------E-X------E--|-----?----B--------M-------
------?---------------X--o---------------B------------------T?-------------------T-----B-----B--TM----M---XT?-o------------------o---------------?------BM------------?-----E?-----B-B--------E---------
----E-------o--o--B--------------------------------o--B---------------B------------------o-----o-------|-----B---T-------?----o-------------------?--------------?----------------o-E-?----E-------oBo--
-B---o-To------|--------B-----X----------------T-----------------E-------------ET----------T-------B--------B---E--E-o-EE--------E|?--------E------B-----------------M----B-T------------EB--------B----
---B-M--oM-----M-----B---o-------------X----|---E---Bo----B------------------?---T------?E-----------------------?-|M----Bo-o-----|---X-?-o-EX---X------------o------E--E-----------EMX------------?----
---B-Bo---------------------------B-----?-----------E-------T-B--X---BE--?-|?M-----?MT--B-----oT--------?-----------------------B-------------X--|----o---E-------o-?---M-o---E-o--------|-----B-E------
-----B-----Bo---o---------oX-o-oBB-----?---E-----B----------o--B-E-----E-B?-----?X-------------o----------X-----o---XB----------BEB-------------------E-----M--B---------ET------T--B-?--o-------------X
----------o---?-------B-Mo--------E---------T--?-----BB-------B------------o-----?-----------------B--------E-|----E-------------|-----B-M-----------?o-?E------o------E-----------B-o------o---------Bv
--------------------o-------o---XB--E----o-BB|--o---------B-|---o--------------T------------o-----------------M---------------B--BEo-----B--o----T-X----------B------------B----------------o-----------
--M----T-----------BBB---------?-------o------B-o----------E-E-E------------oBB-----B---------M---------------------XM----------o---E----E------------oM---B-----------------------oE-------o-----------
-----XMo------M-------|-----------TX----------------------------B?-----M--o-----E---T---?----------M--X--------?---------E-B--------T-----------?---------------B------E-------E-T----------o----E------
--?---o--------B---|---Mo-?B----------|-------o--?-o----------B-------o----o-B----------------T---------o-----T------o------B--EB-------B--------E?--------?-?--?----------------------oEoBo------X?----
BB----T--T-------|-------B--B-B----X--------X------o------B-----------------------------o---B-----o-----o---------M---B--o--T----E---------o--------o----------------------M------------B-B----?-----?--
----o----|------B---BB-----------------?---M--------------------------------------------E---Xo----X-------?---oo-----|---------------B-------?------o--------------|------------------o---?-------o-----
m-------?---BB---o-----o--------------------o-----o----------------X------T---TT------------BB---------B-----X---BB----BB------B-?|oB------T-----------------B-----o--------B--?------B--T-B--------B---
----E?----E|------?----------B-----B----o-E-o----------o--------------?-----------o----------o---?-Mo------M--------|----------------------------------------B--|----BB--M-----E---BE-------------------
