X---o-B-X-------?-------XE--X--X?X--X------o---E--------------X------E?-E--------X--X-X------o-M-----X---XX-M-----------o---?---X---o------X--oXX-X-X----E-----B----X-----B-?----Xo-X--o--o--o----XX----
------------oX--MX----X-X------X--------------X--Bo----B-B-o------------------------X------o-----X-----X----X-X--X-------o-X---EoB--o----?-----?-------XX---?--?-XX------X---oX?------B-------B---E--M--
-------X---------------X--B-?M-----E--B------?--o------X--X---?----?-XX-----E---B---MX-X-Eo----Mo-?X----X-----X----X----o-X--------BX-----------o--E------------X-?-ooM----X-X-M---EX----M------B---XXXE
-----------X-o-E-----BX---X--o--X-----Xo---o--X----------o----M-X--------------B---------------XM--X-----?-X----M-X-----------X--X-?----B------o-?--------o----o---o----o--X-----E--BXE-M-B----------X-E
--oo---------B-----------X---E------------E-?X---X--o---E-------o---X-X------oX-X-o-X-----------X------XB---------X------B---?----Eo---B---E-X---------XXoX------------------MX-----X---------------XE?X
o-X--X--X------E-----B-M-----------B---o--B--X------o---X--X--?X----o---E-----B-E-oM?-X----X-X--Xo----X-------X--------o--------?----M-----E--E---o------XB-?B----------XB------E--X--X--X------------?-
-X??-B-XX-------------------?X-----X-X--o------BX--?-----oB-----o----E?-----------XX--X-?---BME-X--o----o--------X---B------X------o------X-oBX---B-o--X------------X--?----E-X-----?--------XX-o-B-----
X---XX--XX-X--------X-X-X---E--o------X-----X-----?-E----ooBX-X-Xo--B-XB-XB-----------XX-o---X-X-oB--EX--------------------B-EX-o---------B-X--X---B---X----?X-X---o---o---B---XE-E----B-o--X-X------B-v
--X-X-B-X---B----M?--?-X-E----?X-----X-X?-BX---XE-----?X--o---o-E---X---X--Eo------?X--o---oX-X--X----oX--------o--------?-----------X--------X-ooEX--X-----?-X---o-E-o--------o-o---M--------------B---
-XE--B---?--------BX-?-X-----X-oBooM----oX--X---B----B-Xo----B-----XE-EB-----------B---B-------X-o--X-----X----o---------o---?-------------------------------?--M--M-----o--B----X--------Xo-----------?
---------M---------B----B----------?----------?--X---XXXX-o----X---oo--?-----E--?---------o--X---X-XX------------M-X----X-X-X?o-----X---------------XM-----oX-----X-XX--B---------X------X---X---------X
-XX--o----?-X--X--X--BX-------X----X-X----BX--X-X-B------------X-o--X---E-E----X-----o--X--?---X-E----X-X--X--E-XX--------ooX--B--------X---X-X-----o--?--X-------oo-M--o--------X--XX----------------?-
--?--X--X--E----??--------B----------E--oo--B----E----------X----M---o-X--X-------XX--?o----------------X-----?-XX?-oM----E--o--X--X----B-X---o---------B--------XX-----?----o---M-E--B-XE------X-XMBX--
-o--X---o-----X-----X-------------o----o------X---------X--B----M----Eo-o-----B---------X-o---------X--o-XB-----------?--------B-X-B-o---M-X--?---o-X--X?--B---X------------X---Eo--X-XMEX------?----X--
m-E-----X--B----XX-----XT------X---o----E--?X----X----------o-?-?-------XX--X-------X|----B-----------Eo--------X--oX--X--X-----------o--------------------------o---??-X----X--X--T-----?-?-----T--X--X
XXXXXXXXXXXXXXXXXXXXXXXXXXXXXXXXXXXXXXXXXXXXXXXXXXXXXXXXXXXXXXXXXXXXXXXXXXXXXXXXXXXXXXXXXXXXXXXXXXXXXXXXXXXXXXXXXXXXXXXXXXXXXXXXXXXXXXXXXXXXXXXXXXXXXXXXXXXXXXXXXXXXXXXXXXXXXXXXXXXXXXXXXXXXXXXXXXXXXXXX
