---------o------B---------?--?-----------------?-E------------T-B---M----B-------M-o------------------------M---o--------T------------------X----B----B-------B|----------o-----B-o-?|-------M--?E|-----
o------------|-------------------X-------o----o------T----B|----E---------?-----B------B---E-|----------E--------------------------------B------o-X----X------M?-T---o----?----------------------------X
--T--------B-?-o------o-------o-M------o--------------------T--B--?--------X-----------o----------?-----B---o------|--E-----E--?-----------------------MB-------------------------?-B-?--------o----E---
----------o----------------B-------TT---------------------M--------M-----------B-----------o--------------o---B---BB-------?----o-B----B--M-----E------BT---------o-------o--o----B---?--o------?-------
B-X----------E----E--------------|---------E--|--B--------B----------X----------o-o-B---------o---Eo---B---------?--------B--------B-------------------?-------E-T-o------o-----------o---------E-------
-------o--E-X--BM----B-------------------|----M----------?-----o---T--------E--o-o-o--------------B----E-----|-------X-B-----BBM---B---------X--?--o-----------------------B-------------T---EX---E-----
--------B--|------------B-o---o--------X-?-E-------|?-?--------o----|--------M----------?--E----------B---?---------------??------E-----|--o-----------o-----------o|-----T-----?-M----|---B|---E----B--
-o---|-----X-----B-----X-------o---|------||-------o---------o---?-------E---|-------T----E--------------------------oo--------X--------B----M-----??E------------BB--E-M------T------------BB--B---T--v
X-M|---o---oBBoB-E---XM-----------B-----------------X------X--------------o---?-----------E--o--------oT---------o-|?-----------------B----o-----o----E-EX------oo-------o------E---?-------------------
-----B--|---------------------o------------Xo-o-------B-?----------o------------------?--B?--------o--o-----X------X----B----------------T-------------XE--------E-----------------------?----?-B-------
-------X---------------o---M-B---------T----B---XB------X?----o--o---------?--------------------o---M----------------T------?-----E-------------oE--o---o---------o-------------------o--X--------------
----X|---------------------o------|B--B-------Xo------------o----|----------B-M---ooo------M--E-------------------T-E----|-o----------------------B-----------o-?E----------o-------------------B------E
----E----X------------------?----E--E-M----|------------------------------o----o--E--o----------------?o-?------?-----------T----------B------E--------M-o---B----E-o---------o---M-----B?----------o---
?-X----BE------------------E?---B------|---o----------o---------|-----------M------o-X----B-B----o-------|-B------M?T----|-------------?-----E-----------o---o----------------EB---------------E--------
m--E--------------B----------------------------------|-----?-----o------XBo----Bo-----|---------------------------------B----B-------------o-----E-E----------------------|-----------?---E-|-----oBX-E-
XXXXXXXXXXXXXXXXXXXXXXXXXXXXXXXXXXXXXXXXXXXXXXXXXXXXXXXXXXXXXXXXXXXXXXXXXXXXXXXXXXXXXXXXXXXXXXXXXXXXXXXXXXXXXXXXXXXXXXXXXXXXXXXXXXXXXXXXXXXXXXXXXXXXXXXXXXXXXXXXXXXXXXXXXXXXXXXXXXXXXXXXXXXXXXXXXXXXXXXX
