--|-o--------TM-------?-------?---------------X-----B--------oB---o---------?------o??-------o-------------T--E---------oT------?-----------?-------B--------------------BE---------o---E---B-----?-----
XB-----------------|-----------X-B-B-----T------------B-------------------o-------?------------?-o-----------|-E-------o---EX--E---|----------M----M------E-------------BE-o-------E---E-----|-M--------
----o-------------------|----------o--B--E-----o--------------o-----B-------o---o---X---o-----------o-----------B---------?--o---o--oo-------------------?-------X--T-------------M?--------B--------T--
-----------|?------------------o-o---o------------------B-------|-B------------------------?-----B-----------------------------------------T--o-----------E----------o----------------B--X--M-X-----?---
------B----T---------E---E--E-B--------o----?---------|------?----B-M|----?---B------|-E----------------------E-----o-----E----X----------E-----o-----BB------o---B-------------B-----------------------
---------------B-------------o--------M--------M----?---T----o--------------o----------?-----|-----E----------o-------------B-|--------B------------------------?--E-----o-B-----------------------?--E-
---o---------------o----E------------o------E----B-------o---------------E--B------------B------|-o---o---X-T--------o?B-----------E--?------------B-------------o-EX--o-------o--------?--?TB---B--|---
oXo----M-----TX----|EB------------?E----------------------------------X---E?B-------?--------E----------B--X-----------------------BX?--E---XB-----o---E-------T-------------T----B-B--------EB-----B--v
-----------B--------------------?-----------B-Bo---o---o-----?-----o-?-------??B------?----------------------T------------?-------------?-----B---B------------------o-------M--?-----------------------
---X---o---T-------X------X-B-----------B-------T---?----?----X----B-?-----?---o------|---o--E----o--------?---o--E--?-----E-----------------------E|----o-------------X-------------------B-B---------X
---?--o?--------------Xo|-----X--------o---------------|-----o--------------------o--------------------o--------------?-------------E---------------o--?-To-------------E-----------?--------BE?------?-
--------?----?---------------------------B---B----o--------------B---|------------T-------------M?---M--E-o---B------o-----T----E------BE----------E----Bo---------------B-------------X------o----B----
-E--------B--------Bo--M?--------?T-----E------M---X---o----o------------|B--E------------T--oT-------------------o------?-|--E--------------E------------------|-----------------E--M--------o------?--
---o------|--E----o--X------B------X----E----------E-----o-------E---------E---------B---------B?-----?------o-o-------X--------E------------B--------Xo---T-------------o-------X--------oo-?-EE------E
mB---Eo--M--E-|---------B---?---------?----------E-------M-----------B---E----o-----------------------oX-----------------o-----o-------X-B-----------------M--Bo-o----------o----o---------T-E------B--B
------------E----------|o---------------o---------------------------------T-----------------|---B-E---E-o----?-------o-----?----------o---|-------M-oo--B---E-T-----BB----E-------------?----?o---------
