-XXo-X-?X-E----X----o--B--?------X---Eo--oo-----o--XXX|----B-----X---E---X-------------?--XoX----||----B?-B-----------X-----------XB--X-------E---X----------X--XE-B----X----Xo------?o--X--------------
---oX------M--|--o---X-----BX---Xo--X--?-E--------B--X---X---o---X---------------?----B-E---o-X--------------o----?--M-o-?---o--M---------X-?X--?----X---|--o-------o---X----X-----ETo---B--oX-?------o-
X---X------X-o-Xo---X-------X---M?-X-------------X?-?-|--|--E-----?-----o---XX----XX----------M-X-XBX-o-o------?---X----?-X---o-X-----------X--oX-E-X-o-X---B----------|-|-X?-X----?|XX---------EBXo-E-E
------------X-------X-BX-X---------M---|X---B?-o-XoX---X------------E-X---X------X?----X-XX-----------X-X-X---------X---X-X-----X----X-X---------o----X----X--------X----o-X--------|-?-M--o---------?oB
----------BX-?-----o-----o--o--XX--|X-X----X----oB---B-------X-------------------MM-------XX-------X---X-B----X-----E-------E----M-X-B----XM-----o-XX|o-BXX-X-----------o-o-X?----B||----B---X--X----XX-
----o--?X------|-E---X------X-X-------Bo---BE-X-XB-X---B--oX-------XX------X-o-------X---M---E-X--X---E--B?----o-----X----X----X--XoM--oX--o-o----XM---------o-----BX---X---X--|--X-|--XX-------X------X
-|-----E--------B----------X--X--o--B----o------Bo-oX--------X------X-----------|------X-?--o--X?-X---?--------o----o---------X--M-EX-------X---------------E-----X---MM------|--E--|--------oooX|-BoX-o
-------X-B?---------M-----X---Eo-BX----X----------o-------XX---X?-M--X-X-------B-M----X----EX------B--X--------XM--X--MoX------XE------MX--X----o----o--X-X------o---X--o------E----|--?---X---?--BE--Ev
--X----------X------------B----B--?--oB----?-X------X---------oME--oo-o---------?X-X?-------B-X---X?-?M-X-MX--X?---X-------------X----oM--?--?------?-B---?------B-?-B--oE----o--X--|----------------XM-
?-?------X---o-?B--X-----X------------X--|---B------E-BB|-----?-------EX-----XB---------E-o-------------M--------o--E-BX-------------X---Xo----X----E------------------X-BX----X----|-o-X-----------X--o
X-------oX----X-|-------?X-X--------------E--E---X---------?----X----E-----------------X-o-X-----B---X-X-Xo---------B--?--------B-o?---------------------X----X-o--------X----X-----|--X---B--oX--X-X---
X---X--X---M--------|o-|---X|------------------o-X-o?---o-XX--------?o-----------B-|----B|X---o----XE--oX------o---XooX-X-XX-------o-o--|-o-X-X----------------?-------X----o-----o-|-oE-X------X-oX--|-
--|-B-------X--M---MBXE-X----B-----------------BX------E--o---------o-------------M----------X?--------?-oB-X-B-M-------X------E---o-B--X-X-------o-------o---X---------------o-----|--------X-o-------X
--X?-X----------X-?-----------o-X--------|--X--?--o-------B-------X--X----X--XX----B-------o-M-----X-------------B--------M-X--------------o----X-XE---X-----X------------XX--------|---------|X------?-
mXXB?X|-X-?-----MX--o-----o------X-----E-----B--o---o-X--------X-----B----------B--------X---X---B----B----B--X--------------------BX---X----X-E---o-X--------X-------M-------Xo--oX|--Mo---o-X--------B
XXXXXXXXXXXXXXXXXXXXXXXXXXXXXXXXXXXXXXXXXXXXXXXXXXXXXXXXXXXXXXXXXXXXXXXXXXXXXXXXXXXXXXXXXXXXXXXXXXXXXXXXXXXXXXXXXXXXXXXXXXXXXXXXXXXXXXXXXXXXXXXXXXXXXXXXXXXXXXXXXXXXXXXXXXXXXXXXXXXXXXXXXXXXXXXXXXXXXXXX
