----X-?-----X--B---o----X-o-----------M------------------------M--B---------------X--E----------------------------------X-?-----B------------B------------X----E-BE--------o-------------------B-----o--
-----o----------B--X--------E--B------M--------------------X?BB--M----------X----------B---------------------------?---------o---------B-----------o----MB------B----------------o-------------XX-------
---X--------?----B----X----------------M-----o--?-o-M-----o------------X-----------------------o------o--------?--------------o----o----X-------------------M-------E----oo-E--X---------B---o--X-------
---------?--------E--------o------------XX-----E----------M--oMo------------------M----------------MBX----B--------B----X------------M-X---B---------o------B--X-----o---X?----M-----------------B----M-
----------E-M-----o------------o--------X----B---------------------B-----X-X------------------B------oo-?--B-------------o------------o----------------?------?--------X---o--------------------------B-
o-?---X---B---------X------------------o---X--?-----------M-----------oXM---B------BX--------------------o-----B-B------X--------------E---------------------------------?M---------------o--E--X-------
----o-------------X?---------------------------E-XXMXBo----o-XB-------------------------------------XX-o-----------------B------------X----B---B--o-----------B----M--X-----------XM----------??--o-----
--------------M------XBB-----o--o------X-------o-------------X------------------X---B------------------X-----X---X--B-------------------BM-----X--------------------o------o----M--B-------------------v
-X-XX--------------------X-?------?--X----E----------M-------------------?---Xo-X-------B------XBX-------------------------------X--------------------------------BB----o--?------------X-X?-------o---f
--------------?-----------X-M------o------------------------------------M---------------X-----------------------X-----------------?----M--------------------B------MXX-M---------------------X---------f
--------------X-------------X---o----B-----------MM--X----------X------------X-----------M-----------------------------X-----X------X------X---------------o---o--o-----E-----------BB---------------E-f
---------------------------X-----?-------------XMo---------o?B----------------------?-o---M--X-----o------------X--------B----------------------------------------o--o--BB-o------------------X-B-----Xf
-----------XB------B---o--B-------E---------------------B--B------------------?X-----?-----------------B-----------------------------o--------------B-X----------XXB------EBX-----X--------------------f
-------o---------------------?--------------------------M------------X---XBo-M-----------X------E---------------X-----------------X-----------X-------X--?-----------------------o---o----B------------f
m------------------------?---E-o------------------------------------T-----X--E-?-------------X-X---BM----------?B-B--------B--Bo---M-T--M--------BBBB--------------BE--X------?--B---------------------X
------------X-----------o---------------M--?-E----------------------|-M-o---X-B--------?--B---o---T--M----o---M-o------------------o-|-------------M-M---o--T---------------E-------------------------XX
XXX-X-XXX|X-XX-|-XX-XXXX-XX-XXXXXXXXXXX-XXXXXXX-XXXX-XX-XX-XX-X-XX|XXXXXXXXXXXXX---XXXXX|X--XXXXXXXX-XXXX-X-XXXX-X--X-XXX-XXXX--|XXXX-XXXXXX-XXXXX|XXXXXXX-XX|X--X|XX|X|X-X|XXX-XX-XXXXX|XXXXX--XXXX-XXX
