X-----------o-------?---X---X-----X---X--------o---B-?E---?--XE--------X--oM--BB------B-B---------B----Xo-------------------B-----X----------------X-E---------------X-------BX-----XXX-------oX---B--?-
-X----T---B-------?-E-?BX--B--o------------XX-------BX---BX-X--X-Eo--------------------XX---X-o-----XX----E---XB---X-------E---------------?-----X--o---X----X--X-o-X-------X------B-----X-B---------?--
-X---X|---X-----o--?------o-------X-----?------X--------------------X----?-X-------X---o----X--X---------------E?-----?-------X--o--------o------------XX--E------E-X--o--------B-B-----XX--------------
--?-E-|-oX-------X----------------E-?----X------X---o------X---------X---X-----------XX-----o------X-----------B-X-----X--X----X---X-XX----B--X-o-X-o-------------------o-----------X-------------------
----X-|X------M-X------B-X-----B-E---o-o-------B-XB-----------XX-?-X----X--X-Bo------X---X--?--E------X-----X-------------M--X-B------------X----------Xo-------E-B-BE----B----X-X-------E-B----o-------
--X---|-----------------X--oX---B-X-------------o-B------M-----oE-?------o?XX----X---------X---X------o-?-X-----?----------o-----?---------------BXX-------XE-----X-----E-M--------------??-X-X-XB-Mo-E-
------|X----------?-------B-----------MB---------X--X---XXo-----M----o?---------E------o-----o------M------B-------X--XXXX--oX-----X---X----B----B--------X--o----X-E--M-------B---------XM--X--------X-
---X--|-----EX--?-------X--X?-------o------o--------X?---------MX--------Eo--------o--------------B-X----X--X----o-?M-?o--X---X--X---X-----o-----X-B--X--?--E----------X-oB---X---------X--------B-----v
------|-----E---------------XMX---------B-o-----------?-----?---?B-o----------o----o-B----B---X-----B----XoE--o-------o-M----X-----oX---------X---o------X----X----------X---B---X----X-o----------?o---
--X-B-|--X------o----Mo-X---------------oE---XE--o--X-------------X--------B-X-?---XXX------oXo---------XXoX---X-----X------------B--MX----X----X------X---------B-B-X--oXE-X------M----X-----------o--X
------|---X--XXo--Bo-------------B------E-------o-X--------Xo--o--------MX--------X---------X--BX-----o---?--X---------X-?-----?--X-------o-X-?-------o-----X-X------E--X----BB---?-X-----M--X-----o-XX-
---X--|?---X--------X--------X---B-o--------MX---------X----?----B------------E--?E--M--o--E----E----X---XXX-Xo------?-------X-X--X---o-Xo--------X----o------oX---------------B----X--------X-----?-X-M
-----B|--T---------------Xo-----?--------B------M----B-----Xo---------o-----------X---X---X-E----E-------M-------E---BX-E-M----X----?--X--o-------o----X---XEX-----Bo-X--B-----BoX-X-B----X------??--XB-
X--X--|--|-----------o----------X---------------T---B----Xo---------oB--X------?o--------------X----X-M--E--E-?----XEX-E--X--o-----X---X----B-X-B---X----B-o-------------To-X------TX-----E-B-----------
m--TX-|o-|---?---EX----Xo------B-----X-o----?--B|---X----o--?-E-?--------X-------X-X-T?---B---o---B---B-X------X-X-------o----------------X-----X---B-M--X-X---?T-BXo----|-XB------|-------------T-?---X
XXXXXXXXXXXXXXXXXXXXXXXXXXXXXXXXXXXXXXXXXXXXXXXXXXXXXXXXXXXXXXXXXXXXXXXXXXXXXXXXXXXXXXXXXXXXXXXXXXXXXXXXXXXXXXXXXXXXXXXXXXXXXXXXXXXXXXXXXXXXXXXXXXXXXXXXXXXXXXXXXXXXXXXXXXXXXXXXXXXXXXXXXXXXXXXXXXXXXXXX
