--------------------------------XM-----------------------------------??X???B-----o--------------B---BBBB--XBB?MBX------BBB--------------------------------------------------------M------EB-------------
------o?BBBXB----------------------XBBBBXBB--------XBB----------XBMB----Bo----XX-BB-------XB-------------------BXX-----BoB--------X-----MM--------------o--------------------XB--------o---XBM---XMX----
MBX-------B?XBB------B----------------------------------E----------------------------------------------------------M-----XXXB-XXX?--------------------------X------M------o?XEBB-----------oX---------X-
----??---------------?---o-----------------------o-MMX-----------oM---------B---X?M?-o?B?B-------?---?XB--------X-------o-------BXXBMMBX-----XM?-----X----------B?----X---o?--XB-------XBBXB---oB-------
---------------------------------------------------BX--------BBBM---XBX---X----------------BXXM----------?XX--------X??BB----XB----BBB-B?-------------MM-X-oMXB-----------------------------------------
-------X--------?X---------MXMMM--------?B------------BB--B?--------BB-------BX---------BBXB-----------------?BX------------------------------------oB?BM---------B-----B--------------------XB---------
------------------------XB------M?-------------oB?-X-----X--------------------------------------BX---------o-----BB?------------------------BB---------M---?----------------?BBB------------XBB-XB------
----------M--------------BM--XX--------------------XB--X-------------------------------------------BB-------B?X---------XXBB----EB------X------BB-----B?B--M----------------------------------X--------v
XM----------------------M----------------??XBB------XB----------------oB--------BXXBXX------------X?BB-----o-----MBBX-B?MX-------???BX--------------------?B-----X---------------o-E-?X-------MBBBBBB--f
---------------------------------??oX?M-----------------XB----------B?----oB------XX---------------------------------?B-----B--------------B------------B-----MBB---------------BX?BB-?BB-----------X?-f
------BBXB-----X?X--------B??--oBBB-----------------------------?BB--o-------oMXB------------XXB??B----------------------X-------------------BX----------XBB-------B------------BB--BB----------BB-----f
-----------------BB--------------------------oB--------------------------------------------BBB?B------?XX----------XB--BB------------------o---------XM------X?--------------MMB-------X---------------f
---------XB??-----------------------------------X---------------------B-X-XXBXBM----EB------BXBB-----------M?-------------------------------------------o-X-----------X-------XB------B------------B---f
-----XX--XX-B--M?---?BX-------------------------BXX---------XX-------X?XX----------o??B-----------------------------o---oX--X-----X-------M?-----XB-------BX--------------o------o---------oM----MX--BBf
m----TB-MXX-----------------------------------BM-oBBB----------?XXXXB---------X--------------------XB-T---------TEB?oBX-o---------X---------------------B---TXX---------------------o----BBX---M?------X
-----B------------------BX-o-B-------------B---M-------XBMBM---M--TB------M?B?XX------------------------------MB----------BBB--EXMX---------XBBBBBBBXX----------B----------------X-----------M---------X
XX-XX-XXX-X-XXXXXXXX--XXXXX--|XXXX--XX|XXXXX-X-XX--X-X-X-XXX-XXXXXXXXXXX-XXXXXXXXX|-X-XXXX-XXXXXXXXX--XXX|-XX--XX--XXXX--X|X-XX--XXX-X-|-XXXXXXXX--XXXXXX|X-XX--XX-X|X-XXX-XXXXXX-XXXXXXX-XXXXXXX--XXXXX
