-----XX-----oBX---X?--------MX--XXMXBBX-----B------BB---M----?X?-----------XXM-B---------------------BBBXBM--?X?B-------------M---------------B?B?--------EX------------------?------------------------E
---------------BX-----X?B--------------BEXBB--??MBo-XBM---XXo--------------------B--X----------------------XX-X-X?X--M-------------------X--BB----?--------EXB----------------------------E-------------
--o?BX-BB--------BB-----------XBM-------XBM----------BBB---------------------MX?BBB--?BB------------BoXBB--------------oBX??B-BBB?-X------------------BX------------------------oBXB--------XX----------
-----------------B------MBB--?MX---??X------------------------------------------XB-----------BXB--XM-----BXBB------B??B-B-----------------XBBB---------------------X---X----B----------BX---B-----BX?M--
XM---X-------------XXXB---o-----BXXM--------o?--------------------??BB?-------------B------------------------------M-MX?X---------MB--------X?-------------------?--------------MB----------------------
------------------o??XX-----------------------M?--------o?B-----BBB----BBB--------B---------BBBB------XX?---------------XBB?BBM---------------------------X--XXB-BBE-------------?MBB--------------M----
--------X-X-----------------------BoBXoXB----B-----------?B--M?B------------------------------------------------XX---?B-----------------B-oBMB?M----?-------BX--E--XB-----------B---oBMB?B-----MB-------
---------B-----------XMM?---BBB?B-----B-------MB------------------------------BMB?--BBXXM----------BM----------------------------XBBX----X-----------------------------------------------?M------------v
BX--------------------------------------oX?X----XM-B?M?X-EB-XX-----------XXXX--------------B?X---??B----BB-?----------------?-----------------BBXX?---------------BEBX--------B-XBX-----------XBB------f
E------------B----MX---BB---EXB---------XBB---------------------------X----BM----M-----------------Xo----------BB--E--oX?B----------XBB------XX-BXM-------B---o-B-X--BX--------------------------o-----f
-----------oX--XX?--XB----------------XM?----------EXX--XB--oXB--------------o?----BB?-BB---MB---------?B---?B--------XXM--------------XBXXMB-------------------------BXX-MB-XXBX-----B-------------B--f
--------MBBXX?BX--B?XXX--------------------------------------B------X?BB--------------oBBXXB-------X-----XMBB---?X--------?-----------o-------X---------------BX?B-M-BB--------------------------------f
--------------BXB----B-XXXB----BBXBBB-----B-BB------o--------------XX------------------?BM--BB-----------------------X?-------??---------BB----BXB--???X-----------?-----------------B-----------------f
-------------------------------XX?---------------------------------------------------------------------?MBX--------------------------o--EBMXX---------------B?-MBBB----------------------XBB-----------f
m------BBB-XM--------------------XXX----------XX--?B------------BB---B----------------------------------BM?----------B---o?TXB----BXBB?----B--------------B--XXXBBB-?XB-------M--BBBB------------------X
--------?-----MM-oX--------oX------------XBB-------BBXX-?----------------?B-BXM-B--B------------o-----------------B?BX---------------------B?----BX-B------------MX----EB----------XM----XXX?-BXBXXBXXXX
-X-X-X|--XXX--XX-XX-X-X-XXX|XXXXXXX|XX-XX--X|XXXXXX|XXXXX-X-X-XXX-|XX||XXXXXXXXXX-XXX-XXXXXXXXXXXXXXXX-XXXXXX-XXXXXXXXX-XXX-XXX-X-XXXXXXXX-XXX-XXXXX-XXXX-XXXXXX-XXXXXXX--X-X||XX-XXXXXXXX-XX--XX--XXXX-
