-----M-------------------------E--o-----X-----------?------o--B------B--------B?----?--E-E---B-------------B---?--EEB------------B----------T------o--?---------------o-------TEM-----------|-E-Xo-M----
---------o--?-------o-------o--------?-----------BEo----M---------o--M---B--o----------?--------o--------------E-----------?--------E?--------------E-X----------------o|--------------|-T------------M-
-oB--------E----B-------------B-------------------|BM-?--------------o--M---o-o----------------B--|E----M---?-----------B-----------Eo--o--------------------------B---o---------------------------B--XE
--------------?-o-------------o---------|----E----o--?---------T------B--------------------o--B------------|BoB-X--------M-------------------o-|--------E--M---------o----o----B-------------------X----
--?-----------B---B-E---MT--------M------------BE---T--T---T-o-E-E------|E-T-----------------o------------?---------o----?-----------B----------------|---o---o---M--------------B----BX--------?------T
-----M--o--?---EE---E-----------------?--o---|E--------B----------------------E--?-----B--------------T-------------------ooE---------?-?------------------o----------?--|-------o--B---?---?-----------
---T----------------------Eo-----X--|---------------------o-B--------oo---------X------X---?--T-T--T-E-----------B---------?-----oB-B----T-----o-------M?----?----B-----B----------E--T----------?-M----
---------------------o-|-B---T----------E-------B---------------------------------------------------------?---??---------?---------M?-o-------------T------E?---------------?------------B----?--------v
--------T--------o----B---------X-----------?--T--B---E-B-----------E--E-------?----E---------E-EoX|------B?---------E------------------X--o-|----------?M-------------------M-TX-----E------------?|--M
B----XX------o------------E-X-----E-----------X-o------------X-oB------------------------------------------------------------------------o--|B-----|------o----------------B---T--------T--B--X-------?-
-------T-|-X--X---T-----M-----X-------T--E------T--------BB---------B--------------|----o-----|-------|---E-----?----?--o-------B----------?--------------o---------------X------------------?T-M----B-B
---------E--------------------o-----------------E--?----------B---o---|----------------X--E-------B---------------------E---?------o----------o-M----|----------------E--------------|--X----B----------
B--------------------M--o---?--------|----X-----B------o-----o--------B--E--------T---?--------?-------T-------?-------M--B--B--------------|----------E?--------------B------------o-------oX----------
----------X-X--B-----------------B-------X------X----M------------------------o-----?--------------E----o--X-EM--------B---o----------E--o-Bo---?------o--------o----|--------------------B------Mo-----
m?-----E--T|-B-------------------------------?--o-E-----------?---------------T---oo------------------ME--o-----------o-o-?-----o-------o---------------------B---------B----X------------|---o---------
---T--------o-------------------|---------?-X--E------o------------------T------X-----------|-----B--o--------------o---o--?o-----?----o-?--------------------o--------T-B----Eoo----?-B------E---E-----
