-----o-X-----E----E-----------------------E----------B-?----MB-E---o-------?----B-XB-------o----E------------------B-E----X-------EX--o--?-----------E-M-----o---------X---------E------?-----XB--------
---------B-------?---------oo---------E---B-------XE--E-X-?--------E---------E----?-----------o------E----------------------E----XM-----X-----?X-----------oX---------------B?-------------------------X
--------------------E----X------------X---?-E---------X------------------------?------------o-B-M--?---E?--------?-B----?---X--------------BX-o-------o---------------------X-----?--------M-----o------
B-------------X---X---X--X----------------B-----------------------------?--------X------------?-?---?-?-----------------EX--X-B------oE----------B---?---o----X----------o------X-X-E-------B---o-------
-E-B--------X?--?-------B-------------------------------XoE-?------B---------?----o--o--------------E---o------------o----------o---?--X-----E-B--B-----------X-o-o--o-?------Bo-------X--E-----X---o---
XX-------------o--------------X-------?--------o----X-------------?-----M--------X?------------B-o-E-------o---------X----------XXE-X-X-------X---M-?---X--------------------X-E-o--------M-------------
-----X-X-X-----------o----------------------------------B--BE--------------E--X-X--X------X-E---o-----XM---X-----X-----------?XB-X---o--------E------E--o------------------M--XX-----?---?------------XX
---oX--X--------------X-E--o--------oX-----------------o------------X--------------o-----------E---------?---B------X-o--------B-----?------o----B-X---BE--o--------X---XX-----X-----------B-B-------E-v
---B--------o-E----------------------X-B-------------------o------E--oo-----------------------------X-E-----B-?-----------?-------?------MM--------------B-------------X-------Xo----E-E--------B-----Eo
--E------------B---B--E-------X-E---XE------M-------X---------o----M-----E----o----------o-o-----X---o-----------o-----E--------E--X----------------EE---------?---X----E-E--B---------o---B--EB--------
-----------B---M-----------------E-B---------------------------o----B-----X-------E------------E--------------------X----X----------?---?-------------------X------o-X--------B--------XB---M-BE-----MM-
---------E-------------X-?---X-------------B---B------o-----------E--------------M-----------o-------B----BE-------B--------E------------oE----EX------M------?---o------M----o--B-E------------------o-
---------------o------E-XB--------------------X----------------------X----o--------------------------?----?----------B--E-------------MX---B--------?---?--B-----------M---X------------E----------X----
----------T--T-B--TT-TET---T-----oT-----TTT--T--T-----o--T---T-E-T----T-o-T---TT-TE----XT-?-TX--M-T----T-ETTX------TT---T--T-T-TT-T-----TTTT-------------T-X---TT-------T---B----T-TTo--X-?X--TT-oT--B--
m-------o-|--|---?||-|-|---|------|B----|||--|?-|?--X---o|-XE|---|?-X-|B--|---||-|------|XX-|-----|----|--||-------||---|XM|-|-||-|-X---||||-X--X--------|?-X--||--X----|--B----E|-||-------XB||--|-----
XXXXXXXXXXXXXXXXXXXXXXXXXXXXXXXXXXXXXXXXXXXXXXXXXXXXXXXXXXXXXXXXXXXXXXXXXXXXXXXXXXXXXXXXXXXXXXXXXXXXXXXXXXXXXXXXXXXXXXXXXXXXXXXXXXXXXXXXXXXXXXXXXXXXXXXXXXXXXXXXXXXXXXXXXXXXXXXXXXXXXXXXXXXXXXXXXXXXXXXX
