-----XX-----oBB---X---------BBB-XX?XB-X-----B?-----XB---B----MM?M----------X-B-B---------------------?B?XBM--?XBX-------------M--------------?--------------B---------------------BB----------X--------E
---------------BX------?B---B?BBXB---XB---EBB-M----BB-----------------------B----MBM------BBB------B?M--------------------------------------?B--XB-----------?----X-------------------------------------
--B?---BB--------MB-----------BB--------XX-----------BBB---------------------M---------X??-------------------Xo?--o?---BBB?------------------BBX--BB----BBBBXX-o-------o----?X--XBB--o------B--------MB-
-----------------BX-----MBB--?B?---?B---------------------------BBBX----X-XXMB?o?-X---------?-------B--------?X--------B---B------------------------ooMBB------X----------------o-B?-------BBX----------
XMB--BXMB?--XB---------MBBB--------M----------------------------------BBBBXXMBB-----------------XXX---------------MB----------B--------------EB--oB-----B--BB-----------?XBXXBX---------------?B--------
------------------oXB-------------------------M?--------oBB-----M------XBB--------XB--------BBB-------XB----------------XBB??BM------------XB----X------------------------E----XB------BB------XB-------
--------X-X-----------------------XMBXoXM----o-----------?X--M?-----------------------------------------------XBB---------------------XMX-------------------?B-?----------------------------------------
---------BB----------XMM?---BBB?B-----X-------BBB-------BBBBXXM----------------------?BB-MoBBB----BBMB-----BBBB--------------------------------------------------------MX-----X--------BBXX-MB--BBMB---v
BX--------------------------------------oX?X----BX-XBBMBB-B?BXB-oX-------------B----------------EB---------?-------------------------------MMXB-------------------------B-X?----------------BX---------f
EBX-------X?--------B--------------------------B?BB----------------BB-------------------------------------BBM-----oB------------?--------------B-------?-o---B---o---BB--B----B---------X--------------f
-----------oB--XX?B-X-----------------?M?----------EB---B---oX-----------------------------------------B--BBX-------BXXBBX-----X-------------MB-----X-------B----X?---oBBB------X?XB---------oXMB?--B-Xf
--------M--XXBMoB?B?XXXB-----------------------BBB??MX---MB----------MBX-------------------??---?B----MB------B-BX---oX----------------------------?BB-------?--MMMXB--MBX----------------B?B?BX-------f
--------------BB------X---------XB?----M--B--BXB-----BB------------------BBB--B?B----------------X------M-----XXB-------BB-----X?MX------BBB--BB--------------------?MBB-B----------------MM---------XBf
-------------------------------XX?--------------------------------------B---------BXB--------------------------B-------------------?XBM--------------BXXX---o--BB---???-B------BX----------------------f
m------------------------------------BBX?M-----BB?X--------------E---------------o-----T--X-----------------------------------------------XX-----------------------X---E-----------X--BX-XX------------X
--------?B----MMXoX--------oX------------BBB-------BBXX-B----------------?B-BMM-B--BXM----------o-----------------T?XXXB----------oB--------T------?-X------------B?B----XXB-----B-X-----------X-?-----X
-X-X-X|--XXX--XX-XX-X-X-XXX|XXXXXXX|XX-XX--X|XXXXXX|XXXXX-X-X-XXX-|XX||XXXXXXXXXX-XXX-XXXXXXXXXXXXXXXX-XXXXXX-XXXXXXXXX-XXX-XXX-X-XXXXXXXX-XXX-XXXXX-XXXX-XXXXXX-XXXXXXX--X-X||XX-XXXXXXXX-XX--XX--XXXX-
