--o-?----o----------?-----------B-----|---o-------B?----------------------------|------o--------o-o----------------X-|----------------E?-----------M-X--o-------E-B--------B---?oB----E----Eo---E-----E-
-------------BT-M---E----------------|o-T-B-----o---E-------------------?-BT-----E-E-o-----B----------o----------------------------B-------EM--------------o--?---------?-o---BT-------------T-----E---E
-|-E---X-------E------------------------T----------?---X---B-------------E---------------------------M-T--------|---------------------------M--B------B------------|----M---------------M-----B---o-----
---X------B-------?-------?----------------------?------T-------Bo------------------------------E--oX--------E----E---------------M---o-|-----T---------E----o--------Eo-B-------X--o-----------oo------
-?-----------T---E----B------?---BX----X-M-B-------B---?------?--E-------E--T-----B-------EEo--T----------E-------------|--T----------?------------M--------------------B--B-------X-------------X--E-M-
-----------M---------T---?---------E------------E-----------o---o--------------------------------XX-----T--------------o-----BB---BB----o---?--------o---B--Xo----------E--------E---------o-M-T?-----o-
BB----------?---------o---------B-----E?---?-----?-X-------------T-------B----M-------------o----T-----?--------B--?------E--?o----E-----B----X---------|---o-B--------oE---------------X--------B------
-T----?B-----o-----------B--o----------X---B---E?-E---------------------E-------B?---------o-----E-------M----------|-oo-----------------?------------o---o----------?E---------------?--------------?-v
-------X|------------------|---?------------B-B|--E--X------B----------|o-----T--B------?------|-------oM---------|------------T-------E-----X-----?---o-------B------E------|-------------------------B
------o--?--------E--------------------------T--------M-----M-----E------o-E---o--------?---------?----------------E------o-----------------M---o-EBB----------?-o--B-E--------------E-----B-------B--T-
----------E-----?-----------T-E----M----------------------------E-----------|--M------?-T-----------B-----o------------------------|------------------------o----B----?-----?--------o-----------E------
---X--------T-------------o----E---ET--Bo-----------E----------------------o---------T-----------------------------B------o-?---o---?-o----o-----?----------------E-X----o----------EB----M----B-o------
|---------o-?---------------------E-------X---------|----------------T--------B------------?----B-------------------------------B---------------o-------E----------?---T--------o--|---B-------M-E---oE-
--M-----?-----------M------------------------E-B-------XB--------T----T--------------BBE--?---X-M-------B---oMB---?---?---M----------------M-------------------X--E---o---B-M-------o----M--------------
m--------o--|--o-----------B--?---------------------------------E--------?------------------o--o---------------T-------?-|-------------B?------------------E----E------?----M-------EE------------------
-|oT----------------------|E---------------B---X------M-------B?---------------?----------B----X-X----------------?-|--------------------------B---------------|----?o---------E-EM-----?-TT-------o--B-
