----o-----------------X--------------------o--------------------------------o-----------------------o------------------------?--M------------o----------X------------------------o?---------X---------o-
--X-----o-o---?----oB------E---------E-----BB-----------o------?---------------------X------------E------------X?-------B---o-----------Xo----X---E-------X--M---X-----------------------------B--------
-------------B--X--------B------B---------------------M-----o------BX------B-------o------oB--------------------------------------------B-----X--------B------X-----------------------X---------------?-
-----o----M----------o-------B-----o---------Xo--?-----------X-----E--------------------------------MX-------Mo-X-o-------B--------?X---o----------o-------o--X-----------------?------------------X----
----------------------B---M--o-B---------o-X--?------------------o----------------X--------o-----------B---XM--------?-E-B--BEX----------------o------X------o-X---X-------------?B------X--------------
X------------------oX----?X--------------B---------o------B----?--------M--------M---------E---B-------------------BB-----o?X----XXX---------o--o--B---------?-o-----X------B--B------------------------
oX-----M------o------o----------------------------------------------------X-X----o---o----------------------------B---B------------------X--------------------B--------X---oB---------------------------
-------------------------------------M--------------------X?-----------------------------M----X------------------------------M---------BX--B----M----------X---------------M---------------------------v
----------E----------------XX-M----E--?----M--o------B-E-----B--B--------------M--------?----------------?----X------------B-------------------------o----------------B-----------X---B---------oo-----f
-----XB--X-------o----------------E-----X----------------------o---B----B------B-------BB-------?-----?-----BB----?--------------------------------------o-------------B--------o----o---?-------X-----f
--------------?---------M--X--------E-------M-------------------------B---B-----------------M----?--oB-----B----------------?----M--------B----?------------XM------------------------------M----------f
--------?-B---------------B-------------------X-X--------------B------o-------------XB------------B-------o----X?-----o--M-----------BX---------------X------------------o--X----------M---------------f
--------B---B------o--X---------------------X-----------X-o---M----------B-------------------E----------?--B-------X----------------o----X---------------------------------?--o---o-o--------X---------f
------o--B----------X------------------------X-o-------o?X----------------MBB-------M----oE-------------------?o--?--E-BB-X-B-B----?-----------------------------o----------o------------X-------------f
m--------------------M-o-----------B------X---------B-----B----M---oBB-------------BB--------------B-oX-----------------------E------XET---X-?B-B-X---o-----B------EXBo----------o---E--oX-X-------X---X
|------------M------------------BB----o-------?-------?B------X---B-o--B---XMBB-E--XB--------------T-E---o--M-------------------o------|-o-B-T-oB---------X----?--BM--------B-------------BT-XX-------XX
XXX-X-XXX|X-XX-|-XX-XXXX-XX-XXXXXXXXXXX-XXXXXXX-XXXX-XX-XX-XX-X-XX|XXXXXXXXXXXXX---XXXXX|X--XXXXXXXX-XXXX-X-XXXX-X--X-XXX-XXXX--|XXXX-XXXXXX-XXXXX|XXXXXXX-XX|X--X|XX|X|X-X|XXX-XX-XXXXX|XXXXX--XXXX-XXX
