--??X----------------------------------oB----------------X---------BBM----??M--------------XXBB?---------------------------?-BBBBBBBB----BX----------X--------------------------------------------------
-----BM----------?BB--B----------XXXBM?------BB?B--?-------------------------BBMB--X?B------------------BMMB-----B------oMX---------------------------B------BBX?X-----------------------------------BBB
------------BBXX----------?oBBXB---X-oo?BX?XBBXBXX-------------------------------------------------------------------?X------?BBBB--------------oX------B-----BBB------XoBXB-------X--------B-----------
X------------------BoBBB----?B-------------------XX--------------------BBBX-----------------------??-----BBB?EB?------B----BXXX?----------oBMM--------------BBX----oBEBMBM--------------X---------------
-XXB?--------?BM---------?BMB------------------EBB-XX-------------------------------MB?M?----?----X?B--------------??BXBB-----------------------?BBB----???X--------XXBBBXBBB--X-------BBX--------------
-----XX----------------B---BBBXBBBMM?---MBBMXM--------MX-------??-----XBBMXBBBXMB-----------------------BXBXBB-------------------------------------------X--BX-----XXXXXX---XXXM--X---MB--BBBMBB--------
-------M--------X?-------------------------------------XBXBX--?BX?----------------------BB?---------------------XXM-----------------------M--BBB--B---?MB---XX-XM-B-XM---------?------------------------
-------------------BB----------B-------------BB---BXBBXX-oX--M?---------MB??BBB------------------------------------------------BM------BMBBBB----XB--------------o-------?-------------------MB--------v
------XBBBM------XB?--------X--XXXXX---------XB---------BX--------------X?B--------------------------?BBMBMX--------------------------M--------------------------XB---?XBBB--------------X---X?XX-----B-
B--XBBX------------MoB-BBB-----X?------BB---o-XBBB?---X-----MX--------------------------------------------------------?X-------?M?-------BXMX?--XB?-----BB--X--BX------o------XXMXX------------BXX----X-
------M-----------?--------BBB----X-------XBB------------X--B--X-------B----------------BB----------BX----------MBB-XBBMBMB?-------oB--X--MXB--oX----------BBBBBB---XXBB------BMX-----------------------
--------------------------??BB---------------------MBB--------BBM??-BXXXB-------------------M---------------------------------BB?XBBBB-------?--?X--B-----------------------------------------XX?-------
------?--------?XB----B------MBXB--BB----BX-----------------------MMMMBX---BB----M-----------------?---E----MB--------BBBB-----E----------MBB---------XB------BX?BB------?XBBBM--??B--------------------
----------------BBBXXX------------B---BXX-----------------------ET---B?--B--B----BXX------------M?X---------MMB?---------------------TBBX-------------------------X-----BBBX-----------TX-----o?-------E
m-BBXXBBBB----------------X-o-------------XXBX---B------BTBBB--BM--------B----TB-------XXB----XBBXM--------T--------MBBMB--oM-------TXX----------XX-BBBXMB------------XMB---T------TBB-BBXXB------------
XXXXBBB?B?XXXXXB?XXXXXX-BXXXXXXX-XXXXXXBBBXXXXXX-XXXXXX-X?BXXBXX??XXXXBXXXXBXXXBBBBXXXXM--X--XMMXBXXXXBXXBX|?XXXXXXXXXXX-M?BX-B-XXXXXXXXBBBXXXX?XXXXXXXXXX-XXBBXX-B-?BXXXXXXXXXX-XXXXXXXXXXXXXX-MBXXXXX-
