--------X----------?---B-----B-------X------X-----XB-----X---X-----X---?------E--oE----M-o------E-------E---o-------B-B--------X-X--------?-X----X--X--XB----------E---?X-----o--------------o-----X---M
XB--?--X-------------B--------------------X-------E-----------X-o-------------BBX-----o----Xo-o----?B--X--------X--------------B--X--------------o----------B------X------------------------E--X----E---
------------E---XE--B----------o-M------------o--?-EoX------?-------------------------o---E---E----------------X---------E---X-------------E-------?-o------E---------E--------X-------B--------B--?----
T----------Eo---------------------------B-B---?-------Bo-------------------------------------E-------o-------------------X--B-B---E-E--?--o-----oB---o--X---?--------BE---------X---------------B-------
|-----------?------X---o---------X----E-------X---X-----X-----?-------B---o----o-B----o----X------------EE---?---o-----X-B----M----B------------B-------------?----------------------E------------------
-X--B-------------oo------B-o-B-X---E----------------------E--E----X-X----E?-M------------------X--E-o--B?-------?------B----E---X---M--X--B---------------o----------o---E--o-M--?-M--o---X----o-------
----------o-o------o-------?---X----------E-------------------M------------------E----------?E--M---?---BE-B-B---oE--o---------B-?------?---------------B-B-------X-----------o-----------XB-----------B
-----?-----------E---------------oo--X--B-o-oB-------------EX----------B------?oX--E--------------------------------------------o-X---BoX------?X-X--------E--X--B------B----------BB-----o----?E------v
--------X------X--------------X-X---------B------oB-----oXo----o--X-------?--------------------------------------B--------------B-T-o--X-----------------------------E-------------X----------?-XX------
oB-----------------o-------?--X----------Eoo------------B----X----------BB-E---E----o----X-oE-B--X--------o-B----EX-X------------B|--------E--------o---o---o-----------------------T----X------------X-
-------E--oEB--X---B---?--X---BEo-----o----E------B-----XB---B---XXX--------?------------E----X-------B----?-----oE-BX-B-----E-X--XX---------X--X---BE---E-B---X-------X-----o----X-|--M----E--o---X-M--
---o---X--?--E-------X---X-X----?----------T----o-o--?---------X---------------oT----------?--?-------X----?--o-----T-----------------X-------------M-B---X----?-----------------BE-XX------Bo---o-X---B
---B-----?---B---B-----T-------------------|--T---oX---B---------B--o---o------?|T--T---o------?-------B-------o-E-B|--o-----T---------X--o----T----------T--EB----T--------B--Eo------B---X------------
--ET--o---X-T--oX------|-T--T----T-T-E-E---|M-|-----BT-----TT-----TT-B-T-?TMT---||-B|------B-T-T----TB-M-----TX-T---|T----T-T|T----M-------T---|T--M--T--?|----oXET|------XTo--o--o-T-TX--T-oT-----TTM-o
mo-|-X------|--o?---B--|-|X-|----|-|-Xo--X-|--|---XXB|-X---||--B--||---|E-|-|E--||--|---E----|X|o---|M----?--|--|---||-X--|-|||-XEXX?----o-|---||---BX|---|----oo-||--B-B-o|-----X--|-|---|--|-E---||oB-
XXXXXXXXXXXXXXXXXXXXXXXXXXXXXXXXXXXXXXXXXXXXXXXXXXXXXXXXXXXXXXXXXXXXXXXXXXXXXXXXXXXXXXXXXXXXXXXXXXXXXXXXXXXXXXXXXXXXXXXXXXXXXXXXXXXXXXXXXXXXXXXXXXXXXXXXXXXXXXXXXXXXXXXXXXXXXXXXXXXXXXXXXXXXXXXXXXXXXXXX
