----------?---------------------------BBXMB------XB--------------MMMX?-------XB?BX-X?---------------?M------------------MB-------------------X---?--??BB--------------X--XBB--------X-----------oB---B--
---------------------------oMB----?BBB------------oXBBB-BBBBB----BX---XBM----------------?----------------------??--------o---------------------B---X-----------oX-----B-XXB-------o---o?---------------
-------BB-------------XXBB---?BBB-------BBB------BBXM----------------------B?-----------XB-------------oBXB------------------------------------------------XoBXXBo------X-------B?----------------BBBMX-
---------------BB?oo?BM-------B-------------B---B--BMXXoXX-----oMXXM??-----------------------o------------B----------------------------BB-------------B-----?-----??BX-------------------XBB----XX--XBB-
------?----B-BX----------XBBB-----BXB---------------------BXB-------------X--BXMM---------------------------------------XX---X-------?X--------------------X----------------?XM?B--B--------B-X?-BXBBB--
-----------------XXMBXX?X----------X?B---BBB-----XX------------------------XM---------BBXXMX?--------------EX-----------------B??BBBB--------------------------------------BX---------------------------
----------------------E---------X?---?B-------------BMBBB----------------B-B?--X-------B------------?BB------------------BBBBXXBM-XBBB----------------?MBBB--------------XXXo--BB--X------BB------------
Bo-------X-----BX?BX-XB-B-----------------------------BXM-B-----X-------XM----------BBoBBX---MBX-------------------------------------o--------BBB----------------MB------o------?oBoBX?---------B------v
-----MB?------BBB------BB-----------X----XX--MX?----XMB---------?X-XM------XXBBB------------------BBB---------BM------B?---BBBE----------------------?-------M----------?B------------------MB??B---BX-f
----------------B----X-----------------------------BXBoXBX-------BBBM-------BB--------------------------------B------oB-------------o----M-----------X---X-----------E-------------------------B-------f
--------------------------X---------?XB----B-BB-----------BBBo---------X---------MX---------------------BB?X---oBB?----------?BBX----BXXBX-M-----------BMM-??---?---------------------X---------XBM----f
-----X----BXB----XB?--------o?X--------------M-?M-----------------------------------B-----------------o-----------?---------------------BBEBBB--------B?B---B--------M?M--?XXoBXXEMM------o-----??-XB-Bf
------------------oBB-M?-----BB??XBBB---------------MB-------------------B-------?B-----------------X-----------------------B?B-----MXB-----------------M---------------------XB------MMB?------------of
--------MXBXXBBBB------------?B-?X---B---?BXX--------M----B--?XXB----?BBB---------------------------------BXB---XXB---------------BB-----?---------EB----M???XXB?XBXXB----------MB-----------MX?-------f
m------------------XX---T----------oXX-M---------------------X------------------BoM--------------XBBXX--BBB---------B?X----------B----BB---------------------XBM----------XBBBM---?----------X-oX------X
XX---?BB---MM------B--------BBB-------------------------M--------BX?-------EE?B--------BX--oX------X-----------BXBM---o-B-----------BXB?------oB-BX----------------o-XBB----------X--TB------B-XX------X
XX|XXXX-XXXXXXXXXXXXXXX|XX-XX-XXXX-X-XXXXX|XXXX|X|XX-XXXX--XXXX|XXXXXXXX|XXXX-XXXX-XXXXX|X---XXXXX-XX--XXXXXXXXXXXX-XX-XXXXXXXX-XXX|-XX--XXXXX||-X-X-|XX-XXXXX-XXXX|X-X-XXX|X|XX|XXXX-XXX|-XXXX-XXXXXX|-
