-----------MMM--X-----BM----oM--------BMB?B-------------------------------o---XB----MBMMX--B------X-----------?B----------B--M------M--B----------------B---B---X-----?X-------?B----------BXMBBBB-?----
---------XBBXXXX---------------------------------------B----------------B----------?B?----B?--BXB-----B----XXBBBBX-BBX?X?X-----?----E-----oX--B-?X---MBX--------X--------------?------------------------
-----------X--M-?------------------BB-EBB----M---------------MB--B----------o?-BBXM?X---------------------------------------M-------?----XMM-------------------MBB-------XM-EM-------BXB-BB----BX?------
-X----------------XoMXMM--------------B--BX--------------B----------B--B----BB?-X-----o-----------?-------oX-------?-B----------?---BM-X---o---------------------------------------o-------B--o---------
--------XX------X--XB------MX-----------o?----------o---------------------??M------------------XB-X------BBBBX----o?XBB-------B--------------B------------BB---X?B?MB---------------XBXB----------?BBBB-
------M------------B-----M--XX--?--XM----X-------------BX---------XB---------------------?-o---------o--?B--------o---------X-----------------X--X---MX--?X------o-----------?--------XE---------o------
-----B---------------------------XX?B-----------------------XB----------BBX---------B?------------o----BBB-----?----XB----BB------------------?-BBX--------BB----------B----BBXX------B-----------------
B--------------MX----------XB---------------XXX----XBBX-----BB-------------B-------------M------oXBBMBo---------BB?X--------------X-X-----E---X-------------XXoXBXXXB--------o----------BB-?B--BB------v
-------BB----?B-----------------B??BX-XXM?---o--------------------------M-------------------------B------------------------------------XB----X-?--BBX-----M--BM---XM-------XXEX-----BB--------------X-Xf
-------B--------------M-------------------------oXB-------X------BXX--o------B-------M--------X--------------------------------BB-----M-----------------------------------------?---B-M--------X-------f
------BBBB-?BBBM?---BB-----------------------------------oXB-----------------BBB?X-----------------------------------------------M-----------------------------X-M-----------------------------B------Bf
---------------o----oB---X------------------X?--------?-----------B------MB--------------------X?------------------E---X----B------------------X-------------B----------X?X------------B---------------f
-----------E------------M---------XM-?-------------------?-----oBBB-------?BX---X-----B---X--M---------o---E------------------------EBX-X------------o---BX--------o-MB---------EB--o----X-------------f
--------------------MB?X---------?-B-?XX------------------X---B-B-??-?XX--------------------------------------B-X----X------------MXM?-------------BB------X------------------X----?BBX--------------X-f
m------oB--------------------------E---?-----------------------BX?----M----X-----------------XB-------------MB-----o---------X-----XB-------o--------------------------?-------------XXB---XX----BBEEE?X
----B-----------MBX--------------BB-------B--XMM--BXXBB--ME-BX---------------------------------o------------------o-----------X??------------------XX----------B??X--B--BB------------MXX-----------XX-X
XXXXX-X-X--XXXXX--XXXXXX-XX-X|XX-XXX-XXXXX-XXXXXXX-XX|XXXXXXXXXXXXXX|--XXXXXXXXX-XX-XXXXX--XXXX--XXXXXXX|-X-XX--XXX-XXXXXXXXXXXXXXXX---XXX-|-XXXXX-XXXX-XXXXXX-XXXXXXX-X|XXXXXXXXXXXX-XXX--X--XXXX-XX||-
