-B---------?-X---To-----oT--T--------------B------|---------M-----------------o------------?------M-B--------------------E--------------o-B--------------------B---B-oB------o-----?------B----?|o------
-----------o---B--T---M---B---------B---------E--------------------B-E-------------------T----------------Bo----B-----B----o--X------------E---------------B------------------------------------B-------
-------o---T-------E-----B---o-?-|-|--T-------------------X|---B-?----B----oT-----------?------TM-----B--------E------------------E---------B-B---------?---T----o---------|-----------B---o----------o|
-o-----------M-B---M-X------o-------?---------M----?T-----------B-----T---------------M--T---------?------------X-------------------------oE----?-o------------oo-E-X-?X-B------------------------------
------o-------------?--------o--------B-----?--MX----T-M----o--------X-----E----------B----------------B--------------B-X--------?M----oE-----B-----EE-o-----o---E-------B------------|-X-------------E-
--o--T-------------X-B-----------T--?--E?----------------E--------E-----o--------------B-----M---?--------T------------o----------M----o----B-----------Bo|-------------------E-----------?--T--B----o-M
--------E-B---------------o-----------E-----------------M---?o--X--------------?--T---------?--?-----------T-E----ToT-----M-TT-----?------M---------------E----?----|--------B---------------E----------
-----B--o----?-----M---|--------?------o?------|-E-------B------------------B?-------------?--------------E--B------?----------E----XX-----|--?--------?o-o----|-?--B---------------X-o---?---------?--v
--------o---B-E-----------------------?----o------B------------M-------------E---M------?----M?|---------------X-----------------o----------?----T--M--------E--B------?---------M---E--M------T------B-
---------------------B---X-----------T---------B-----------?-----------------B------o---o------?o----------------B----B----o-------------T----M------?-----------------|-|----------------E---?-----X-BB
-------o-B-----------M-E|------o--?----o-----B-----?-------B--MXoo-B------------E--------|-----o---E----------------B------------------------?--------------o-E------ETo----B-?E--o----------------o----
-?--X-----------E------------------------T--------------o--------?------------T--B---------E--------?--T---?-------E-----?---o-o--o----oE-o---------?---o--------?----B------o---------o----------------
-----?---B-------------B-|--------?------o-------------------B--------B------B--E----?---B--------M-?--o-----------o-o------------X---M-----------T----o---------B---------M?---------o--?-|T----M------
B--?o------------?---E|------o----------o---E--------B-----E------------------------------o-----E----------M----o------------X-----------o---E----o??---oE-----------------------X-------------?--X-----
m----------T-T------E----T-?--------o----?-------M---------T----E?--------B-?o-X----B--EE---------M---|--?-?---------M------------------E----------------------------------------o-------TM-|-M?--E---o?
XXXXXXXXXXXXXXXXXXXXXXXXXXXXXXXXXXXXXXXXXXXXXXXXXXXXXXXXXXXXXXXXXXXXXXXXXXXXXXXXXXXXXXXXXXXXXXXXXXXXXXXXXXXXXXXXXXXXXXXXXXXXXXXXXXXXXXXXXXXXXXXXXXXXXXXXXXXXXXXXXXXXXXXXXXXXXXXXXXXXXXXXXXXXXXXXXXXXXXXX
