--B---o------------------------------------------T---------------------------o----------T------------------B------------T----B---B-------------B--o---------B-------------X-oT----B--------B--E---------
---------------E-B----TE-----E---------TE-o----B--E--?-o----------------------------------Bo-------B----B-o--B-----B-o----------------To----X---E-XM--------------T-----E--------?B-------------|-------
------E---------------B-------Bo--------o------X-----E--Bo---?--M--B---E----XE-M-------B--------ET---B------o-----E------------------?----------------?---------X----------o---M-------|-----E----------
-----E-o--X?-------------------------B----E----|E--?-----------oT----B---------?-----B----E--B-----T--------B----------------M----E------?-----------------EE-------?----------B-B--B-----o-------o-----
--T--------------------E--E-B-|-------------------M-----------B--o----E-------?--M-----X------------X--------------oE--E-o---X---B-----------o----E--------------XX----o----B--o-----------T-------T----
-------X---?-|B----------------|-------------------BB--o------o--o---------o---M---o------X--------?------------o------------M-----?---------B--------E------o------XoX-----------?------------?--------
-oo----|----------E-----?----------Bo---B--E------ET-o---B-|--T----------------B--|BX--B-B------o--------------------o--------------X---------o-o---E-B--?B----------X-----X--------?E-----o--Mo--------
-M------|---------------E----oo---------B------o-----B------------?---|-----|---------T---B--------|--------T---B--------------E--M--?----------B-----------------------B--------------------?---------v
-------------T--E------X-------T|-----------------------?----------BT---------B-E-------------------?----?--oE----T--B---B-----E-------------------o------------?-------------------?--------|--------B-
--------B-B---X--o----B?----X--------E------o----|---B-----B-------B?-?oEo----o---------------------BX--T---o|o-T-|-----------o--??-EE----?--------?-BE-----------------------?---B------?B----?-E------
--|----B---|------o----o-----B------------X-------|-o---|-------------------------B---------o?-|-X--o---B---B-?-o------o------B---B--?---?-----o--o-------------------o-----------E-o--o-----?-----XE--X
o--------------B-----------------o-----B------?-o----?---------|?--o--------E----------------------o--------o---XM?----o--o----------o-----------o?-E------B-------------BB|------To-|B------o----------
---E|----------E----o--B-----?--o--o-?-----------?----------------------B------B----M-----------------?E----|-M-----o--------------o----BE-X---------------o-B-----T-XB-T------?-----------?-----X------
-|?B---o-------B--o---------oX-o---M--------o-----B----------B----B--------?-----M------------------------------?-?--?-----B-----B?-----------------X--------o-------E--------E------------------o------
m----------E------T---|------------------T----B-----|----------------------------------E--------------B------XT--------------------E-------o--?---o---?E---o---M-o------o---o------X---------T----------
-----E----------B-----------------------B---|---------E----EE--------E-o?--|---T--------?---E---------?E-----E-------?-E---------E--E--------T-|E|------------X----X?-B-----B|--------------M-------E---
