---o---X-------BM---?oM------------E---o--X------------B----------MB--X-----o---------------------------------------------------------oB---------BB-----------------------E--o--------oXo------------M--
------BX-XM------BXM-----------X-oB-----------------B---------------------------?----B-----------BBBBBX-------------------------------------------o-XMB?XB---------------BXXX-------------BBBXX------XB-
---oo?--MMMB----------B-B-----BB-BX-----M---------------BBB?------X-BBXXXBB----------BB-BB-----------B-B--------------------?BB--------B--B------BB--------o-------------?B--MM?oX------?BBB------------
---------M-------------BM----oXX----------BB?-------X-----X--------------X-----XMB-X?----------------X------BBBB-Xo---------BX----oB------------X------BB-------------------X-----EB?--------------XB---
B-X-----------------------B---------------B----------o---XB---X------X----------------X--------------------------?--------------------o----------------oX-BM-MXX----------BX---X--------------XX-----o-o
---XB-XB------BBXB---X?B---BB-------BX?--------------BBX-----------BBBB?-X-BBX---------EBX---?---------------X-BB---------X--------BXM-------BMMB------------XXM-------------------XB-oB------MBBBBBB---
-B----------XB---------------X------?-------o-----BX-B--B--------------X------oX---XMMB-------------B-----B----E---------------o------------XBX------------------XX-----X-------------oo-------B--------
X--XXX?----------?---------??--XX-X---?---------------?-o----------X--------o----XB------o--------X----X---------------------------X--------XBMBB---------------B-------------------------BB-----------v
-------------X?---------E?--------------?oX-------o---------------------o-----------------X------------E--oB----M-----?------o-----E-------X----M---------------------X----------------X---------------f
X?o------B-------------?-----------o-----?--XX-B-----X------M-------------------------------------X-----M?B------B------EM------------BBBB------M?---------------B--------------X-----------B----------f
----------------XMM-----------------?B-----o----------------B------------------------------M--------------MX----B----------------MX------------------------BBB--------??-BB-----M-MM--------M----------f
-------?-----------------------B---B-M-MXBB-------BBBXB---------------------oB-BBB-----------B--------B-B--X---X--------------------------?X--EB------------X---------------------------?M---B---XB----f
--------BX---B---------------B------------------o-------?--?--BXXM-------E---BMX-------BBB----------------BBBXB-X-M----------------o-------------X--------MBB---B-XB------------------------B----------f
-----BB-----?------------------------B-MM--------------------XX-------------------------------------X-?---------------------X----BB---B----oBX??X---------B---?-------B--??XB---------?-----XB---------f
m--------?BXBB??M---BB---------?--?-----------M----??M--------B-B?BX?X------------------------------XMBBBB------------BBBBBBX--BXM------?X---------------------------T---X--B---------o--X-MB?B--------X
XBEX-XX?X-B?---------------?BXXB-BX-------?--oB-----------M------------MB?B---X--------------------B?-B?-----------------------B--oXB---------B?M----------M---------X--------------MB------?oXXXB-----X
XX-XXXX||XXXXXX-XXXXXXX|XXX-XX-|X-XX-X-XX-XXXXXXXX-|XXXXX-XX--XXX--XXXXXXXXXXXX-XXXX-XX-XXXXXXXXXXXXXXX-X-XXXXX-XXXXXXXXXXXXX-X-XXXXXXX-XXXXX-XX|XXXXX||XXXXXXXXXXXXXXXX|XX|X-X|XX-XXXX--XXXXXXX|XXXXX-X
