---BB-------X------B---X-----------------------------B--o---------------------B---XBB-XB-X-X---?B-----------------M--------B??X----o--?----------ooX--o----------B-------------BX---X--------------X----
-----X----------oX----BX?---X--BBX---------X--------------------XB---------------------XB-----?M--o-?o----MX-------------------?B------BB?BX--XM---------X---BM----------MB-----------------MB---B-----M
--X-------------XX-------------------------------------B----o------o-------X----------------------------------MoE--o--------X--o------B-------------B--?XBBMB--------------B------oX---M----------------
---------XX--------------E-XX------------------------B--------------------------------B---BX-XXB---BMB--BX--MBBB------------------------o--------o---Bo-------------o?B-----M------------MX?XB-------B--
-------------------------BMXXX?-XB----BX?B?X--------BXXM----XB--B-----------------BB--B---M?B--X-----------X-----XB--Xo----?----XBBB--------B----------------?XXB------B--------------XBB---------------
------B--------XB--------X--------?----BM------------M?------B--B----------B--------------------MX-XM--?-----------B?-X---------------M-----------B---------MX------?---------M--X-X----?----E--B--XBX--
--------oB-MB-----oBB?--BX----B-------X?-----o?X----------B--X--MX-----B-BXB---XX--oMXBBX-------------BXB-MB-----??---XB?-?B---------------B-------XMM-------------EBM--------------------BX-M----?-----
B----------------BB-----------------------------------M-------------X-------------------X---------X--?----X------E------------------------B-----B---o--------------o-?-o---------o------o----------X?--v
----------B------M---------------------------B-----XMBXB-----BB------------------------------------?-B-oB--------?-oB?B--X----------------------------o--------X-------------X-----XXBBB--------------Xf
------------------X?--X-------------------X----XB---------------BB?---BBB------------MBB-------------XB--------------------------------------------------------?--------------------B---------B?-------f
---------B?----XBX---------o??--EBBBE--------------?--------------------------------XB-------o?B--B-------------EB-B?B---------------------------X-----?XXB-----------------B-----?-X-?---M---o-------of
-------X-oX-B-------------------B-----------------------XM----B-------?B-B-----------------------------------M----o-----X---------------X---------?------Mo-----BB--?----B-B-----------B---o-----------f
------------BX---------------------M?----------------------------------XX----XX------B-B-------------B-------XXBXBBXX------XBB-X---BBM--------------?XX-----------------o?--o--------X--XBBBB-----X?--Bf
-----B--XX------------------------XBBB---------------------MX---------X?X------------------XBB-------------?X----------XB----XX?----oMX---XBBX----BBB----------------------------?M-----------XBM-B-XBBf
m------o---T---------------------------------o----------------------E-----B----------XB-------------?-------------------------T-----------oBM----------X-X--EM----------XB--------BX-----oB------------X
X-M--------|---XBB------------B-----------B---X-?X--------B?BM?B-------------------------------B------M----E------------------B-B?XM-------------------------M----XX----------B--------B?--------------X
XX|XXXXXXXXXXXXXXXXX---XXXXXXXXXXXX-XXXX-X|XXXXXXX-X|XXXX-XX-XXXXXXXXX--XXX-XXX|XXXXX---XXX|XXXX-X-X-XXXXXXXXXXXXXXXXXXXXXXXXXXXX-XXXX-X-XXXXXXXXXXXXXXXXXXX-XXXXX|XX-XXXXXXX||-|XX-XXXX-X-XXXXXXXXXX--X
