----------oXX-E------X--------------X---X--B---------XXX-X-XB--XX---X-------XX-X---o---o---?-B----------------o---X----------Xo------------EX-X?-?E-B--B-----------X-E-------XMB-----------------E-o----
X---X-T-X---B---XX-B-Eo------------X--E---------Xo-----X------o-----X-------X-------M---------X----X--X-X-X-----------B------B---B---------X-?-----X-----B--------XX-----E----X---X---BM?-------X--?----
---X--|----------X------XX-------X-----B-?------X-------EX-M----E---------X--X---E-B-B---X--XE-X--BX--XXBoXXX--X-----E--o--------X-----E-X---X-----E-EX----EB--M---------?--X-B-?-E----------X---EX-B---
--BoB-|B-X-X----?-?B-X-----------o--------X--X------o--------------X--B--M-----XB?------X-----X----M---o------------X--------X---------o---XXX------------B--M--X-------B-X------o-----XX--?X-X-------M-
-----X|---------XX----o---------------X-?------oo-----B-X----X-X-----o--o---X--o-------E------------XX-----X--o---Xo-----oBX-??---M--X-B?X-X---X-----?B-X--B----X----E------E-E--------X----X-----X--?oX
X-X--X|-X---E---?---?--X---------X------X--M---X-E--X-----------XoX---X--B----o-M?E-----XXE-?X-E--------------XB-------X-----X-------?----------X-------o----X-------?-o-------X----oX-----X----?----X--
-M----|---X-o-E----------X------X--M-M----XX------X----------XX------BX-o---------B--------B--------------------X-o-----oo-X-o--B---------------------------?X----X-X-------o----?--------M--------X----
------|--X---X--X-?-E---------o---BX--o---Xo---X------B--?-o---X--------E---M----XX----X-o--o-----X-X---------B-?-?-----------------oo--?X-X-----------------------B-X------?----?-X-X-------X-o----X--v
---?--|--o------X---?-X---------oMo--B--X-------------BB-------X-oEX----------------E----?o-----M--X-M----XM-------E----o------------XE-----o------X--X-------B----?------B--o----------?X-o--X--?-?---o
X-----|--M--oBX----X--B-X-o--Xo---X----------X----------o-X-o---------o------M-------o-B-X-o------oX?---o-BXX--?--M-----------B-B----X----X-X-------X-X----oE---X------X-B----E---X-X--------X---oX-X-X-
---X--|------o---o-B----XX-------------------B-B?-X-------E---X---------X--B---XX---X----?X-----E----oX--X------MX-o---X--X-------XoX--E-X-----o-o------X-X---M---?-------------XX---o-?o---B--X--------
--X--?|-X-oX-X----------XX-B--E---?E-oX-----X-o------M--X-o----X------XB-------X?--X-----o----M-X----X---------------B--------X-E---------?-------X-?X--B----X--?---o--MX-X-X--X-------o-------o------EX
------|--To--B---o-----------B--oX-X--XX----X-X---------E-X-------------Bo--------------------o-?B----BX-XX-Bo---B------------M--M-----?--E-?----X---oX-------X------X?---------------B-------B-X-------
------|--|-------T-X-o--X---o--------------o-T------X-XX---T-----E-o-BB-----X-------o---B-X-E-----oo-X----X----X-----XB-X-------X------B-o-------X------X------o------X---E---T-?-X----o-?T-X---M-XM----
m?----|--|-------|------o-----------o---X-XX-|X----B-----X-|--X-------X-B------o--B-?B-----X-o-E-X--B----B----B-o-EXE-------o------XX------X-X-----X--o-----X-BX--?----X------|X------o---|E---X------BE
XXXXXXXXXXXXXXXXXXXXXXXXXXXXXXXXXXXXXXXXXXXXXXXXXXXXXXXXXXXXXXXXXXXXXXXXXXXXXXXXXXXXXXXXXXXXXXXXXXXXXXXXXXXXXXXXXXXXXXXXXXXXXXXXXXXXXXXXXXXXXXXXXXXXXXXXXXXXXXXXXXXXXXXXXXXXXXXXXXXXXXXXXXXXXXXXXXXXXXXX
