------------------B---MX--------------BBB?BB---BB------------------o----------BBX---M-BBB---------------------oBB---------Bo--------X--X---BB--------------------BX----X?X--?MX--------------------B----
----------XX--XX-----MB--B?B?-------------------------------------------XX---------------BB--B-XX-X----XB--------------?B-XBX--------------------XXB----B---------oXB?X?-------------XBBX?XBBX-------o--
E-----X--MX-o-------BXB------------------------------------------E-X-----------------------------------------------------o---X-------------------------------------X-oB-------BBBB--------------?BX-----
BX----MX----------MB---X-------------------X--B-------XXB---XX-X--M--------XB?-------B?-----------?B?------X------------------MMB??XBMBX-----------------------M------------BB----oB---------------XXXX-
---------------?B--BBBXX----MXM?--------o---------------------------------?--------------------MM---------B-------?--MB--------oBBM--------------X?----XXXB-?-BBX?---o--------------BMX?BMM-------------
--------X---BBXXXM--X-B?BB-----------XX?XXXXB-B?BBX?----------B?B---BBB------?XB--------------------------------X---B---XBBXB-------------B---------BM--o-------------------------Bo--XBXM--------------
----------?--------XB--?----------B------------------------XXX---------o-------------XB-------MB--B-------------------------B---------------------M--o---------??-----------------------X-XB--------?---
BB?-----------B------------X----------------X------XBXB-----B----------------------o-----BB-----BBMMBX----------BB---XB--------XB----B--------------------------------------------?XB-----MBM--?XX-----v
-------MBB--------MXBXMX?M----XXMX--oX-------X--X-B------M-B-------------------BB--------XBX-----------X----M--?--------X-BBX---Bo-----------M?---BBBBBXX-XXBB?----------X-----------------------------f
----------X---------------------------------------------BB--------BX---BBBBXB-----------------B?MB------------XBXX---------------------------?B---------B?---X-B?B---?B----------------EXM?------------f
-----B-BBB-BBBMXB--BBX---------------------------------B---------------------BBB--------------------------B--------------XXBX--XBX--------------XXX----oX-BX--------------?---XX---X----------------M--f
-------------------o-B--BX-----------BX-----BB?M----------------------X---------oXM-----------XMBB---------B---X-XBB-------ooX---MB---------XX---------------B----------BBB----------X-----------------f
-------B----------------BX------XBBXBX--MX-------------XBX---------X--------?BB---B----XX---X?M------BMB--------------------------------XBBX-----------?----B----------------XXB--------BBB-----?------f
--------XBM---------B---BB--------BX-BB----o---------------XB-X----MMB-BBB------------BB---MXXBX------M?X----X-X---B-X?-----XXBBX-----------------------------------------------?B?X---------B?X-------f
m--------BX--X?------MB?--B---------------BB------------MBBBX--------------XB-?-----------?MB-X----------------?-----o--?XXB?--------MXB--?BB?---X-----------------------------------?M-------------B--X
B---X----------------------------BB-------B---M---MBXB---MXM-----------------X-------------------------------------X----------M--------------------BB------o--BB??B-----MX--X--------------MXXX-oXX----X
XXXXX-X-X--XXXXX--XXXXXX-XX-X|XX-XXX-XXXXX-XXXXXXX-XX|XXXXXXXXXXXXXX|--XXXXXXXXX-XX-XXXXX--XXXX--XXXXXXX|-X-XX--XXX-XXXXXXXXXXXXXXXX---XXX-|-XXXXX-XXXX-XXXXXX-XXXXXXX-X|XXXXXXXXXXXX-XXX--X--XXXX-XX||-
