--XE---------------?--------M-----XXXoB-BBMX-X--B-------------B------B--------BBX-----MoBX----------BoX-------MBXB-X----------X-?MM-------------BBBBB-----BBBB-------XB-----------------------B-BBBX----
---o--E?------?-X---B--------------------M---------?-----BX-------XM---?--------B---------------XB------------o?X-o--BB-BM?B---------E-------B-------M--M------?B------o---------MXX-o---BB-XBXXMB------
-----------------BB--------XX------------------------o?---------------X-BXXB-------B--------B----BB-----oBBB-----------B--XBM---------BX?M------B---------------X-?X---M--------------EBB------XB-------
--B------------BBBBB----------------------------B--------------------BM?----BBX------------?XXXM---------------BBB---BMBBB----MXoMXXBB------------MXXB?---X--------XXX?------BX---BB--------o-----X--?--
X-------------BX-------XB------MXBB-------oX----------XXXXB-----------B-------B-X---BXBB---------------oB---MB---X-----XM-X?B--E-------------------------X-MMXM--o?----MX---?----------------XX--------E
--------------BMBXBXX----------------MBBB-------------------------BBB?B--------M-B--BM-BXXo-----------EBB-----BB-------------------?BBB-X---BB------------------B---XX------BBMX-XX--------------------X
--?B?--XB----X----M------BBBB-------------BXX--E?oX------------------oMX----X--------BX----------?B-------------------BX----M-----------------------------------------X------XXX------XXXX---MB?BB?X-X--
-------------------X-------------------o--------?----?--E-----------------MB?-----------o----------------------------?----------B??BB--XX?---------------BXBBX?BXXX?X------M---------------BB----BB----v
----------X-----------X------BB------------------------------------X?BoXXBBB-------------?B----------o--XXXXXX-----EB--X-B-------EB--------BX------B--------M---------B-X?B-E--------------XB-----BX---f
?-----------------------------------------------XMB?-------------X------------------BMXBBMM--?------------?BB?B-------------XM??---------------------------------MBB-----------------------X-----------f
--------------------------------------------------------B-------XX-X---------?--B?B------B--------MX-------BB------BE-------------B---X-XB?-B--------------------------------------------X?X-----------f
--------------------------M------B-----B------o------XX----------X---------------------------XXBBB--MBB---X---X----------o?----------------------XX?------------B----B?-BM-----???BMBBB------------B--Bf
--------------------M-X----------M-XMXB------------------------------XXoXB------------------BMM------XX--------------MB----?MMMBX--o---------------------XM?-----------------o?-----BX-MBXXBB?----oB--Bf
-----------------------------------B?------X-------oM-----XB---------------------------------M--EM---------E----oB-----XX-------------M----------------------------B----XX-----------------------------f
m--------T----------XX----B-----------------o-------------------------M-XB--------M--XoB--------X-XXXX-TBB---T--------M--XXBB------T----------------------T---XB---?---????o------------------MXX-BXB?BX
X-B?B--BX|--MX--oXX---------------------------------------------BB??X-BB-----------X------------?B??---X-----XX-B-BX---BBB------?-------T?--------------MBB?-----M-MM--BBXBMBXB?B----BBM--X-oX-------BBX
XX-X-X||----XXX---XXX-X||XX-XXX-XXX-X-|X|-XXXXXXXXXXXXXXX-X-X|XXXXXXXX-|X--X-XXXX--X|X---XX--X|X|-X--XXXXXXXX-XXXXX---XX-XXXXX||XXXX--X-XXXXXXX--XX-X|XXXXX-|XXX-XX-XXXXXXXX-XXXXXXXXX-XXXXXXXX-X-XXXX|X
