------M-To---o--E---oX-X----------B-----T-B-----B--B--B-----------oX--M-----o--o--------o-T--|-M--T----------T--oEoX---oX-X-XX----o-X----X------XX----X----T-----o----B-E--------X-----------------BE---
---X-oT--o---o--?---B-X-------B--E---X-----B--XB---?----X----B------------oo---B----X----E--XXX---------X--X--o-X-------------E-----------------E----B----o-------o-X-------?-B----o-X---------EX---X---
----o-|M-----?--EoXXX--o-----------X-------X----o-----B--?--E-o----?---------EX-------X---B-----oX--E--E---------E----M------X--B-o---?--o-----TX-----X---------T--------o------------T-oX-----?---Xo-X-
-Mo-B-|----?----X-B-----B-E----T-B--X-o------?Xo-------X--M--B-----X---X-------XX-----MXX----B-X-----X-------B-------oTM--M-X-o------------o-X--B------X--XX---B--XM--?M------MEE---X--X--X-------o--?--
X----o|E-X-----B----------E-XT---X?o---------TT----B----BXEE-X---MXX?----oX--B-----Xo--?-XB?-T--XX---B---X---X?-B----?-----X-------o------?-Eo-M--------------oX-T---X---XX------E--Bo--------X---------
-----T|---------------X--M--------BXB-X----E--------X---X---B------X---Xo--------X--BX--B-------X-B-X-------B---X-------X-T----------M--------X-X----X-B--X---B------?B-------o-X----X-----------------B
------|---o-----oE-----M----B---X---B-o--------E------------?----B------T----X--------------M-------o-----o------------X---o--X-XXXBoE--?--o-oBXo--X-o---XX----------X-T-o-X---------------?-------X----
-XT-XB|--------X---o-X-----B------X------------X---X-?E----o------o-X------Xo-X--------o-E------X-EX----o---T--E-------X-o-----X----X----X?--------M--X---X-----X-X---------B-----XX--------E-XE---X-X-v
-----X|-X-BT-o-XB--o--o-------?-----X-------------X-------X--o-?-------oX-------X-X-------------oEX----oX------Mo---------------T------X---B--TX----B?------X-X---------X----o-?---oo------------TXX---T
--X--X|----------X--X-----E---o--o-o-B----X----B---X-----oT----------------?---?---o---------------X------------------XX-----EXo-B--B------X-------TX--M--X------------------o------B----X-----o---XX---
--X---|BX--Eo-o-------E-X--T--------X-X-Bo-o--E--?---X------X----X----oXEX---BEo---------X-E---X-oX---XX---o-------M--o--?X---?---oXX---BX-XX-B??-X-o-------o--X----------------o----------E-------?o---
--Bo--|----XX--------MX-X--------M----XoX-----o----M-BX--X--------------T--B--o?XXo-XX-----E--------o--X-----B---T---M----------------B--XX--------B-X-X----X----?-X---------o---?----Xo-XT---X-T--B----
------|--T---T--XX--Xo-X--?--X---o----------E--o-----B-o?-X-M-M-M--?--B-------------XX-B-E--X-------X---X--o--?--------M--------E--?-X----?----T?-----B---B----------X-XX---X-X?------?--X-B--X----o----
X-----|Xo|----------X--X-X---?X--------B---o---X------------X-XX--T---XM----------X---B---X---X---Bo-TM------XE-----o----XX---E--o-oB---------------XBM-o--B----XX--o---------X--------X---XM-X---------
mo----|X-|--X--------o?-------------XXXX----?M-TX-----X---B--?----|-X--XM-----o-------B--------------T--M------X---M---------M-BXo--E-----------------------X---X-oB---------oX----BE--------B-X-BB----X
XXXXXXXXXXXXXXXXXXXXXXXXXXXXXXXXXXXXXXXXXXXXXXXXXXXXXXXXXXXXXXXXXXXXXXXXXXXXXXXXXXXXXXXXXXXXXXXXXXXXXXXXXXXXXXXXXXXXXXXXXXXXXXXXXXXXXXXXXXXXXXXXXXXXXXXXXXXXXXXXXXXXXXXXXXXXXXXXXXXXXXXXXXXXXXXXXXXXXXXX
