-Xo------Bo?---X-------------X--M----X-XE-----o-----XX-E-?o-X------------X---B---X-?--B-X-------XX------o------X-X----------o--B-------XX---Xo-X---E-E--M-o---oE-o----XE-B-Bo-X-------Bo--------X-Moo?--
X--o--TE---o-------o-B-----X-o---XE-Xo---------X-------X-----E-XXo-----oX-X------X-B------?------------------X-o------?-------------X---X--|-XX-----X--E--------o-oX------------XBo-T---------X---E-B--?
-----X|-o------X---X---B--XX------X-o--X-X-------X----E---BX-X-------------E------X-X--?-----------B---X--|---X--|--------E-X-o-------XB-o-X---X---Mo--------X-X-----XB---X----M--M-|-----?--------B-X--
-X----|-E--?--o--EBXE--X-X--X-?-M------Mo---X----X-X---------B-oX------oX----XX---E--B--X-?----o--E-------XE-E-XXXE-M-X-BoX-X?---X-EoB-BE-----------------o-o-B----------M?----o----|X--E-----XB-?-o-X--
------|--X-X--M-o-X-X---X-X---X----X--XoMX-X----X--o-------XX--BX-X--?---------?----X---XX---------------?--------E-X---------------Xo--X-X---Xo-------------X-XB-XX--?-----?---o---|-----------?--?---X
------|--XE-----X--------B-----Xo---B----oX--E-------E----------X----------o-X----------oXBX------------MX--------------B-XX-X?---------------------oX------B----X?------XB----EX---|-B---X-----E-----M-
----X-|E-------------?---X-oX-------------oXE-o---X-----X-----------M-----------?--o-X-------X--XX--X--M--o--EB----X-E--o---------B----B---------B----X--X-------------X---B----oo--|---B---------o-M---
------|-o--X-------X-X---X-----X--X--------M--XB------X------?-------?-----------------B-----?-?X----o-----M-X-------?----X----X----oX?E--o-M-?-X------X------------X-E--o---M--M---|---?--oXX----oX---v
X-----|o---X-X----o-----XX--X-------X----E--X-o-XB----E-M--o----------X------B-------X--------------XE------------?-------M-----------XXo--?---X-B----X---------X------------------?|o------?XB-----B-o-
--X---|--X-X--------X---X-EXE-------M----E-X---o--M----X-X------------o--------X--------X--------X-----M-XoBB-?--XM--------?-?------o-BX--X--Xo--------X-o----?-XE------EX-X---M--X-|--E---o-----X------
?-----|------XEX----X---E--X-MX-----?-----X-------?-------------?-o-X------M------X-----X--M?-M---E------------X-Xo-E--------------X---------B--BX--Bo-B--B------B-----BXE------?---|--oX-----X-XX------
--X---|-XB------o-XX----XX--E----------oX-E------EX-X-E------B----o---------XXo----X-?-X-----M--?--------X------X-X-?|-?--oM---oB---o-----o-X----BMB-E-E---------X-----X--oEB-------|------XB-o--X-X--X-
----B-|oo--o--E----B---------X---X-X----------B----X--?--X--XoB---------X------------------B--X---M-B---o--------X-o-XB---X-M--B------o------X--|--B------?XX-------X--X-----B------|-----------------X-
------|-?--M---------o---X--------X---------o-X-o----EXX-----XM-X---X----------B--EB----?---E--X---o-o-----XX--Eo----------X-----o-----X-----X--X--X------------X---X---X-B--o------|-------------------
m-M-X-|X-------X-EXX---B--|--EB-----------------oX---BX---E-E--X--------X?B--M---------X----?-X-----o-------X---X---BEEB------B|---------X---o----X-o-?--------Xo-------o----E--o-B-|--oX-------E--?----
XXXXXXXXXXXXXXXXXXXXXXXXXXXXXXXXXXXXXXXXXXXXXXXXXXXXXXXXXXXXXXXXXXXXXXXXXXXXXXXXXXXXXXXXXXXXXXXXXXXXXXXXXXXXXXXXXXXXXXXXXXXXXXXXXXXXXXXXXXXXXXXXXXXXXXXXXXXXXXXXXXXXXXXXXXXXXXXXXXXXXXXXXXXXXXXXXXXXXXXX
