?---B----E-----X------o|BX-B--------o-------E----EXX-----oX-?----E-----|----B---X--------------B-oXX??E---X---X-------?M-----E-----B--oBMX-----o------X--------oB----XX-------o-B--o--------oEo----o----
----o----XX---X--o-------E---X-----------E-B--E-X------B|B-X-----X-X----------X--?----------X---------X-XX?X-------X?-|--X-o--o---B--------X-----------X-------E-----X---E---E-X--XoTX?-----------------
---------o-o-----------B-XX-----------E---XXEX------E------B----------?---|--------X-------------XoB-B-X----o-|-----E-------X----------X-B-------XB-----o--o--B-o------B---E------BM|?--------o-MX------
E-X----X------|----X--M---X---------o-------------------------o--o-----X---BEX---o?----B-E--X--X--------B---o--B-----X---------B---o----------Eo?--o-o-------------?--X-X------X----|X---X-oo-----------
o-X--X---------B--o--X-?MX--o-?----------X-----X--?-M-----X----X---------X------X-B----X-------------------E---X-------X----E---?----X----B|-?--B-B--E------XB--X-XX---?------X-o-E-|-------o-X-----o---
----------E---X---XE--X--|-----?---o--X---E-------B-?---------B------XX----X-o---X----B--M--o----oXX-X----|---B--o--------X--X-?------X-o-X?-----------------X---------X---M-----E-B|B-XM-------o---?B-X
--o----X-XB----BX-B?------o--X--o----o-X-E---------X-?-X-BXX---X---ooB--X------------------------M-X--------|---X----X--B--------XXX-X----o------oE--------------?--X--------E--o---|------X?-----------
X--------------|--MX----B---EX-X------M------X-X---|----B---B---------X----X---------M------------?---------X----M?---------X-E-o---?-MB|-X---------------X----M-X--|----XB------X--|Xoo---XoX-X-?-----v
--X--o-XB----E--X?-?X--oB---X----B--------X-----------BX------o------X---------X---X-------X--|--M---X------?-----o-?------X--X---X----X---?--E---X---X---?----?----oB-X-----------E|---|--|E-X---E-----
BB----------X-------o-----------E---X-X-B---?---?X----------EX-------X-oE-----X----X----o-o--------EX---X-B-X-o----|M-|----oX|--B----|-B-M------o-oX-----oB------X---Xo---o---------|-XMB-X--X---B--o-X-
-----B----B-X?--XM--E----X----X--B------X---?----X--B-oo--EX---|--B-X---E--------BX------------E---o------XXX-B-o---------------X---o-X--o----X------X------E---X---|-----o-o---XX-?|-----------E---M?X-
----X---X-------B---------|----------------X--oE-o-X---X-E-|---X-------oXX-o-----B-oXX------X-X---XE---------BX---X--------X--E--?X---|-----o-?o-B---o-oo---X--X--------------B----X|------XME---X--o---
|---------o------X-X-------?-?---BB----M------o-?X---B-------|X-B--o-------------X-|?|--------oB------XE?o-E------B-------X-o---X--?-----X----o-----------B-------------Xo--------o-|-M------o?-X-------
--EX-------Xo--o---B?-X---------MB-X---X-X?---XXBB--|-X--|----------E----------o-----B----X--?----XX--XB---X---X---X-------------Xo---X-XE-X-------X---o-X-Mo--------E-X---o--------|-?------------B--B-
m---E-|--------------------M--?X-----------E-o--------oX-?----X----------X---o---------o--X---o-M-X-----o----XM-X---X-----X------oBoEoM-XB-X---------?--M------o-X-B---o------X---M-|--X-X---------B----
XXXXXXXXXXXXXXXXXXXXXXXXXXXXXXXXXXXXXXXXXXXXXXXXXXXXXXXXXXXXXXXXXXXXXXXXXXXXXXXXXXXXXXXXXXXXXXXXXXXXXXXXXXXXXXXXXXXXXXXXXXXXXXXXXXXXXXXXXXXXXXXXXXXXXXXXXXXXXXXXXXXXXXXXXXXXXXXXXXXXXXXXXXXXXXXXXXXXXXXX
