-----BB?--?B----------EBX-------oEXE-XXB-----XTT--------XB-------?--------------MBB-----MB--E---B------M--------------?----X?M------oB-----------------------X-----|------B----M--------X---------------
----------------------oB----X------------X-----B-E-------T------T-?-------MBX-------------------------M-------X--?X-----B-B--------TX-------X--M----------?----------XBT-------M-EoB-MBX----------------
-------------------?-E-----T----o----oo---B-----------X--X----------------------------oM-?-----------E-----o-------o---oX---------------------?-----T?----------M--M---B---------X--------E-----BXo-----
-?-------B-----------------B?BX-------------o----------XX---------M---B-------------------------??-------M--------------o--------B??---------------o----B-------------------B-------X-------B------XX---
-------B-----T----XB-E--------M---TXB------TX------oBBB----------------XX-T------T--T-----???--TX?----------B--------------?----X----MM-B----X--------B----------------oM--------------------T----o---M-
---BB-------B|--XB--M-----o-------|B-------|--------X?-----------T---XET--|---?-----X--------------B-------X---EB------B-T-------BBX--M-----?BB----Bo-oM-----------------------------------MXX----------
---EXE-X---M---------?-----o----T------------T-E?----------M-----X-----|BXX-------BM------------Mo------X?---------------X---------------------M------T---------M-------T----B---------T----------------
----M-----TX--------------------|XB---------XX-X------TX-------------TM------oB-o-MX--?XE-----------------XMM--M-----EX-----------------------MB------M-----------------|--oX-----XXX--|BBX-----E-M----v
-----------XMB-XX------------BB-o-MBB----------------M-oX-------------B------oBB----BB-----------o--------------------------?X-----------B----B---------------------M-------------X?MB--X-------------Tf
--?MoXX-------------BB-M----------o-----------B-------------o-----------------B-----o-----X------o----------?o-----X---?------------T------------------XX------------------------E-B-----------------TBf
-----M??-BX------------------?-MMM-X------------?B-----X?B-----B??--B----------oX---------T---M-------------?XBB-------o-B----------|---oX-M--?-----------MMB??----------------------------------------f
-----M?-B?-----------------------E--------?-BB-B?-----------T-T------X---------T-------X----------oBX----------o-----E?-----o-----T---------------B---------------X------M--?B--MBEo---o--B---X--Xo--MTf
-------o-----B-----------B-------X----------o---------------T-X-B----------?---------MB------------X----B-----------------o---o-------X-----------B--------B----?-B-X------------------------------B---f
----------------------------B-----------------------M---------X-M----------------MBX--o-------X-B------------------------o--B----E-----B-------T------??--------------B------EBXo-----?BM--X--XB--BX---f
------E------------------BM--------------o------o--------------T-----EB---B------X?B-------oBB---BX-XX-X?B-----B----X?---B---------------------B---T------E----------------T---------------------------X
XB-----------------------------------X--E--------------XX---oBB?-X---------------?B--M-----T-------E---?----oMBX-----------------oX?---B--?-----------------------------M--|-----E------X---------o-?--X
XX-XXXXX-X-XXXXX-X|XXXXXXXX-XXXX|XXXXXXXXXXXXXXXXX-X-XXXXX-XX|XX|X|XXXXXXXX|XX--|XXXXXXX-XXX|-XXXXX---XXXXXXX-XXX---XXX--XXX-XXXXX-XXXXXX-XX|XXXXXXX-X--X|X-XXXXX-XXXXXXXXXXXXXX-XXXXXXX--XXXX--X-XXXX-X
