------o-X-X---X------XE-----------?-----X----E-o------X------EEB----X---X-----------?------Xo------M-----X--------?B-------E---B---B--B-------B-------EEB-ME-----------X---oB-----------o---X----o------
X-----T---X-X------B-----E------------------E----oB-----o-Xo-----------EXX?-o---------o---E--------------X---------------X----o----X---B--oB------B-B-X-o---------o--B-B----------o---------------------
-?o--X|--------------X-X------B----B----B----?----X-o------------------E---?-?----B--------------XX----o-------?------X--X------o-EXX--B---o--o---?------o--B-?----------------X---------X-----B----o---
-----?|X--------E--X--X-EXX--M-B-X-BE-?B-----B-----X--M-X---------X---X-X-o---X--o-------E-B------o-B-------X-o----X---M-X-X-X-o----X---------?-----?-X------oM-M--X---E?---B--X-X---E-Xo---?-----B-BE--
---X--|X-o--X----X--------X-X----------X------XBX-----o--X?--X--X------X-----o-------B-E-----XE----X---------------X--oX-----o-------o----X-------------oX----EX----o----XX------------------X-oB-------
-X---o|-----?-E---------X------o---X--oo---o---?X---------M---o-----o-M-X------oB-------B---M-----------E-------BB-o?-X---o--?---B-------------------EoBX-----B-X--?---X---X-----EX--o-----Xo-----o--XXX
-X----|---------------------X-B---------X--|--X-----E---BXM-B--------X------ME--------X---E------EXXB----X--------X-X----X---B-------X--o---M--?XE------o?-o-------------B----XoE-------Xo-------B-B---X
-X--M-|-oXX---E-X-----X----?--XX-----------XX----X-------?-----oX-------?---X------------X--------?E--E-o-----X--X-X-XBB--X-?-------------X--X-oXX-E-----X-----X------XX--XB----------E---o--------X---v
-----E|-B---X------------XX--X---B------o---E--X--X-----X?-----B----oo--------X---X------------X-----X------B------------o---X-----XE-E?----------X----X-oX-----EX--X-----X---o--X---?--X---X--------XX-
X---oX|-X--X-X---B---XX?-----oX-B----X---------XX--X--B--E--------------o---X-XX-M---B--X-X-E-----X-XX---o-B--X--o---oX-----XXX----o-------o--BB---X-BB--XXo--X-------X---------------------X--------X--
-o--XM|XX-----X----E-oX?----------------X---EX---------------EX------?--X-------X-o-o-------------?----------------X-X----Xo----------X--o----o----o-B------o--------------------M--X---------B--X----X-
X---X-|X-X-----------X-----?-X-X-o--X--?--B-B-X------------------------X---------B-------oM-----X----XX-----X------X--BXX---?-----X---B--X------X-------------X-E--E-----X-XM-----X-----X------XM---X-B-
------|--T----X--X-----------B--------------X--B-M-----X-------X---X---?-----------------?---XB-----------X---X------X-B-BM--?XX-o---oB-X------Xo--??--X-----M------------?----BoX------X----oE----X----
------|--|XB----X--X--------E---?-o-B--X-X--T---------B-------X---X-------E-------------B--------oo--X---------o?------T---------X--------E-X-------X----X-------o--BT--B----X-B----X-------X-----------
m--X--|--|-----?---X----------o------E-Mo-E-|----B?---oBE-X----------M------------X-------?M-----Xo------------o---BE--|-----X---X---oXXo--------X-X-X---X--o--o-----T-----X--X-B-----------------------
XXXX-XXXXXXXXXXXXXXXXXXXXXXXXXXXXXXXXXXXXXXXXXXXXXXXXXXXXXXXXXXXXXXXXXXXXXXXXXXXXXXXXXXXXXXXXXXXXXXXXXXXXXXXXXXXXXXXXXXXXXXXXXXX-XXXXXXXXXXXXXXXXXXXXXXXXXXXXXXXXXXXXXXXXXXXXXXXXXXXXXXXXXXXXXXXXXXXXXXX
