---MXT----o----X---XX-X-B--o----------X?X--|--T-------o-----------X----X--E--X-B--------E---------X-------X---------X--E------X-------?---?---------------E-X------------E--X--B--T--oo-?---X----X|XX---
X-?-E-Bo-T--?--o----M-o--X-------|-?-?X-?----Xo--X-X-X-------X---X-----BoX---X----X---X-------Bo----X--X---X----X----X----X--E-B----------X------------B------Xo-X--XX---EX---E----------TX--o-------X-o
oX---------------X----oXo---?oB--o---E-----X----------------M-----o--X---?X--o--E---X-XX----------X--X----B--T------E----|----X-------------------o--X--BX-----T---XXX-------XX--X---?-X-o-----X-oXoX---
----X------------------X-----E---------B|Xo---X--E-X-----------------T---|B-------B---X---X-----X?-------B---X---------------------o---B-?-X---o-----X------X|-?--------o-X-XX-X?Mo---BB----?--------T--
oXo-X-E------XXX---oB----XB--|-X----M----Xo------Mo----X--B--X-----------X----------------B-oE---?------------B-X-----?----B----------X-----X--X-X----X--EX---X-XB---o-X--E--Xo-------T-----B--o---X----
--------?----B------B-----X--XX--X-----o--------------M|-----B----o-----X------B-o---E-------------------X----X-E-XX-----o---------X----|o----TB-oo-----E-------|--X------------X--X-B----X---B-------XM
----BXX-|X---o---------T---X--------X-?o--X--X----X--------B-----E---B--XE----------------o---?-?-X--?X----X----EX----X----o----o--M----------X---?X--X-------X-B----X?--X--XX|-E------E---T----X----E--
---o-----Mo-------?---B-X-o|---?X-----ooX--------------|-|---------E-X------X-XoEB-B---X----E--X---BE------X---X-----------?-?XB--B---oXXX---o--?---X--X---------E-X--------X--------oB--X--o-------X--v
B--X------E----------X---X-o--XX--o-X-------M--|-B--E--------B-----XB-----------X-----------B-------------------o----B-E----X-X--B-----------B--E--B--XXo-------o--E-o-X-X?-X---X--|E-Mo--XXB-E--X--T---
X-----X---oT--------B--?-------o---------X-X-----------------X?o--------------E?B-o-o-XX------Xo-X-------?-XX?--------?-B--o-X-X---------B-------?--------?---|o---E-oX---B--X------|--X--X----o---M----
---B?X-X---X-----B---------X----o----X--X------------------o--X--?------T---E-X----X-X------X-----XE---BE-X---Bo-o-M-?---B--X-------M---B--o-?----------X---------o----M-BM---XX------X?-B--XX----------
XXXXXXXXXXXXXXXXXXXXXXXXXXXXXXXXXXXXXXXXXXXXXXXXXXXXXXXXXXXXXXXXXXXXXXXXXXXXXXXXXXXXXXXXXXXXXXXXXXXXXXXXXXXXXXXXXXXXXXXXXXXXXXXXXXXXXXXXXXXXXXXXXXXXXXXXXXXXXXXXXXXXXXXXXXXXXXXXXXXXXXXXXXXXXXXXXXXXXXXX
--X--oX-X-o?BXXX------XX-BXBB------oX-o---XX-----o------------X------o-?X-----XB--M-------X------------X---------X--ET--------X--BM--------oEoX----X--------------?---oX-?-------X--B-----------B|-|X---
-XX--X--XX---X---T----T---X----Xo-----o---E------?----BX-----?-X--|-------?-----X-----|XX-B--M-XB---X-X-----XX----------oB-o------B---?-----BB--X----?X-------X---o----B-----B-----X---------|?-X--o-?o-
m||-----?---o-------B-X------X-B?-X---M-B-X-E---------------XB-----o--XXX--oB-o---------X--------o?--E-?---X----X-o---X----------E--o----?---o----X---oXo-o---B-X|---X----X-----------X--T---o--X----TB-
B---?-X-------MX---X---o----X-----X-E-X-----X----------BB---------TBX------B|-B-X-T----XoXXB-B|-----B------------?TX---------X--------oE----B--XM-Bo--X-------E--X-----B---T-E---------?-B------------E-
