----------?---------------------------XBXMB------XB--------M--------XM---XXM--BXB---------XB---B----------BBM------------M------------------oXMM-XB-------?-----BB-XBX-----BX---------------------------
---------------------------oM-----?X----------------------EX----------------------------------------------M-------------B---------XX----------?-XXX?----XBBB----------------------------?BB?------------
-------BB-------------XXBB---?BX--------BBB------XX----------XMB?XBB--------?--------X--------BXB-??B??BX?------------?BBX-------------------o-----BMM??B-BX----------?XX?BX-----EBB-M--------XB?BB-----
---------------XBBooXXX-------XX------------B---?--B-XXoB------XM?---o--------------------o-----------------B----XB--BB----------------B--E-----BBB----B--------B?B------?-------------M?---------------
------?----B-B----------------?----------XBBBB----------------------oM---------M-----?X----------------BB------X-------XB----?BB----------?B-----B?X---------X-E?-----------?XM------------------MX?----
-----------------XXM??X?BX---------B-----BBBB----B-------------------------X----------EEBBM----------------EBX?X---------BBBMXX---------BB----------XBBBX-------------------------BMB---MXXB-BB---X--XB-
----------------------E---------XBB--BBBB-----------B-----------------------------------------------MB--B?BBMX-------------X?---o--------------------------------------------------------------BBXXX----
Bo-------XBX?--BBoBB-XB-XB----------------------------XXM-B----XB--------------B--------------X--------B--XXM---XB---X-----------B----BM?--------X------X----------B---------X-------------B-----------v
-----XX-------BB-------X------------M----BX--BX-----BMXB--------?X-?M------XXB--------------------BBB---------BMM----------------XBBX---B-------XB-o-B-----MX--------------------------------XB-----BB-f
----------------X----XX----------------------------BXBoB---------BBBM-------BBB----------------------------------------BM?MXX-----------------------XBBX----------------MXBBBBBX-----MBB---------------f
--------------------------X---------XB-----XBBB-----------?BB?---------X---------B-----------XB?-------MM?B---BB----------------M------?BXX------------BX-------?---MX----------BB---B-----BXXXX-BBB---f
-----X----BBB----X----------o?---------------B-X------------------------------------------------------------------------------------B--------------------X?BB--------------M---BB-----XB------X?-------f
------------------oBB-BX-----BBXBXo?B---------------M--------------------B-------E------------------X---------?B---B?--------o----------------------------------X-----oM-----B?B--X-MB---??XX-B--BB----f
--------MBBXBBBB-------------?B-?B---XB--?X----------------------------------X------------------------B??XB---?------------BBM-------EM--------------------B?-----------B-M-----------BB?--------BBBB--f
m------------------XX---B----------oB?-MB--------------------XB-----------------Bo?BX------------XBBX---BBB---------T?XB---------B----B--BMB---------------------X?------------MB--------??B-----------X
X?---?BBXB-MMB-----BB?------XBBM-----------------------------BXB---------BMM?---------BB----X------------------XM----------M------------B---------XB-----------------?B----BXXB------------------------X
XX|XXXX-XXXXXXXXXXXXXXX|XX-XX-XXXX-X-XXXXX|XXXX|X|XX-XXXX--XXXX|XXXXXXXX|XXXX-XXXX-XXXXX|X---XXXXX-XX--XXXXXXXXXXXX-XX-XXXXXXXX-XXX|-XX--XXXXX||-X-X-|XX-XXXXX-XXXX|X-X-XXX|X|XX|XXXX-XXX|-XXXX-XXXXXX|-
