----?---------o----------B-----E---------------------o-------o-o----oo-----------?----E-------------|------------B-o----------------------------------B-B-------|---B----------------E-----X--o-B-------
o-B-------o---|--M-------------B-B-?---------|-----o---o-----------|-----o-----X-------------XX-------------------------------o------?---------------B-Bo--|--------B----M-----M----------M--T----------
o-B----?---------------B----E--BB-o-------?--E-B-----o----------?---B-------Eo-X------oX----?---X----Xo-E-------B-----------B----o----------T--?-----?---?----------B-o--BT---EB-------E-----B-ET------B
--------------------------o-------o------o--o-----T-----------EB-------E-------M----M----------o----?-----------M---------|-----------?------|---BB-----E-oo---o-|o---X-------E----T----------o-BT----T|
------T---------------?------------------------E---o---B--B------------------T-----------E-X--E-T----B------E--------B-------------------------------T--------M--oE---M--------o----------------?o------
--------------?-------B-------?----------o--?--B----T---B--------------X--------B--------------------o---M----E-Xo--------------o---B----|-o-------------------------------T------o-----------E----?----
----------TE---------?M----------?-----------o----------------oo----------?-E-----o-----------B-----|E-T-X-M---------------??B-M-|-------?----------T--------|BE--T-Mo---------------------E------------
--------------------------E----T---o---o--------------|---------E------|-------B----E-B----E?------------------|B---B-----------M-----Eo-----B-----oE--X----M------ME-T----------------?------------E--v
B--?-----------o-|-?---B----------B-B-------------T---?--B----o-------E-E-BE--o?-------------o------?---------B-----------------EE---------------o---------E|--?--M---------M-?-------o-M|--X-----------
------?-------------o------------B---o---T-------B---oBB|--------|------o-|----E-B----M-B-B---?-------------X------?------o?-E-----o--o--o------------X----------------E---X---o-----------------B----B-
--B--o-------??------------------?-B----------?-E--------B----------?-------E--X---X-o--------------o---------TM---|-----B----?-------|-----T--------?----B------E-M----------|--?--------E?----ME------
----------------------M-BB-M-----------XT-------------E---X---B----|--E-------------B------------------o-----------o---------o--?------------o-B-B-------------M--|-----M-------------------------|E-E--
---|E------|----------------------o------Bo?E--T--------M--o?--B-E----------E--oBB-----B--B?--E--B-------M------MM----------|-------?B--------o----?o-----TB--o-E--oB-B----Eo--------------o-----?------
----T----BT-----------o-T-----------B---------------------------oB---X|?---o-B------Bo------B----o---E-----?--B----o----oo--?o-------X---------o---?------o-------E--M------E--------T----X-B---B?-----o
m-----------o-----------E?B-E----------------------|-----E--?---E-----------------------------B-?-------------------------o-----?TE-?-----X--?M--------------------------B--T----------o---BB----------?
XXXXXXXXXXXXXXXXXXXXXXXXXXXXXXXXXXXXXXXXXXXXXXXXXXXXXXXXXXXXXXXXXXXXXXXXXXXXXXXXXXXXXXXXXXXXXXXXXXXXXXXXXXXXXXXXXXXXXXXXXXXXXXXXXXXXXXXXXXXXXXXXXXXXXXXXXXXXXXXXXXXXXXXXXXXXXXXXXXXXXXXXXXXXXXXXXXXXXXXX
