------X----o--B-------------------M-o--------X----------------------BB-XX-------------o----?-X------------------------B-??-X--oM-------EM--B------------------------------------o--X---?--B-----o-------
--X----------oo--------------MXB--------------------------------------X---------X------------------------XB-------oB----------?-----------o---BEX-M-----------------?---------------BBB-X?--------------
-----X----------B------------------------E-------X---EBE--------------------------B-------------o-B---------------?--B---?-----------------------B--BBMXB---------X-------o--------------------B----MBX-
---------X-------?-----------------------B--E--X----o-----M---?-----BM-------E-----------------XXBB-----------E----------------X------------------BB-B-----BX-XBBB-------------------E-B------------B-B-
--------?-------------B-------B--------B------B--o------?----------X--------X-X--------------?---X----------X-o---------X-------B-----X----------------------------X----XX----?-------X-----------------
o---o---------?-M---------------------------------o-XE-X--------B------------X--------------------------?---o-----?--------------------------o------------B-o--------EM------o--o------------E------o---
--------?o---------------B-X--B---------------M-o-------E----oB------X--E----------------------X----------?------------------o--MX--X-----BBXB-----M--B-X---E-XMM-----M-------------E-X-oo--?---o-------
---------o-B-X-BXB-o---------------------?-X?----M-ME-----------o-------E--------M----------?M--------------M-B------------M--X-------------------------------------B-------X-------M-----M------XB----v
-----------------XX-------------------------o-------------------------X-----XX------o------X------E-----B------------M--X---------B----------M-----X-------BX----?------Bo--------B--------M-----------f
--------------M---E------B-------o--------E-----------M------------------------MM-B------------------B--o---X-X--------o-------------------BX?XB-------------------o----------------X--E----XX---------f
---------------XoX--o-------------------------B---------X---------------------M-------o?------X-----------?-------------XX--o-----?--------------B------------?-----X-----------oX----X---o-------o----f
-------------------B---o------------------M------X--------o-----o--------------X-------------o---------M-------------------oX-?B------B-----------------o----E---------------o-------------------X-----f
---------o-B--------X-----------------------------o---------------------------??-------------------------o-------E-----------------X---------------M----M--------------------E--------X---o------------f
---------BM?-?-----------------------------EX-M?-BBX--------B-M------XX---X??BBX----------E--B-----------------------------------------------------------------------o------X--X-----------------------f
m-------------B-----?B-----M--------?---------------MBB-----o------------?---------------oM--------o--------------o-------oX-B---X?B----------------------X-M-----------------E-----E-----T------------X
X-ooM-----------------------------??------------X--?---o-------------X-----------------------?--XX---------?----BB----------B------B----oX-------oo-BB---XX-----------?------??-----------|--M--------BX
XXX-X-XXX|X-XX-|-XX-XXXX-XX-XXXXXXXXXXX-XXXXXXX-XXXX-XX-XX-XX-X-XX|XXXXXXXXXXXXX---XXXXX|X--XXXXXXXX-XXXX-X-XXXX-X--X-XXX-XXXX--|XXXX-XXXXXX-XXXXX|XXXXXXX-XX|X--X|XX|X|X-X|XXX-XX-XXXXX|XXXXX--XXXX-XXX
