-E-B---o-----E-------oE---------------------B-----------E|------------------o-----?--oo----o-|---------T--------B--M---Eo--E-B-----------o|-----------o-?--T---E---T----------M-----------------B----B--
---------------------M---M-E------------?--?-B---------o---------B-----M-----o-----B-B-----?-------B--B--------B--B-----E-------------?----oB--------B-------------------------B---X---?----------B-----
o-----E---------------------?--?----------E--------T---B-------o-----------------------E----------------o-?------X-------oB------T------------------o---??----E---T----EB--o--B--o----E-----o----B------
------------B-B--X---B-------E--o--|----?-------------B-----?--T-------X----M---E----------?o-----------------|-o-----------oo------------------T--------------------X-------E--------------------------
--TE---------------------------E----||-----?o---------E--------------|----------------------?----X------o---B-------?----T-o-------oE---TXB---X-----------------o-----o-o--------?----BM----E-----B?-E--
-E--B-----------M--?-----------------------B-------B------------o--------B-------------o-----T-------------B----E?-T-----o-------------?-----------------?---?------B-M--------------E----??------------
----?---o--M|E-?-X--E---X-------E-------o-------o-------------------o----------?--E------o---------E--?|-----o--o-------M-X---|T-o-------o-----T-|----------T-----------E?E--------------B-?-B--T-------
M------------------------------|----T---T--?------------M--|-|--B--------------o|--------TMT------------------X-o----------------------o----?---B--------o---E----BM--|-?--------X---|---o---E---------v
------M----------T-T---E--o----X--------TMM--E-?--------T-|------------|------E--o---?---o-B--o------------------o---?--o------?-----------|B-----------T----?-E-----|---X-------------------BE--T------
M----o----------------X-----o-------M-------B--X--------------o--X-----o-B--------o-----------o-?---------o---B------o---------o-------B--------E------BE-o-------------------X---------B-X-X--M-T--E---
-----------?------------|E-------TT---|------B--M------|-B----------------?-----o--E----BE----Eo--M--------------?-----B--B-------B-------------------------T----T-----o---BE?------X-----------o-------
?--------------oX--B----B-----|------TE--o-------|------o-------E-----------oB-BB|-----E--?---------------------B-------------------------BB-----------T--T--B--o-----oB-----------M-----------B-----?--
----B---E----------------B------?-----------M----X---------------T--E------------------------o------|----E---------------X---o---E---o-B--?---?----------o---B-E-----------|------------------M--------o
M------------o-------------------B---E----B---E-----------?-o-E--MB------B--o|-X----B--?---B---------------?--------B---------------------------------M------------------------?----------o----B?M-?----
mM--o--o----B--M-----E----T------o?---------------------?----?---------------M------------|----------E---|----------M--M------------B-----o-------B----o-----T-------|-E--E-----------E---|------?------
---?-----------M----?--------o-----Bo------------?---Xo-----------------------X-----B--M-----T-----M--------EB---?o-M?---------o-------------o-----o?--E----------o--------T--------------B----T?-E-?-o-
