--------------------------------------------o--------B---------------?X?-----BB-B?BBX?BBBB-------B---------MB----------o------BBB-----?B--XoB-------oBB?EXM--------oMB----------------------------X-----
--BBXMX----EX------------------------------?BBB?XM-----BoX-----------BXXMBB----oX------XX------X-----XX---BBBBBX------E?B-------B----------------------------XX?MBXBBM-----------BB-------------X-------
--------oB-----BXXBBBMBB---------?X--------------------XB------o??--B?X--------------B--------------XM-XMB-------------M----------------------BB--------X?------------------BBB?XB-??----BX-----------B-
---------BB----X?------B----------MX--------BB----------------?--XX?E------------?M--------?XBX-BB?----oB?M-------XBB--------oBM----MB---------------XXM------X-------------BX-o??X-?B---------------X--
-X---?BB---------------------------------X?B--------XXM----M-----------o-----------------------------XM--XB----BBBB----o-----BB?-----------XX-----------------BB---------?MBXMMX------------------------
-------BX-----BXB---------------?B------X?---------X------------------BB---o----XX----------o----------------------------------XXXX----------X?B-------------------?-----BX-----XX----------------------
--XB-XBB---------------------------XX----BMXX-------oBBX--BBo--------------B------X?BB-B?-------BBXBX-XBBBB?--BXMMXXBMB----X?o--?--------------------------?B----------------MMB?--------------BM-------
---BB-------------------XBB----?B--?X---BMM------------BX--X-------XBB-----B?X---------?XXXMB---------------------------------------------XBM?--------oXB-------oXB----------------------XB?-----------v
--B--------BBX--------XXX-----------B-------------XB--------------XX?B--------------------BM--B-----------------BMoXBBBBB-------X---------oB----------------XB------?------XB--------------------------f
o-----M??---------------B-----BBB----XBB?--M-----o--------------o?--------------BBBX-XX--XXX----------X?----------------BB---------?XXX---BB-BMoX------BB---------------o---------------o------XXXXX---f
----X---BB?BX?BX?M-X--BB-----------------BM------oX-------B----o----------XB----------------Xo--------------------------BX----------oXoo-----------------------------------------X----------------X----f
-E---------------BX?-------------XXB------------oB----B----oB----------------------------oB----------------------------M--?--------XX---------------------------X----------M-----------BB--------------f
-----------BBBM--------BX?------------------------------XXX---?X------BBB------XBM--------------------------BBBXXB--------B-----B---------BB?XoXX-----------BX------------BX------?B-----B-o------B----f
-------------oXXXXX--XBBMX---------------BX-T?XX----------XBBX-E?-------TB--------------B-----------o----------T---------XBBX--------------------------oB--------------MB---BM-------------------------f
m----XXXX-T--------XB-------?B---MBMTXB-----??BXB--T----X--?BB?--?--TBXBBTTM-----------T-BBX---TBX--BT-------B-X-X----------TB--M-X---TXMB?MB----------------TXT----------T-----M---------BBXBBMTB-----X
X-MBMBBXXXXXX--XXXMMXXXXBBX-BXXXX?BX|BXXXBBBXXXXXXX?XBMXXXXXXXX-XXXXXXX-XB--XX---XB-XXXXXX-X-XXXXXBB-BXXXXXXXXX?BXXXXXXXXXXB--??XXXXXM?M---XXXX--XXXXXXXXXX-XXXBXXXB-?MBXXXXBXXXBMMXXXXXX-BXXXXX-XXXX-MX
