oBB----------MM---------B-----BXX-XXXBB------BBB--------------------MXB--B------------------BB--------?--XB-------------B??BX---------------------------?-?M-----o?B-------MXBE---oB------X-------------
---?BM-?XX----------------MX-------------?BB--------M?----------BX-----B-----------BXBX-oBXBB---------X-----B?-----------------------------------EB?--------------------------------------------BX------
oBXB---E----MBXX---------?BB?-------oXB-----------------MB--------X-BXM---------X-BXXBX-XBXB--------E-----B---------B--------------XBM?X?-----BXM-BB---------------M---------MX---BB??BX-----XX--------X
o-M----------X-------------XXB--------?M?-X------XXBX--EBM-------BMB--?B?B-------BMB----XXB------------------MB---X?X-------------MXB---------MMX------------M-----------------EXX--oBX-----MB----------
---------------------?BBXB------------------oMB----------o--------------BB?----BBBM----BBo?---?MB-----X-------B--BX----------------------B-------------------XXBXBX-----BB----------------?-------------
EXo?XB-BXM----BB--M-----------------?---BBBB-------------------B?BX------------------------------------------X?BX?XB--------X-------------BXBM?-------BMM??B---------oB------XX---------X------???X---o-
-BXB?-?X-M--------------------XX--------X--X--------------------------------------?XXB---------?BBBB??--X----B------XB---------------------?---o-MBBM------------XXX-----M----?B--------XXB?oBX---B-----
--------X---------o?B-----------------XMM-------------X--------BXXXXXXB-----------------------X-BM?-----------------------M-----o?-----o-------------?BB----XB-------X?----------X?M-------------------v
---BM--------------------------BBBB---------X----------BB-----------B------E---------------??--------XMX-----B-XXX--------------------------??X-------XB?B---------oM----------B------------------oXX--f
---------------------------BB--BB-------------------XM----X--------------XX----??--B?---BXBXX?----------------------------XX-----o?------??BBXXXX?XXBX-XB---BXM---------------XBXMB??---MBB--------BM--f
-----------------------------------BB-MBoM-----o-----X----------o-------------EB-----------MX??MMXB---B----------------------------------------------------------------MM-XB-------MX?-BB--------------f
-----------X-------------oB---M-----------B-----X---------------X?BX------------?--X------?B------------------------------XE-XoX---------------------------XB-BXMX--------------M----MB--o-------------f
-------------BBX--------XX?-??-?XXXB----?B?XB--------X-----M??-------X-----B?-----------------------------------M----BBX-------------------XXX---------------B--B------------------o-------BX?---------f
------MM-------------------BBB--------------------------------------------BBBXX?BXXB-----?--------------------------------------B-----------------M?----EXM--M--------------X--o------Xo----------??B--f
m-------------------X--------oXX------XB-----------------T------BB--BBXX---------------------------XMMBXX--BM-----MM---BB------------------X------T---------M?--------------B?----BX------?--?BB?----BBX
XMBB------------XX--------------------------------MMXMBBB|TX----------------B?BB------------------MX-------B?-----------------oX--BXB-XX?MXXB-----B?BMXB--------------------M?------------BBX--------BXX
---XXXX-XXXXX-XXX-XXX--X-XX-X-XXXXXXX-XXXXXXXX-X-X-XXXXXX-XXXX|X--XXXXXX-XXX--XXXX|XX-X-XXXX|XXX-X--X-XXXXXXXXXXXXXXXX-XXX-XXXX--X|XXXXXXXX-XXX-XX-XX-|XXXXXXXXX--XXXXXX-XXX-XX-XXXX-X-XXXXXX-XXXX---X-X
