------o-----------------?------B-o-------------?----------------X-----X---------E-------------------M--------ooB--------X--?-----oBo-----XX-o-B--------o-----?---------?-X-X-------o---M-------?---X----
B-EB--------X-----------B--E------X----o---------B---M-oB----------------o-----?---------EX-----XB--------E--B-o--o--M-o----?------------B--X---------o--?-----------------B-----o--------------oo------
--------------E-E-----------------o-------B--X-----BE---?-------X-E----oBo-o------------o-B---?X-----------------------------X-------X-------------B-------------------X-------------------B-M---BX-o---
-X------?----BB--?-----E-B-----?---B-?---XB-o------o-?--------E-ME-------o-----X------B?-------o------X-------------------o---E-X--o-------------X-X----BM-X----------?-----------------------Eo--------
------------------o--E-----------B---------E--E----X-----X----X---X--M----o--M--o----------------------------------?--------E--X--E----Bo---B---XM---o-X-----o--------E----o?-E------------------M---?--
------X---XoB------------------o-----?-----B-------?----ME-o--X---o----------?----?---o----X--------E---?-?E-------------o-o--------------X---X-?o----------BB--B-----------X--X-------?----M--X-----X--
-X--X-----------o-----o----------o-----E-B----o----B--X------------?----X-X--------X-----------------E---X--B---------------XX--X--XXo---------?--E-----o---------EBX-BE-------X----B--B--?----------B--
--------X------o-----E-----X----------Bo----o--E---X?--B-B--------X-o---------------------X-X--B-------------------B------?---X-Eo---X-----X-----Bo--X---E-?------X---oB--B-EX--X-E---X----------X-----v
--?--------B-------------?---oB---------------B--XM-----B--B--------X-----X?---------X----o--------o---X---B-----E-------o----B---XB----o-E----?---B------------------------B------o-----------X----B---
----------B--------X-o-------------------------------------X----BX---------Eo-----B--------------X------------------------------oX--B-X--X?---X---E-?-X---B----X?------------------E--B-----?---B------X
o-X----o--MX-X---------E----?oo------o----------o------------M------X--------X-X---------------o--o--------M-----------------------o--?----o--------------o---B--X---o-X--------E-----X------X--X-------
-----?----------X---------------B-------------XB----------X-E--------E-------o-----X----E-----------------E---o------------B---------X-----------B--X------------o--X-----X--------B------BX---X--EX-X--
---B-B----X-----B-------X---------X----------X-----------o-?-------ME---M-M---B---o-----------o------------------o---oo------o-?--------------B--------X----X---------------------o-------Xo----B-X-----
---------X--o-----B----M---o--o--------------o---o---------X------------?------XE--B--?---X--X---XBE-----?---oM---X--X---T-B--EX-X--------M-B-----------B-XB------------EMXE-----Xo--------XBB---T------
m-----B------B---oX---XXX-----B--------o----------o-------Bo--BX---o-----o------------oM----------o----X-----------------|--X--o-E--BoB-----X------------X---------------X--X-oo--------B--------|-B-X--
XXXXXXXXXXXXXXXXXXXXXXXXXXXXXXXXXXXXXXXXXXXXXXXXXXXXXXXXXXXXXXXXXXXXXXXXXXXXXXXXXXXXXXXXXXXXXXXXXXXXXXXXXXXXXXXXXXXXXXXXXXXXXXXXXXXXXXXXXXXXXXXXXXXXXXXXXXXXXXXXXXXXXXXXXXXXXXXXXXXXXXXXXXXXXXXXXXXXXXXX
