-?---E--o-X-----o-X-----oX--X----XX---E---|BoE---|--E-o-X--Xo--M-o--X--EX---o------E?----------o-M---------------o-------X--------oo-oooX-XXB---X-------B-----o---X---oX-|-------Xo--X-B-----E---------X
------X------o------X-----?---|-----o-X-B-----X--------T---o---?-X--------X?-B----BT----o-X---?-------------X------------?-------------X--BX-------TXBXXX-X-oM-----oX--X-?o-E-BM------B-------T----o---T
-----?-X-X----B-------X--T-B--o----------?--------?-------------XM----o---X-----B-X---XX-o-BB-E--X-o------MX-oo----Xo-----------X?-X----------X-o--X-?E-X---------o-------TX---X--X---------X----X------
-------X----T----|T?-X-?------X--------?M-|--|----X---------X--E--ooT?-----------o--|--X----o--Bo--XT--XBo-X----B--XE---X--X-Bo--------T--Xo----E?-|---X?--E---B-o---X-o---X?-------B-X-----------------
----------o---E-------o--X--XX---MX---XX--XE--X--?----X--X---E-------------XB-----TXBX--Xo---XX-X-------X-XX--o--X---------X---X-----B---B--B-----o?E--XB------B--X---XXX--XX--|-EX----BM------------X--
-------|--X-----E-----?-----T--B---Xo-XXX---B-BX--XE---B---X------X---|------X-B|-X--X---E-?E----------X--------X--X-----B-B--|----------o-------o-----X-o-------o--------XXE---o-o---o-XE-----X-------o
------X-B-M---o--------o-?---X--------X---M--X--------?-------B---XEX-----B---B-------XX---X------o----T-|-X--T-------E-B--?---M-|o-----?o--T-?---XXo-----oX---?B-----E-B-E-------M--------|--X-------X?
X-------X----X----?--BX--------------X-----X-?---------M------B---B----E--------?----X----?----EBX-------o-o--o--B-X-----------X----BX--------X-----X|--B----------------o-X----o-MoT-------------|--B-v
-------X--|---XX-------B--E-----------------------------X-------XTE--|-?---X--B----oo-o--X-X|--X-----?-----?--------?---?---M--o---?o--o---?--M-------XM-------X----o----XB-------X---X-o-------------|-
-XM----Xo---o-----X-o---B-E--Xo--o----T-----?---X----X-o------X--B-B----X---o-X--o---Xo-?---------------o-------X-TE---X-------------------MB-------E-----BMT-EX---X------X-E----------X-----BB-----T---
X-X--B--EX---X?---Xo-o----------B-X-To----o--XEX-----o----EB------?---X-X--|-o------------X-o----E--B------|X--oo------|--X---X-----?-E?-X--XB-o------X-XT-------------XX-----T---X----?--|-X----oX-----
-M-XX--------o--o--?------------M-----B-X-X-----oX-B---E-----?o-X--EB------o--------T--X-----B-X?-------E----XXB--B------o-----BM?------------X-----XXXXX---X--E----------oX-BX---------X-X?-X--M---o--X
B---XX-X------?XXT--X-------X---X-------X--------X--------M---?----XX-oX--BoX-X----o--------------B-X--B?----E---------X--X---------BXX---------------M----------M---o------B--T----------XX-X---B------
--o-----E------E--BTB-X-------X--------X---------E--------------o--X--|-X--EX---B---o--X----X-------XB--B-------X-----B---M---------X-B---T----T-------o?--------X---------o--B--B-X---X---T--B-X-X---?-
m------B-Xo------T---X-----X--E?-------o--o----Eo--------------?X|-o----T----X---o---X-----o-------------o--------o---X-E---X---|---X--------X---EBX---o--B----B--o-----X----XX-X-----E?--X-------B-----
XXXXXXXXXXXXXXXXXXXXXXXXXXXXXXXXXXXXXXXXXXXXXXXXXXXXXXXXXXXXXXXXXXXXXXXXXXXXXXXXXXXXXXXXXXXXXXXXXXXXXXXXXXXXXXXXXXXXXXXXXXXXXXXXXXXXXXXXXXXXXXXXXXXXXXXXXXXXXXXXXXXXXXXXXXXXXXXXXXXXXXXXXXXXXXXXXXXXXXXX
