--------BoX-----|M|--------To---E--To-----E----------Xo-M----B-------------------?---o-----E-----------|-------------M----------B---|----o-EB--T--B--------?-----E----B-?----------BT-----o----X------?-
--?-------B-M-o----T--B-E---------------B--|-o---------------------|--o-------|--------------X---o-----M-Eo--|---E?------?B---------o---B--?------B----------T------B-----------------------------------
-B----B-------------oX-------------B-?o-------------------E-B--------------B---------------?-----------------T---?------------------M-E---------------------------------------------?-----T-------------
T--------T------|------------Bo---EB-|?--------------------------EB----o---B------------------E------?-----B--------------------B--M?------------------BE----------------o-?--B---B-o------------?------
--------B--------------ET?-XM---o-|----------------------------o----?--E------B-----oBB-------------X--|E----E-B----------?-------------------?-T--B-------B-----------------------------oT--------?----
B-----T---B---XM---E---------?-E--------E--E------------------|---------E----------B----------B--------ME----oE---X-----BB-----X---------E---------------M-----------------E----B-----T---?-------------
-------?-------------------------?-B------BE----------o----------------X---|----?Mo----?E-E----B-----E------------------?--o----oo----?---o------o--------------------------------T-----------o--------?
-------B--o------Bo?-B---o-----o---B-T-----------B--B--------E--------X--o----B-----------------B--------T--------------?--?--E---X---------BX-E------------------o--------|----|---------X-B----------v
-----B------o-BT--o---?----E----o-------------------B----------?Eo-?---------------------B-?--Bo--o--o-------BT-o----B-------o-o-----o-------------oE---------------M----------X-------o-----------o---E
------o-----o-M--o----------|----------------B-E-?------?----BX----|-M-----T---------?------B---------o---M------------------------------?------M--E------------------B----B-----------|--------E-------
--XT--------------B--o------------------T---T-?-------------|-B------------------B---o---B-B----B--o-o---B---o----------|-?--------------------?---E--o------?-B---------------E----o?---------|----T--T
-------------------------------E-------B-|-?B----o-----?B--?X----------o----E-------o--------------------o-------E-?-------B--------------oBBB----?-----------B-?--------o----o--------|----E----M---o--
--B------o---XT----------?----------o----?----?-------------------Xo----E-------X----?---------------B----------E--?---------|--?--B--M---------------|B---MB---E--|----B-----?--------B-B-?------------
------------------------------------?---E--------------------------?----------------------------------------B--B----------X---------------?--|-----M-----o---B------------M----------B-------o---E------
m---|EX-----------------o----?o-------?----------o-B-------o-------------oB--o-|-B-----o----E-------------B--o--------X----M------------------M---|------------|o-------o--------B-B---B----------------
|---B-----------------------T-----B----o-----B--------------------oo--------B------B-?----X-------EM---X----M--------?---E-------------E----BE?---?------B---------oT--?-------------o-----------o---X?-
