--------------------------------XM-----------------------------------?-----------o--------------?MB-X----XB-XBB---------------??-----XX--------------------------------------?BB---B??BB-B-----?B-------
------oB-??X?X---------------------XB--X?M---------B------------XXX-----X?MXB-B--XB-------BB----------XXB?-----o-------oo---------B-----BB--------------BBM---------XBBMX------BoB----------o------BBo--
MBX-------XXBX-------E----------------------------------B---------------------o?B??X?o?X------------o------B-BB------------XX---------BX-X-------B--B--------------?B?X-------o?BBX------------X---o-X--
----oM---------------?XB-BBMB--------------------XXBX------------oB---------B---XX-XBX--------?--XX-------BBX-----MXB----B----------------X-----------------B?-B----MX----------------X-----E---BBXM----
----------------------------------MooBX--o---X---o?----------XBB?---M----B-BB-----B?---------------BBXB?XX----------------------------------------o-----------------------------??----------------------
-------B--------BB?--------o---MX-------?-------------XM--BB--------XXB------XBM--------X-B------------------B--------------X-----------------------BB-------???-----B?-BX-XBB------XBBMXX--------------
------------------------BB------M--------------oB--------------------oo-?BB---XBB?X---------------MXX----oBX--------------XXBXB?----B------------B-------------------------------?-------------BBBB-----
----------B--------------?BBBBX??M---------------BBoB--E?------------------------------------------B--------B--------------o?------------BB---XB---------------oXBB------------?----XX?---B-----BXB-o--v
X?----------------------BBB--------------??BX-------?B----------------B?--------B---XBB---------BBB--B?----BB----BM----------------B--------X---B--------------------------------XXXXXB---oBBMM--------f
---------------------o----M-------------X-B?MB----------X-----------?BXX--oXXB----XB------------B--X----------------E---------X-------MXX-----------------XBX?----------------E----------------oBBXX---f
------XMB------XX---------oX?--oBBBBX---------------------------M----B-------XMoBM-----------?B-o------------------------X------------------------------?B-------------B--?X?MBoB?-?B------------------f
-----------------XM-------------------------------oMX-B--MB---------X?--------------------o------------------------BB-----BXBX----------------------------------------------------------XX-----------XBf
---------BX-------------------------------------BBXX------------------X-B-BX-EMBB---EX------X?BBB--------BBXB--BX---------M--------------?BX-----------------X--X-----B--------M--B--???---------------f
-----MB--XX-X--M----MXB-------------------------?-----------XX-------?BXX---------------------XBB-----------oBXXXX----------------XMXBBB--------X---------??-----------------------XB-----XXM-----B----f
m----T--BB------------------------------------XB-o-?X----------?oM------------B------------------------XB--------EB?oBX-M--------XX-----------------------BBE---------XB-----------o?--------BBX---XXB-X
-----|XB----------------?--o-X-------------B---M-------BB------MB?T?BB----MBBMBX------------------------------M?----------BB---MX?o-----E-----X-------B---------MM---BB?------oX-----------------------X
XX-XX-XXX-X-XXXXXXXX--XXXXX--|XXXX--XX|XXXXX-X-XX--X-X-X-XXX-XXXXXXXXXXX-XXXXXXXXX|-X-XXXX-XXXXXXXXX--XXX|-XX--XX--XXXX--X|X-XX--XXX-X-|-XXXXXXXX--XXXXXX|X-XX--XX-X|X-XXX-XXXXXX-XXXXXXX-XXXXXXX--XXXXX
