-------------------------X-XX------X--BXM----------B-------XB-------------X------BX----------X----------XM-?--------------------XX-----------X--------XM-B-B-----------------------MX-------?-----------
----------oX--------XX--o-X--------------------X----?-----------X--------B-------B-----E-B--------------------B---------B-----B-----------X-E-------M-------?-------------------o-----------------------
-B---B----------BX?B---------------B--B--X-----------------BB--------X----------------?M?---B-----?----XM-----o-M?XB------------------------o--------------o---o-B------?--B-oX-E-----------------------
---------E------------B-X?------------?X-o--XE-Bo-------------BX--------------o-----------?-B-EE--------------------X------X------------------?-----------o--M----o-----------------------------o--MXB--
-------------------------------M-----M-----oM?---BB--------------------o--B-------??B--?B------E-?BX--B------B---------------XBXBB?----------X--------------BB-----X-----MMBMB-BBB----------XB----------
------------X------------------XX-----------EB---?B--------------o-XM--Xo----------B--BB--------------X--XXB------------------B-o--X-B--XX------------XXX-------------MXXX-oB--------------------BB-----
X-----------X---------X?---------X----B-oX------o--------BBBM---BBBB?-----------oXEBX-------BBX------------------B--o?-?BM---XM----BoB-------------------------------------------------------B-B-BBX----
-------------BB--------o-------------------Mo-M--------B-----BXXB---------------------XB----------------------B------BBXX------XBBB------BBMX-----------------------BXX--M?BX-----------MX?B?B---------v
--?B--------BX-----XX---------------X---X--------------------BB---BXXX--------B---------------------------B?-------XB---------BB?B---X--------------------BBMBX---------------?-------X--B-----------XBf
-----------?--X-----X------X---X------------oX---------------X--------------X--------------------BBB------BX------------------------------BB----------o----------------------------XB---XBX-E----------f
-------------X---?---------------------------------------X----------B---Xo-M----------------------------------------------------------MBX------?M-XXB----------XX------------?-------------------------f
------------------------o-------------------------------------o?B----XX---------MB--B-----?--X-------------------?------------B?--------BB?-------BBB--------M----------------BM-------?X-?----X------of
-----------------?BX----BX----X---XB-----------------------M---BE-----?---------?--------------------------X-------------------?M--BB-----?---------M------ooMX?---BB-o?-B?X-?XBB-----XX-----BXB------Mf
---------------B--o-----B--------B--------------------------------?--?-o--------X---------------------------BB--B---?---T-XM----Xo-------B-MB-?B----------o---o----------------E-------X-B---X---o-----f
m-------XXB-----------XM--o-------X----------------EB?----o----?-----------X-----------------X--------B----------??-BB--|--B-----X-BB--------------E-XTBX------B---X----------M------X-T-B--------BBB--X
---------oo-XB---XXX--X--X-----oBM------?B----XXMXBMXBo----------------XX?X??---E-------?XX---?B-oMB-----TBB---XMBMXXBB-XXB---------------------------|-----------XX-----MXMB-XB-------|XB?-------B----X
XXXXXXXXXX---XX-XXXXXXXXXXXXXXXXXX-XXXXX|XXXXXXXX--XXXX|XXXX|XXXXXXXXXXX-XXXXXX-X|-XXXXX-XXXXX-XXXXXXXXX-XX--XXXX|XX-XXXXXXX|-XXXXX-XXXX-XX---XX--X-XXXXXXX-XX-XXXX--XXXX--XXX-XXXXX-XXXX-X--X|XXXXXXXXX
