--------------------------------------------MB-------XX-------B-oXBB-----------MX--MB----X---X-------?---------X-------------B-o---------------oBB----BBXBB----------------------XB-------?X------------
--?BXMX----E----------------------B??------------------oBM------BBB--MB-------------------XBMBBBBBMB-----------------------BX---------XXXBBB------------BX---------------------B---B----------------?---
--------oBX----MXX--BM-----------BBB-----------E--------------BBB--BM-----------oX---------------------------X--------XB?XX?MX-----MB-----BXXX---------------------------------M--------BB--------------
---------BB----X-------?----------MBBXB-----XB----------------B--BB?E------------?X-----------B-----------------------------?X---XBXXM---------------------X----------oB-------------------BBB----------
-XB--XBB---------------------------------X?B--------XX-----X-----------o-----------------------------X---XB----B?------X-----?B------------XX?----------------X?---------?MBX---------------oXB---------
-------BB-----B?X---------------XX------X----------o------------------BB---B------------oBBB----------------------BB----XX------?X---BX----------------------oB---------------XX------BXXBXBBB------o---
--BBBXBB---------------------------XXM---oMBX-------oBB---BBo--------------B------XBB-------------XM------------X---------------------------oMB-X----------------?B--------oM----------BBXX----Bo-MBBX--
---X--------------------XX-----?BB-?X---B-X---------------?BX---------?BM------BXBB-------------------------B??-------------------M--BMB--------------XMXXM-----------------?BB---X??MB----------------v
--BBB------BB---------XB------------X-------------BB----------------------B---------XX--------XX?XXMX-------------------------------B---?--------------------BX----------XXXXXB----------BBBMB?--------f
o-----MB?---------------B-----BB-----X-----M-----X--------------o??-------------------------------BB----BB---------oX-------------------------------------oXXB------------XBB-------------------M?-----f
----X---XB?BX?BX?M-X--oM-----------------B-------oB-------??---o----------XB----------------Xo--------------------BBBXoBBB-------M?M----------------------oBB----------M?B--EBBBXB-----BB-------X------f
-EX--------------BX?-------------BXB------------X?----?----oB----------------------------oB--------B---BBX?-------------B?B----------------------------------------B-----oX-----B----EBX---M-----------f
-----------BMXM--------BBX------------------------------XXX---?X------MBB------XBMB-------------------------XB?XX?----------BMB-------?B-------------------------?X??-BB-BXB-BXXB--------XX----BX------f
-------------oXXX----XBBBX---------------?XXTXXX----------XB---E?-------TB--------------?-----------o--------------------XBBX------?B---BBX---?B---------------------------BB--------------------XMBB--f
m----XX-X-T--------XB-------TXX--MBMTX------B?BX---TB---X--?XB?--T----EXB-T-------B------XBB--MB-B?------B--------------B??XB---TB-oBXB-XXX--------?M?---B-------------XBX-------------------------o---X
X-MBXBBXXXXXXXXXXXMMXXXXBXXXBBXXXM?X??XXXBBXXXXXXXXBM?XXXX--BBXXX|XBXXX??X|-X-MX??XX--XBBXXX-BXXXXXXXXXX--XXBXXXXXXXBXXXXXXXBXXXXXXXXXXXXXXXXXXXXXXXXXXXXXXXXXXXXXXXXXXXXXXXXXXX-MBXX-BBX?--BXXXXXXBBXXX
