-B----------------------M-B?----B-?EXM---------??--X----X----------?-----------------M----------------B-------BM---XB------------MB-------------XB-------------B---o---------------XXXX----------X--MBB-
-------X---------------------XB---B---------X-----------B----------------?BB--------X----E-----------X-----XXM---------------------X---------------oB-----------------B-XB-B---------o-------MB---------
E-------X---------------------------------------ME---X---oo-X--B--XB-----B-?---------------X------X------BBE?-o----B----------X----------------B---------o---X-X----------------------------------M-BM--
----------------E----------BX?-B--------X?XXB---BB?M--------------M-oMM---------------------------------------------B-XBX----------------?------?MBBXX--------oB----o-----B------B-----XBBB---XB-?BB-B--
-?-MBB-----------------X----------BX----X--BBX---------MMXB------------?------?B----BX?----------------B----MB---M------o------?B-----?---------------?-MB-XB----BB--BB---------------------------?B----
-------BBXX?--------------------------BB??---------?BXB---------------------------XB------X-----------EBBB?---BB-------------------?XBBMX?--BBB-----------------B--------------X?BB?--?-o-------------M-
o-BMBBX--------B---?-------------------XBB------------o--B--------------BB-------B---X-----------B--------------------B??B--X--------oB-------------------------------XB-----X-B----------------XX----o-
--oXB-BB?X----------?BoX----XB------X------X?XX?-MX?----XXB-----------B------XMB--?X----oB---------------------------B-------------------o-----BXB?BBBXB----XX----B-------BM----------------------MMX--v
---XXXB-------o----X--X??B-----------B-M?-X-------------------------X--BM--------------------------B-BXXX---------------------BBBB--BBX--X-XEX-----BM----------o??-BXB--------------XX-----X--------XB-f
--------XM------------B-----------?oB--XX-------------------BXB-----X-----------------------------------BMBX----------------X------------------------------------MB---MBX---------------XX-----BX?-----f
-----------------X-------------------BM----------E?-----o-------XBBXX-------------XX--------------MX-------X----------------------B?--X--EXBB-------------------------M?--XX---B---B-----X-------------f
-------M--M--------------------------------------------------B--------------B------------o----M------------------------oXM-oB--------------------E-----o-E---o------XB-XB-B----------------------------f
-----XBX---B-----?-----o----o?---o-B?-X-o-------o------o---------oX--XBBB---oXB-----------------------X----------------------B---------MBBM?---------M------EB-----------------?------MXB--------------f
--------------------?--------------------B?XXM--BB-B-----------MB----BBBB--?---------------?-BBB--E--B----M-BB---B---------------------MXXXXXB--------XBB--BBB-X-------EX?-----------X-----------------f
m------------XBXXM------X-?-X------?BBM---------o----XB-B-------o-------------------B-XMM--------B-B----------B-B-----M----E--------B--------?-------------X-----------X------------XXX--------XX------X
Xo---------E-X---BX--------X-o-X---------------------------oBX--------XX------X--X--?------------------------BB---M-------XBB------B-E-------BMM---EB----XB----o-------Bo------------EB-TBB--X--------BX
-XXXXXXXX-XXXXXXXXXXXX-|X--XXXX-XX-X-X-XX-XXXXXXXXX-X-XXXXXXXXX--XXXXX-XXXX-|XX-XXXXXXXXX---XX|XXX|-XXX-X-XXXXXX-XXXXXXX-XXXX-XX-X--XXXXXXX-|X|-X-XX|XXXXXXXXX--XXXXXXXXXXXXXX--XXX-XXXXX-XXX|XXX|XXXX-X
