----------MX--------------XX-E---Xo------oE-M---------------X---?E--------B-Xo--X---X---M--B--oX-X--------o----|-o------X--------?-XoX|B-X----X----o---B----------X---X--X------X---M-----------X-----B-
-X----TMX-X-----------E-----o-----?-X---E-o--------X---------------X--o-----XX----X--EB-??-X--XX------------------E-E------o------------XX--------o--X-o?-EX-------------------B-X--TX---o----o--|?X----
--o---|----o---XM----X----oB---o-------oX--?---X-----X-M?------------X-----o----X-MX------B------------B----E-Xo-B---X----------B-X---B--XBB----oXX--X-o--X-------?----------o-----B|-Xo-----o----X-----
XX--X-|X-B------o--X--oXX----B--B---oo---E------XoXX-?--E----o-----------X--X-------------B----X-?----X------X------XX------------X-B--------X-X-o--X--------|--o---------BX---X-Xo-|X-------X-?-------?
------|-----Xo--o-X----o----------XB?----B-----o--------BX-X-XX-XXoo--X|--|B--------?X-X---X---------------|--------o----|X--XB--------E--B----------------B------------XX----B-X-M-|-------B---------Eo
----X-|----MX-E------X-Xo----EB-----E------?---------M-----oX--------XX---------B-oX------?--?-o-X-XX---B-|---B----X-----?---EX----X----------ME-------o----Eo----X--X---------o-B--|------o-----o------
------|--EB--X-X-------XM---X-----?-Xo-X---------X----?------X-----XBB---------------X------------E-----XX--E-----BB-----X--B-------X--o--o--X--o----XX?X---?---------o-X---XXX-----|?X-------E---B-----
X-----|-X----------------X-----X---MM---X--M--X-?--X-X-----------E-----EX-X----X---------------------E-X-XXX-----X?-X--X-o------X----BXE-?---X----X---X-o-E-B-B-oX--EX--------X--E--|X?|E------E?--o--Xv
---X--|------B-XXo--E-----o-X-X-X----X---XX--X----X-------------E-------X---------?XXX---------XEo-E-----?---X------------X--?--X-BX------------X---XM------E---------X----------X--|---X--------X---X--
B----B|-----E---?-X------?--X---------X-----|o-----BX-X---X----------o-------X---E---o----------?---o---X-XXE--B-B-------------------X|----------M---?----X-oX---E-----------E-----B|--X-----X------X---
------|B-X?-------BE------XX----------X---?----B--B-----X----M---o-X---o--?---?----X|--o-----------B--X--?X--M------o--o--X------------E?--oB----X--X-X--M--X--XB----X-X?----------X|---X-----------XB-X
------|----M----X----|---B----------X------M------X---B?---E----------o-X----X?--o------------o----o----o----M--o-M---?--M-X----XB-o---o---------B----------------B-|--------X-----X|-----X---X------B--
E-X---|---X--Xo---------XX------------B--------E-----?X----o-E-------o--------E----XE-?-------------oX-X-|--------|X------XE---------------X---------------o-o-B----|------------X--|X-M-B?-----o-X?--M-
------|------X---XX-o-----EX--------------E-------X-----E--E------X-o-MB------------o?---E--------XB---XX?BE-----X--X---------B---B---X----E-?-X--------X-------------------o-------|---X---oo--X--E-X--
m---B-|--X----X-----X|--|---------------X----o--------B-XM-----B-----XE-X-XXX----?--|X----XX--Bo-----?---o---X--?E--MM-o----M--Xo--------X----?-----X--X--?X--E----o----X--------o--|--E---o---|X------B
XXXXXXXXXXXXXXXXXXXXXXXXXXXXXXXXXXXXXXXXXXXXXXXXXXXXXXXXXXXXXXXXXXXXXXXXXXXXXXXXXXXXXXXXXXXXXXXXXXXXXXXXXXXXXXXXXXXXXXXXXXXXXXXXXXXXXXXXXXXXXXXXXXXXXXXXXXXXXXXXXXXXXXXXXXXXXXXXXXXXXXXXXXXXXXXXXXXXXXXX
