-------------B--------M------o-BE---oB----o-----M----------B--------o-------------------?----------------?---B-o---o----------X-----B--o----?-------------------------------M-T---E-------------M------?
--------E----B---------------E----------X-----?---B---------?-B------?------X-------Xo-----------o-B-------E|----|--o---------------o---------X----TM-----X-----B--o----T-------------------------------
-------------?--------------B----?-----------o-----E-B--E------B------E-----X-------------------E----------X--M---M--------------------------------------BXB-----------EE----------M---B?--o------B-----
---------|----------------E-----BE--------E--------o--E--T?M----?-------------------|---M-T-M------T--?----o--------------?--------MM---X-TBBT--------o--------------X-------------T--------------------
-------------|---------E--?-------------?-------?-------?-------X-B----M---o-B-----TB-?--------T------Bo-o--------------B----------B-o-------?-------------------o-----E-B-?o-----?------?-BX--------E--
---------------E-----B-------B-----------|-----------XXE---------B--T----|?X--------?-o-To---B-T-|------M-----B--o--------o------B-------|-------------------M--?--o-o----B----o-------?---o-T----------
--B----------------?|----M-----B-----?---T-----o-----------------------T-----BT------?----o-------B----------o------------o----?-----------T--E-?-?----Eo--------o---o-------o---B-----B-?----B-o-----B-
---X---------M-----o---------oo-------B-EE-------o-EE-----------------B--------X--B-BB--------B?--E-------------E-E-------------E---T?----------------E-----------------------EE-M-B---------------BM--v
----------------o---o-------B-----------o--B?-----o----oB--E--E-E-----------------o-?----------B------BM------B--------oB------?----B--------o-?-----------B----B------E--B---------B----E-M-|----------
-B----T------X--B-E--------B-------T-----------------------o-B-B--------B--------T--B----------------|----------------------------------o-X-------B-----M------BB-----X-X-----o------T--------------B---
B----------B|------------B-------o--------oo----------------------o---------------------E-------B--------E-------?---B---------------------o-------B---E------?--------------M---B-o-oE-----To---?------
--B-T------------------oX--------|------B-----------------X--------E--------------B-----BB--M--o---o-----------B--------B-B-X----o--------o-BX------B-E--X--M----?-------?-----E-X--X--|-----o------?---
----------?----E-T-------------------o-------B---------X|-----------?---|------o------?--B---------T--o---------E-?--------|----B-----------------o?-----------------?--------o----?-------oE----B-----E
--M--------?----------?---------B------E-----------------------------??----------TE---B---?M----o?-o?---X-------------|----?------E----------X-------o-------E----------------o-----------E-------?----E
m----?--?--------------------o--B---o--------BT--------------o------?----X------------|-?-----------------------M-?------------------------o-------X-----o---o----------T--T------B---oo----------o--|E?
-------M--BE-----------------BB-------o--?--|-------oB-------------------------------|----------------------B---------X-----B----------------------------B-B-------B---------------o--------------o-----
