-?XBBB----B--------XBBBXXB-X?----------------BB-BBB-------XBXX?------------------BB-BM--B-BBB------------XBXM--------XB------------------------------XX?X-------BX---------------B---------------------o
-------------B----B---------XX-----BMBBB------XXMMB-XB------------------MX?---B---BB------------------BBM---?BM----B----XM---------------------------------B------------------------------------B-------
---------XBMX-------BMB------------BX--------------------X------------------B---------------------------------------------------------------------------?BB-oXXB----X---------?-XBBB?---------BM?-------
-------oBB-------------BXXMB?--------------------------MB------------BBB------B------------------B------------XBBBXB---o-X--BBB----B-BB--E------X-?X--------------B-B-----?-X-X--BB--------B-BB--------o
--------------------X?-----------BXB------oM-BB?---------------oX?---------------------BX-----BMX--------------M---------------------XX----XB------------XX---------XBX-BMXX--E-B----BBM----------------
--XoXMM?M-----BBX---XXMB--B--------XXB--------X------------MX-----------BBBBX----oBX--------------XBBX----B-----------B------------XBB?-------------------EB---------------MB---------------------------
-MXX-----------------BB---------MBBB------------B---------------XBBB---------B---------------------o------XB--BB-------o---XB---??MX--?B-----o-?-----------------------X------------?--------X-??BBXBB--
---EXoBBX-X?-------XXB?------------X------------B?BBB------------------BXB--------------oBB--------------------BBBB--------??X-----------?-MXXBBXX---B------BM-------BB-----XB-------------------------v
BM--------?BB??M------------------BB------------XXBBBM---------------------------o-BMMMMB-------?-----XMMB--MM----------------------------------?M-----M----------------------??B----------------------f
XM-----------------BBBXBBBX----XXXBoB---------?B?-----------BB-----XBBM--------B--------------?----B------------?BXXB----------oB---------B-B?--MMXBXBBM---------------------------B?------------------f
-------?X---BXX--------BM?X------------MB-------?B----------BXB---X-------------B--o-?X---------------------------oB--BMB-----MBB-----BMBXX----BM-----M---BBB---------o------BBB-B-------BB------------f
---------------------------------------------XXB---BBB---MBBXX---------MBBB?-XBMBB-----------MX?M---?BBXB---BB----------------B--------BX??---------XXX?-------?XXB----XBBBX------M----------------X?X-f
----------------------------------------XM--------------XBBB--M-------M?-------B---XBB--------BBMBBB------X----B--B---------?XXB-----XBB?------------BB-----BMXBBB?MM--------??BM----X---XB----X-BBMoB?f
----------MMX----------------------------------?B---------------------------?B-------BB----------------------------------------------------------BX-BXX-BXMBBX--MB-------------------------------------f
m-----X---------BMBMB----B------X-----------------XX------B-----B-------B---------T---BX?---------XB------------XBB???-------------B?BB---XXB------------------BT---BXooBXB----------------------------X
XXBBX?------------M-----XX----------------------------TB------B-M?-----EX--o--XB--BB-------?XB---oBX-------------?XB?-------------B--------------XB?------?-BBX-|--------------------XXX---XXX---------X
XXXXXXXXXXX-XXXXX-X|-XXXXXXX-XXXXXXXX-XXXXXXX--X-XX|XXXXXXXXXXXX-X-X-XXX--X-XXXX-X--XXXX|XX|XX-XX---X-XXXXXX-XXXXXXXXXX|X--|XX-XX-XXXX-XXXXX-X-X-XX-XX-|XXXXX-XX-XXX-X|XXXXX|XX|XXXXX-X-|-XXXXX-X-XX-XX|
