o------------------Bo--oX?---BBoX?--?B-X-------------------------BB------------------------M--------------------?---XXX--B---------?XEB--?----------XM--------------------oBB---------------------------
--XM--EXE------------------------XoB?-----??XMX---?------?M---------BX?B-------------------B------?B---BBX------------------X---o---------------------o--M----M-M?-------MX-----------------X-BX-----o--
----------------------MM--o------------------------B-----o--------X---------------------------XX?B?-oB-------B-------B-?B-----------------BB--?-------------------------B?----------B-------------------
o--?X--XBBB-X-------B--XXX----XXBM-BB-----BB-XB---------------X----oo-------B-M------------------MBB-------XXBBM?BBB-----------------------------o---------------XBB---------------XEX---------------?--
-MX?o?-------------------------B-------------X--oB---------XBXB---------oMBXM-------------E----------------------------------BXX------XXX------B---------------XMMXB?X?------BXB?-----?BMBB-----B?------
---EX-X??------------------------------------------------BXX--------?B----M?BXX--?X?-X---------------------------------BB?---XX---B--------XXBBB----?XX-----------------BB-------EBBBXB-----------------
-------XM-------------BBX-------------XXB?---------------------------------o-MM?B--?o--X----BXM-----XB----------------------XBXXM------------?X-----BB----X-X-------B-------------------BX--------------
B---oB-----------M-------M?MMBX------------------------------XXB--B-XB-----XB--------------BBBX-oB----------------BBX---------B?B-----------------?BB?--XB?X---------------------BB--------X?BB--------v
o--------------------------------MX----------------B--------------------------------XM----------------X--------B---B----------------------------------X----X--------o-------------------------X?BMB----f
B---------M?BB--Bo-------X-------o-------B---BX-------------------BX----------B----B-------------------BBXXXBB------------M-XBM----XBXB---------------?-----------------------XXBXX------XMXBB------BM-f
-------?XX--B------------------?------------------BB---------------------?B-----------------M-----------------?-------------B?------BB-B-----E------------------EB----------------B-?BBX--XXBX-------?Bf
------MMB-------------B-XBB-------------------o----------------o-----------------?BBX-XBB-?---?o-----XXE-------------o?X---B-------------------MXXBB--o-------M-B-MX---------------------------------X?f
-------B--------Bo?------------------------X-------B--B--------------------------------------------XM-B-X-------MX-------------------BX--------?B----B----------oMXM-----BM--------X-------BB----------f
------BBX-?-----------------------------B-BMXBB----X-------------MB---------------BB------B--------XX----BBBB?---------?BB----------------B----------B--------XX----------------MBB------------BXX-----f
m-------M---------------------B-------------------------?BX--------------------------------X-B----------?--EB-?X?B----TBBB--------------------T----?XX??XXXB------------?----X?--T--------X-----------XX
---X-MBBXB--------B---BM--XX------------BXBB---------------X---------B-----BMXB-----BBBXB-----------o?-----------oX---|M----------B------------------M------------o--------------|X--o---B-oB----------X
-XXX-XXXXXX-XXXXXXXXXX-X--XX|XXXXXXX-XX-XX|---XXXXXX-X-X|XXXXXXXXXXX-X-XXXX-|--XXXX-XXXXXX-XX-XXXXXX|XXX-X-X-X-|X|XXX-XX-XXX--XXX-XXXXXXX--X-XXX-XXXX|-XXXXXXX-XXXXX|X-XXXXX-X-XX----XXXXXXXXX-XX-XXXXXX
