------------------------------------------E---MB--------------X-----B?-X---Bo-X-M------EX----------------B-oB----------oXoXBX-----BM---------------o---XXM-------------------X------B------BBBM-----XX--
?-----E-------X-XBX-----------------?-------M----EXBX-----XX??--------?--E?------------------------X-------------------------------BB-------------B-----------------------X--BB----------------------XB-
--B--------------------------B??B---------------------X?BBB-?X------------X---------o------X------------?----XBM------MX--M--------BBM------XX---------------XBBB--?BBBB--B------?----?X------B---o----B
---M-------------?---------------------------------------------XB----EX-X----------------?BBBX---------------------------X---------------------------------------------------?-------o-----B?---------oo
-----E-----M---------------------M----X---------------------?----M--------------X----o---------------------o--------X----B-------o?----------------------XB-------------------------X-------------------
-----MBo----------B---------B--X?------------------------XEB-------X--BB---M-----------------------oBB-------------MX--------------------X------?------E--------------B------XM-B----X-------E----------
o?BB----------BMB----M-BB----XB---------o-B---------X-------------B------B-------------XX--------BM?--------------------BM----------X-BX----BB---------------------B------X------Xo--BB?B----?--BXB?----
?-----------B-MB-----B--------B---------MBB---B---------------XBX---------------------X-----------------B-B-----------B---------X---------------B-------M----------B----?----M-------------?--BBB------v
--------M--?B----?BBB--B?BB?BB?--BX-EB-------------------MMX----------BBX------BBBB-----M----------X-----XB----B----M?B---------------X--------?BBBBBB---------------------------BBXXM-B-MMB-------XX--f
BBX-------XXX--??-?--M--------?-B?---B-XMMBB-----X?-----XBBBB-------BX----XXX----------------------------XBXBB----------------------MMB-----------X-XM--BBB--MBB----B-E-----M----BXXXX-M--XX-B-------XBf
-----XXX-BBXBBM----MX-----------BB-B------B?BB--XBo----B?-------?oBBB-XXX?X-----o-?X---------------XX--XB?B------------------oB----------?X-----B-?--B--------------------------------B-M--------------f
--------------------------------------------------------------X-------------------o-----?BB---------------X---oB----o-X--------------------X--X-----B---------?XXX--------E--o-----X--E----------------f
-------E----X----oB----BMMX--XM-----o-------------X----------------X--M----B-?X--------------BM-BXB------XB--------------o-B--BB----X-----------------M-------------B-----------------------B----------f
----------?BB----?---X---XX-----oB--X-----------B-M-X--X-o?---X--------E---------X-------B----------------------XM-B--X?------oBMBBB----------------X?--MXBXX-B----BM-o----o?-----M-----------------oB?f
m-----BM-----B--MB?-X---o---oo--?------T---MX-XX------------BB------?----------B?B-------o---------B-----?--------------B------?-----o?---X-------------------o-----------E----------------?---------X-X
B------X------------------------------B|XB-----X?X----------o--B--------X-----X----------o------X---o----o-----------?---M-----o-----------------T?X-------oXB-Mo---X--BX------------B------M----------X
XXXX-XXXXXX-X|XX-XXX|XXX-X-XX|X|XX-||||X--XX-XXXXX---X|-X-|XX|XX--XX-|XX-XXXXX-|-XXX--X-X--XXXXXXXXXXXXX-X-||X--XXX-XXXXX-X-XXXX-XXX--X|X-XX|-|XXXX--X|XXX|X-XXXXX|XXXXXXXXXXXX-XXX|XXXXXXX-XX-X-XXX|-X-
