?------MBX--oo----E------B------XX-o---?-oX----X--------E-BX-B---E-----X-X-X-?------X------o--BX-----B--?Eo---X----o------X-----------o-Xoo-X----------?-EXXo---X-X------oX----------o-E------B---o----X
-E?-B------?o--o-X---X?---B-----B-EX-------X-----X-X-------B--------o--|----------X---------------o-oE-------X-----X---------o-B----B-X--------EB-BB|-X--B-?------X---o----------E--T---XM--------?---X-
?-?----------X-XX--B-o--o--------?-----X-E-----------X-------XXX-|o-------------------?----o-X-o-BX-----B--X-o-----XX-------M--------------X---------|oE--X--o-------?-----X-------X|------X------?--X--
B----X------X-X--E--o-----X--------X--E-----------o-------X---o---o-X--X-------------X--------|?oo--o-----o------o--X-o--o?--X-------XX------------X----X---X---?X-----------E------|-----------X-o?----
--X-XE-?--X----------X--M----X-----X-X----?-o--X--X-B-------------------------o-----E-----X---o-------X-----EXB--X------X-?-B---M---------X--X--------o-----M----M--BX---E-o-----?--|-M----oX---o?XXo---
---X-----o-M-M-------?--|-|------X----o-------XX-------X-M--o-X-o----?-?------X-BB-------X-----E-X-X------E--X----XM--X--X----o-X----X-------X---X-EX----XX--X--|----------X---|--X-|---X---------------
o-o-X----E---X-o-B-----X----------------X-X---------------------X-?E----o----------X|-Xo-X-B-E----X----------------X------X--------------X----E-X--o---------X?XXX---B-X-------B----|B------o|----X--o--
-B?-?---------------XX-EEo----XE--?-XX---o----E---X----|B---o---X------XX---?-------X-BX-----------X--X---||B-X-?----|---EXo---o--------------|-----------X--------M--X---?---X-----|-X---------XX-B-XXv
----o-------------X----------E-----o-XE----------B---------------X---BB--B----------X---X?----X---X---?------XB-M-------------B--?----o--||-|----M--B------?E-oo----XB--BX--------M-|--Xo--XX-----X-?--B
B---B----o---XXoX-M-----o-E-B------------E--X-------?X---E-|------XX-X-X---?-----------o--B----o?----X---o-o--?X------------oX--o-----?-XX--X------------Eo------------X-------X----|--B---X---X--------
---o-X-X--E---E--------X------E--------?XX--------------X-----B---------X-----------X-B-------o--------------------X-E-?-o-oX------------X-------BB?-Xo--------B----------o-------XX|--X-----X-X--------
--------?--?-XB-------o--?X-|--------B-oX-------X--o--Xo?------B---o-o--X---o---o----X-?XX|----X----E--M----------------X---E---------X--?X---o--------X-B-oEX--MX--B-------o--XX---|--------X---Xo-----
---------X--------------E---o-o----X-B-E-X--E---?-o--X-------------|--E----X-X--X-X-----?X---?--X---X---o--X-------o--EoE?-oX---oX|--------X-B--B|----------M--------|-X------------|-B---oX------------
|----------E----------X-Xo------o-----X--?----?--X--o----B-------X--------?B-E--B-X----E-X---?-----------o------X---X---X--B---?Eo-B------o-X-X---X|X-X---|o---------------o-------o|--X----XX--o-------
m--o--|---E--------------XX--B-------X----E------E-X---------BX----o-o?------?---B---Xo----------E--X?EX-------------------M|--X--X------E---E---MEB---?----|---E---------------X---|--------X---o------
XXXXXXXXXXXXXXXXXXXXXXXXXXXXXXXXXXXXXXXXXXXXXXXXXXXXXXXXXXXXXXXXXXXXXXXXXXXXXXXXXXXXXXXXXXXXXXXXXXXXXXXXXXXXXXXXXXXXXXXXXXXXXXXXXXXXXXXXXXXXXXXXXXXXXXXXXXXXXXXXXXXXXXXXXXXXXXXXXXXXXXXXXXXXXXXXXXXXXXXX
