-E-----------XXXBo?---------B------------B?XX-------------------XXXMX------------X-------------BXB---XBB-----------------BB----XMB--B-----------oB-----------MBB-----BX---------oMXX--XXM----oB?BBX-----
----X----------------------------BX---------------MM----------------XB---------------------------------BX------------M-----MBB--------------------------X-B--XB--------??------------------MXM??B-BBBX--
-----------------XX-XXXX---------BM-----XMBX----M---M------BX-------XM-------------XBM-----------XX-------MBBX----?----------------------MB-BB-----------------XBX--------------------------E?----------
-------X-----X?BB---------------------EB----------------BB-------------MBB---------------X-------------XM?X----------BBM?--BMXMXBBXXB----------------?X-----B------XM-------------------------------X---
----B-------B?---------------M------B?X---------------XBM?------------------?BB-------o-------------X-oXB---------B-------------------------?BX?----BB-?XX?----B--------X--XB??B-M?X--------------------
-MBMX------BX??-?---------?B--X---------------------B--------B---?XB?XX------------------------------------------X----------XXB-------------------------oXB-XB-??XX----------------XXX?B------X---------
------oX?BB--------B--?---------------XM-----------BM-o---BBB--------------------BB----------?XBBB-----------------XB?B----------oB-----------B-BXB-----------oBBBXBXBB-BBB-----------------------------
---------------MBXB----------------X----B-?BB----XB-----------------------?BB-------------------XBB----------?M---XB------XB---------B----?MB------------B-BBX---------------BBXB--M-MMBB-?M---------XBv
------MBX-----------------------------B--------------------------------------------------BX?X---BB?BXBX----------------------------?XB-----------------------------------------------------------------f
-XBB---------------X------oBX--B---MXBBB------X---BB?-----?X---------M-----?B-----------------------MX-BB?--------------------B---o---BX---------------------B?B---------------------??---------------of
------------BM-----oBB------------------------o?-------------B----------------------?BBB----o---------------------BB-----oB----------------BMB------------B?B----M-BX-------?------BXMX-BMMBBMB?----EB-f
---------?BBB-BBo---------------------XBBB-----oB?----------------------------------o------BM----------------------oM---?BX?------B?B-------BoXX------MB--------------B------BB-------B----------------f
-----------------oB--X-----------B?X?----------------------------------------------------------------------------MX?X-----------X------BBM-------------MB---------------M---BB?----?XBX?X----EX------BBf
---------------------MX-X?XX?B--------------------?MX--------oXBX----X-------------------BB-----B-------------------------------------?BXX??B---M-----B---------------------------------?-??MM-------XMf
m-------------------------------------?B?-o?B-T---------------XBB-------BBB-------------------------MX?--------------------?B------------------------------EB-------B----------XX--------XXX--BX-BB--?BX
XXoBB---XXB-----XX----------------XBB---------M-----------X----------------MB-BX--------------------------------MMB---X?B------------MBB------------BBX?B-------------------o?-----XB-------------??---X
-XX-X-X--XXXXX-XXX-XX-X-X|XXXXXX-XXX-X|XXXXX|XXXXXX-XX--X|XX-XX-XXXXX--XXXX|XX-XX---XXX-XXX-XXXXXXXXX-XXXXXXXXXXXX-XXXXXX-XXXXXXXXXX-XX|XXXXXXXXXXXXXX-XXXXXX-XX-X-XXXXXXX---XXXX-XXXX-XXX|XXX|XX|XXXXXX
