-------------------E--o-------------o---------------X--------E|--B--------?-----------------T-----------EE-------B----Mo------------E--E-X------B-oo--B---------B---?-E---E-------o------E--EEo?------B-
-------------B-----E----o--------M-----B----------------B-------E-------B?--o------o--?-----BB---|----o------EB--------------B-EB---o--X--------------T---------o-B---X-----------------------E----o---?
----------------------M----------------X---o----------------------------oE------E---X---------o-----------?-------XE----|---------o--------X-X--E-----o--?--?--------|---o-----E------------------------
|--------------------------X-M---------o------------o------------?--------------o--------------E--------o---B--oEX------o-----------o--------o?---Eo-E-----E---B---o-|----X--o--MEB-o------E------------
------T-----------B----B-------M-------------------------T-------------?----o--o-----------------E---------------------------------o--------o-Eo---o-------------|---o-o----------B-|o--o---------------
--B------------------E---B----------------?---------o-----E------?o----B-------------------B-----------o-----?Xo--------?--------------|----BT-----------------M-----------M-|-------------B-?-B--|-----
---M--o----------------|-?-----oo--------------B---X--?----?----E--B-----?----?--o---?---------o-----BB-------o-------B---o-----------?------|-----?--B------o---X-o----------------------?-?----------o
--------------------E---o?----------------------------------o-------o----T-----??------------X--B-----------?-o----------------------|-----B-B-----B----M-X----o-------Bo---B--------------------------v
--?B----?-----------o---B---E-E-------?--------B------------B---X?----T-o---?-----E--o-------------B--------E?---------------------?--o----o--M-?-----?E-B-------B----B--?X-------X--X-----B-o----------
--------E----------o-------oB---------B----oE--T-o---o-------B-------E----TMM?-------X-------E-X---o---o--T---B----o------B------o---T--o-----------------------o----M?-B--------?-----|----------------
-B------------EX----------?---------------BB---------------------------------M-----?-B-------------E---------------------E-------o--E--M--|-----E-----Xo----X--o---------?------------------------?-----
-M----------------B?---------------M---B-X------------o--------------B---E---------------M-M-------------------------T-----o------?B--------------X----------E----B----B-B-----------------B---------X--
---------------E------o--oX---------o---------------------------o-----E----B------o--T-B-o-------?----?-----------TX-M--B---|-------B-----BB--BE-oo-E-----X--------------------T--?---------------------
--------?--B-o-------------------B-------X----o-E--XX----B-------------B----oo--------X--?-E---------E--B-?----------o------?------o-----?-X---B---------X--------T--|----Bo-------------?--oEE---------
m---?--T-------------o--o--o-------------------------------?----E----------?-------------------o------------MB----------?--------?----|---B-------------------o?----X|-E------------------?-------------
------------o-E--o--o-----B-------------?-------EE---B----E--------?--------ooo----?-----------o------E------------X-----B----|-oBo----B--o---------|--B-B-----------o---|---?----------T-E-------------
