----o-------E---XX-o-----T-X------o---M-----XX--o----X-X-----B-B--------X-?-------o------?---B---M------X---B-o--o-X--X---MoEB-E--------?---X-----?----------T--|----------T--------o--E--X----o--------
---XE--B-----X-XM---------o-o----X----X-X?---B----EB----?------o---------X-E-X--X-T---X------oX----B?o--X-B----BBXo--B------------------X-----X---------X---?--Xo----X--MX-E--X--B-X-----X---------BB-X-
----XB-B--X--XX------|-------X?---X---o---XX?----B-X----------TXX-----oE-X------X--XX--------X-EM-?-XoE-------X-?-----X-E-X----X--------X--o---?---?-|---------X----E-----------TX--X---------Bo-B--B---
X-BX---E-XX--X-----X--o----B-------oMXE-o--------X------X-XX----------o-X-?-o--------X----X--|-ET--------X---?-X-X------o---XB---X-B--X-o---T--------o-B-o-----------------XoX---X--------XBB-----B-----
--------X-----------E-------------|--?---|--X-M-M--o-o-o-----?TM------X--o---?---------M-Xo--oE-E---X---------E--B-----E-o-----o------XX----T----B-XX-X--X------------oXE----B-B--B-X-T---X------B-B----
-----o--X----X------|------------X|Xo---XX-----o-o?--B---------X--M---o----oX--------B------X-------T------B--X---o---?----------B---E----B----------o-X--X-oB--o-E-?-X------E--------------X-X-?-------
-----E-X----X-oX-X----------------------------X--M-T--oo-oX--------X------------|B--------o----o---------|--|--------X----X-X--X---B-o-B------Mo--T----X-oo-----X---E---XX-----?----BXX--?-----X---X--?-
-B-----X---oB----ET-M---o------EB-X-B---X---?----X--X----X-X--X|-X-oB--------B-XXX----?--X---X--T----|X-B-oX---X--?-----B--E---Xo-----E----o---X-----XB-------E-------------X---------B-E------------E-v
-X-E------------o-----B---X---X---------------X----?--o-----T?---X-X----?------XT---?B-----oX-E--XXo-X----------o-E-X-X--?-------o--X--------------B-------o-----------X-B------------B----X-----ooX----
---------X-|-X-----------------?----X----Eo--------|-----X-------X-XoE---?BX----MX--------X-----X-o---XX-XX----T-----E-Xo-----------|---X---XB-?X-------|------X?--o--X---X-------E---B-X---|-------X--X
--X-E-?X-------|-o--X-E----X-Xo--X---|----X----B--X---------T--o----X?----E|-X--------------?-X--BX--XE---XXoB----X---X---X-----B----X---oX-----------?-o---XX----X----o--X-?X-----B----------X--BX-XX--
XE--|----?--X------------X------X-X--------B--X-----------o-------------XM--X---o-BX---------X-----------------B-X-X------o-------E-------X-o----X-E----?---Xo----Xo--X-----B-X|X----?---B--------X--X--
---B--------X---BX---X--------X----------------------M---------XX--T----X------o------TB----o----X-M---------TXM-----------------B--X--o-------X---XX----T----o-----X---B------X-B-------------EX---BM-X
o---X-T-Xo-----------------X--B-Xoo-o---B--X---X--------o---M----E------X--------X--------X----X-------------E------X---X-E--MB--o?-o--X----|---E--?-|E-------------X----B----------X-B-X--XB----X---T-X
m|----|--?XX----X?--oX---XXX------X--X---B-X----------oE------X----X------------o-o-B-----B-XB---T---X--X------X-X--------?-----o-X|-----o---B--M--B----B-----------X----o-X--X-M---o--E-X-?---------X--
XXXXXXXXXXXXXXXXXXXXXXXXXXXXXXXXXXXXXXXXXXXXXXXXXXXXXXXXXXXXXXXXXXXXXXXXXXXXXXXXXXXXXXXXXXXXXXXXXXXXXXXXXXXXXXXXXXXXXXXXXXXXXXXXXXXXXXXXXXXXXXXXXXXXXXXXXXXXXXXXXXXXXXXXXXXXXXXXXXXXXXXXXXXXXXXXXXXXXXXX
