-B---------------------------------------??------o---X----------------X-BB--BBXB----------------------------B---------------BBBB-B?---------BXBB-----------------E-------?BM--------------B-------------
------XB-------------M?X------------BM-----------------------------------------oBX-----BXXB----------MB----------XBBX-------------B----------------------------------BM-------BB-B---------------------M
-------BB------------------------X----------------------X----BB--------------------BB?BXBBBBBB---------oX----------BB--BBX-------------------MXB-------------------------B?--------------------oM-------
----BBBB--------oX----------------XX------------XX----EXX------------------------------BBX---------------------------X-----------------BB?------------oXBM??--EBM--MM-XXBB-------------MBBB-B-------XBX-
---X-------------------------------oBX--MBB----BBMMBoBB--------X------------EB--------------------BXMM---------------------?B------M-M?-oXX---B?BoX-B---------BXXX---BMM-------------------o-----B?BX---
---------XX----------MBBB--------------BBB?----------BB-------------XBBBMB----oBX--------------BB?-------------B--MXMBBMBBB-------------------------XBX--B------X?BBoM----BXXB------------------BBB-----
--------------BB-----o??B----------E?-----------------BBX???XXXB--BB??B------BMMM------?BX-----BBB?XM-------------?-BBXMBXX----------------?----------------BB---EB----XBMM--------BXB-------------XX---
----------------------------B-----------?B-B?X---B-----------X---BBB-----------XX--------------------------oXXBB?---------BB-----------------XB?M--------------XXB--------o-------M?----------------B?Bv
------------------------X?---XX----------B---XBXB----o-----------BB--------o--X??B?---X--------?B--M----------B----B?-------B-X?XXX?XXXB------MXBBB--BX--?BBBB-----------XX--------MB-----------?MXXX--f
---X?-----------------B------------B--------BXBBX------BB-----------MX--X------XX----oX---------XBB--XMB------B-----oXB-------BB--MB?---------B?-?BB--------------------M---oXXBBBBB--------X--XB--XM--f
----XBX?B----BBMBX-E---BBBBB------MBXX--oXBX-----------XB?-------------BB----------XXXB-----------------------------------XBB------BX---?BBMEBBBBB------------BB---------------------------------------f
-------------------------------X??X-X--B-------oX------------------oXXB------------B--MB--------------------BBB--E-----------XBMM--------BXB---------------MB?--MBB?-----------------------oXBX------XMf
---X--------BBB---------------M-----------------------------BB-----?o?BB-------------?BB-----------B------XXB-BXX----------------EB---------------------------------------------BBBM------X?B------XXXBf
--XBXMB--------------------BB---------X?M---------------------------------------------BB---------M----------?T-BM-----------------?XBBB-----o?-XX----EBB-----------------BXXX--------------XXX?MB------f
m----B--BX---?BB----------------BMX-XXB-----TB-----T------------EB---------MBB-------------X?-----BX----MM?XX|----XX?B---BM------XBBB-------------------B--TMX??-TB-----BB-XXTX------------B?--------?-X
X--XXXXXXBXXXXXXMBXXBBBXXXXXXX-BXXXX--X-BBBXXXXXXXXB??XXXXXXXXXXXXMXMB-BXB-XX-BXX-MMXXBXXXXXXXXXXXXX-XXXXXXXXXX----X-XXXXXBXXX?-XBBBMBXXXX?X-B-XXBXXXXX-BMXXXXXXX|XXXXX-XXXXXXXXXXXXXXXXXBXXXX?BXX-XXBBX
