-BXXB------------------------------------XXX-----X---o---------------XXX-----oBXXB------------XBMX---------M--------------------------M------------------------------------E----o-----------------B-----
------BBB------------?BX------------oBBXBBX------------------------------------BXX-----BXXXB---------BBBX--------XBB?-------------o?---------------------------------E------------------XXX---------XBBM
-------B---------------------EX------------------------------BB-----------------------XX?B---M----BXBBM?---------------------------------------BB-??X-------------MX---X-??M------------------------BX--
----BB----------?X----------------XX-----------------oMBB-----XX--------BX?X--------XB--BM--------------------------??------BX?-------MM------------------------X---o-BXB-----------MB------------------
---B-------------------------------oX---XMB----?XXBBX--------------------BB----?BBX------------------?B------------------?B-----------M???XXX?--------BBBXB----------------------------XXB-------o?-----
---------BB----------XXXM--------------XB?BX--------oB?B?M----B----BB?X-?X-----------------------X?---------------------------EB?----------XBBM------BBMB---X----------------X?-------ooB--XX-B---------
--------------XBXXBB-BB?X----------?X-----------------BXXMB??oB---XBB--------?BM--------------o----------XXXX--XB-----------BB----BX--BB-----------------------------------XB------B?----------?--------
---------------------BX-----BBX---------EE-X-----MX----------B---X-----------?------------------------MB--------------------------------------------B??---------------oXBBBX----B--BXMXBB-------------ov
------------------------o----?B----------X---XXX-----BBB---------BBM----------------------MBBBBMBXXXB---------------------------XM----------XXBB-----------------------------------?-----------------XBf
---XB-----------------BBBM---------X--------BXBB-------XB-----------MX--XBB-----------BBXX-MM----------------BX------BBMM-----------BBB--X-------BBXBX-----------------------------------------------oof
----?MMBXM---BXMBB-X---M----------o?XBXXBB-------------B----------?----X-----------B-?--------------------------------------------MBB--o-------B---------------o?BBXoBMB-------------------------------f
-------?-------?---B---------B?B-----B-------------------------XXB?---------B--------------B-----B?------------BBB?---MB-----------------------------------??B--------------------MBB------XBB------XX?f
---BB?------B-----------------B----------X?-----------X-MX---------ooMM-----XB-------X-------XBB-----------MXXB------------------------------BXX-BBB---BBXX---------------------------------BMX-------Bf
--BBX----------------------------B------------------------MBB--------B?-------XX---o--------?X-X------------------XB?B?-BX---------B----MBX-----------------BMB---------------------B----------XM------f
m----B--BB---BM?----------------TXX-BXXX-----------T-B--------BMMB-------?MB------T-------XBX--XB---X?----------B-----XBB?MB-----------TMB-----------------B----TX------------TX------X--oBBMX---BXB---X
XXXXXXXXXBXBBXXXXBX-XXXXXXXXX--B|XXXBBXXXXXBBXXXXXXXXXXXXXXXXXXXXXBXBXBXXB-XX-XXX?BBMXBXX-XXXXXXXXXX-BXXXXXXXX-----?XBX??XMBBX-MBBXXXMXXXXXXXXXXXXB-XXXXXXXXXXXX|?XXXXXXXXXXXXB-MXXBXXXXXXXXXXXXXXXBXXXX
