?-------------------BX----o?---------------B---------BXB?X--oX----------?BB-----BBBXX--------------------oBB---------------XX-----------------------------XBB-------------BB-----------------XBBB-------
----------??XXXMX------------XB---o--X------------------------------------------o-o-----?--BoM-----o---------------oX-------------------EB----B--------------------------?X?B---------X----XB-------XBB-
---------E?MXB----------------X?BXX-----EB--------------------X--?B?X---------X---------------------------BB-------------XX------------BB-BXX-----------------?MX-----?XB---?BX-----------BB------------
--B----------------?X-M--?------?XE?M-M-----XBB------X--------MB----?----------M--EX-----BMB-------------oB-X------------------------------BX----XBBB------MBMXB--E-------XX---B--XB----X?BBBB----------
B?X?MB-B-------X---------?B----o?XX-------XXXXX---------------XX---------------------------------------------------------MBB-BB--------------X-----------?---B----BB------------E---------BMB----------X
-----?X------?-X-------------------------------------BBB--------B----BX-----XB?---------??----oXoX--------------------B-------------B---XXX?-------------MXXMMBXXBBX-------XXXB--------------XB---------
-----BoBB----------------oMX---------------o?B-------E---------B?B----------B---B?B??------------------EB-----------------XM??---BBXXBB----------------------M?MXXB-------------B-BB------BBBBM---------
---------------BBMX?MX-----X------------------BBBXXBXXB---oB?------XX--------------------B----XBB--------------------------B?B--------------X----XX------?-?XXB------------------------XBM------BBM----v
BBB?-X--X?BEX--------X-------X--------------B---------XB?B----------XMB---------------BXBXM-B--------------B----------------------------M--------------------------XB--------------------------MXBB----f
---------------X---XB-?X-----------BB-----------MB---------------BB---------XX-----BB-----------------XX----X------B--BX----XM-M------------X?-----BB-?B----XBB?-BX-BX-X------------------------B------f
------------------------------------B--------------?--------M---XXB-XB---------------------BX?X---B---------XXBXB-?BB------?XX------BBB--BBB-----------------BBXXX---?B--------oo?X?----------------X?-f
------X---------M-X-------X-----------BBM---??-?--------BBB---M------------------?-------oB----------BBB-BB------------X--X----X------X-----X-XBEB------------BX-------M?B-------BBM----------------XB-f
-----------B--------------------BB-----------Xo--------------o--------------------------??EEB-------B?B--XBXXB--?BMBB-----BM------------------------------------X?BBX--------XX?----------BBX----XXB---f
---------------------------------------B--BMBXXB--------oBXX------XB??oX---------B--X---o-----X------BB-XBBBoXX---------XX-------MXB--------MB?BMX-------------------------B-----------------XXBMBBo---f
m------------o-----XBo----X------o-o--?XXXB--------------------B?oXoB-------------BM-BB-BBXMM-----B------------B?------------------T-----XX--B---B-B----BBB--------B-----XB-BX?BM------------MB---BBBB-X
X------------------------------XMB-XX------------?M?X------------------X?XXX?----------o----X--?B--------------------?-------------|-----?-------------M--MBB-B--XBXB------------------BX-----M--------X
X--XXXXXXX-XXX--XXXXXX|XXXXX-XXXXX-XX-XXXXXX-XXXXXXXX-XXX-|XX---XXXXX-XX-XXX-XXXXXXXXXXX--X-X-XX-X-XXX|XXX-XX-XX-XXXXXXXXXXXXXXXX|-X-XX-XXXX|X||XX-XXXXXXXX-|XXXXXX-XXXXX-XXXXX-|XXXXXX-X-X-X-X-XXXXXXX-
