?-------------------XMBBB--BB-------?X--------?BB--BEE-----------XM-------XX-X-------MBB-------------------------BMMB----------------o?----------B------------------------MMBMBX--------------------BBB-
----------??BXXMX------------XB---X--X------------------------------M?----XB?------B-MX-BB-oB?-------BBM-------X??-------------------X?B------oX-----------------XoBB??-------oB----B-------X??B--------
---------EB-XM-------------------BX-------------X?------------XEBXX---BoB--------------B----------?------EB-----------------------------XB------XBB------------------------------BXBX?------------------
--B----------------BX-?--X?-----M-E?M-M-----X-B------M--------MBB---??---------B--E?-----B---------------oB-MB?------------------------------------------------------------------XM-X-------------------
B?X-BBBBMBBM---X---------BB----o?XX-------MXXBXB--------------XXX------------------------------?BB?BB---------BXB-------------B-BM---------------Bo-X??------oB------BBMB---------------BB-----?B------X
-----XM------?----------------XBBB---------------B--------B-----?MBX-XBXB-----?---------XM--XBB-----B--------XB-----XB--XXBBBB----oBBBBB------------------BB?BBX------------B---?-------?BXX--oBMXB-----
-----BoBM----------------oXBB--------------oBB-------E---------B-----------------------------EB-EBB-X-------E-------XB----------BB---o------B-----XB----?B-B--?B?-----BXB--XB---BBBB---o?BBX?-----------
---------------BBMX--------B----------------?BXBB---------------------------M?------------?B---XBBB---------------------------------X-------XB----X--------------MBBB---?B---------X-----XM---?--BX?B?Xv
BXXB-XB-X?B?X--------B-------X--------------M---------XB------------oXB------oB----------BBoBM-----------BXM-XB---------------M-------BB-------------------XXB--BBB---BXX-------XXBB-----------?B------f
---------------B---X--?XB----------oB-----------MB---------------BB?--------XX-----BB-----------------X-----B------B--B-----?X----------BB-----XX-M--------------------BBMB---------------XM---------?-f
------------------------------------B--------------B?-------M---?XB-XB---------------------BB?----B---------BX?XB-?B-------XX?------Bo---BBB-----------------BBXXX-XX---------------------------------Xf
------X---------MXX-------X-----------BBM---?--?--------BBBB--B------------------B--------------------?------BB-M-----------------BBM-----------------------------------------------BBo----B--XX-------f
---------------XBX-B----X------------o-----------------XX----------------oXX------------------X-?---------M----BXXXX------------------?BBBB-XMMXXBX------------------BBBBXXo--------XBEB---MX----------f
---------------------------------------BB?BM--XBB-------oMXX------X-MBoX---------EB-X---o-----X------X?-XEMBBB----------?X-------MXX--------MB?BMX-------------X---------XM-----------?--------XB-XXX--f
m------------o-----EBo----XB-----?Bo--?X-XB--------------------B?o-o?X------------BM-BB?X?X-------BXB----------B-------------------T-----XT--M---B----M----------XXX-------------------?--------MX--?BBX
X------------------------------XMB-Bo-------BBB--oB--B---------------------X-------o---X?B--B--MM--------------------BMB-----------BM----B-------------?--B-??----XXX?MXTBXX--?X-----------BB-TB?XB?XB-X
X--XXXXXXX-XXX--XXXXXX|XXXXX-XXXXX-XX-XXXXXX-XXXXXXXX-XXX-|XX---XXXXX-XX-XXX-XXXXXXXXXXX--X-X-XX-X-XXX|XXX-XX-XX-XXXXXXXXXXXXXXXX|-X-XX-XXXX|X||XX-XXXXXXXX-|XXXXXX-XXXXX-XXXXX-|XXXXXX-X-X-X-X-XXXXXXX-
