B----------------B---X-X-B-B?XX?-----?--?-----?XX-------B------E----------B---?--------XBBX-----------------o---XM----------------M----------------------------------o-------BX---BXBB---------MXX?o--Bo
-----------------?--------B-----------X?-----------E?--?XB--------------o???-o-----------B-------------M-------M------BBB?X------B-----------------------------BXXEX---MBX---------------------------BB-
--XB-B--------E----------------------------MB-----------Eo----XX----------?BB?---?B?------------BMMB-BMX---X--------------------------BXB----M---------------------------MM?-------B------o------B?---X-
------XB?--------o--------X?-B--------BX--BBB--E?B----------------X?X?BB-----BB---------BB-Bo?BBBBXB-------------------------X----M---X-----B-----------B?BX--X--------o-EBB------------------E--------o
--------------------XXX-----------?-------oBBBB?B--------------o-----------------------------XXBBX----------------------X----BBB?-----------XMX------------------B----X--------X------------------------
--------------BB----B?MXX-B--------XX---------B??-----X--EX?B-----------MX?------------BB--------------B-----?--X---EXXBBXM--------X---?XXB------------------------BB----XX--------BBBBXX----B?BX-------
-X-------------------BXX?-------MBMBXB----------------------------------MX------XB---------------M---------------B---X---------MX--------------XB-------?----------------------------------BB-----------
---B------X--B------BBX?B-------------BXE-------oB-XB----X----------?-------------B-----------------------------------------?X-------XB-----XBX------------M-------------------------------o?----------v
----------?BX-----o---?BBMX----------------?BX-B---X---B------BB---------------------------------------BBMBM-----BX-BX---------------??XM----------?XX---------------?-X-----------------BBBB--------XXf
BB--?-----------M------XB------MBB?-?---------B---------------------X-----X------X---MB------BXBBB-----------------BB-----?M---------------------------------------------?M----X?--B---------?--o------f
-------X----XB------------------------------------------------------------?-----------------------X?B?B----------X--BB?B----?BBMBXMB--------B-----B--X-------------------------XXBB--------------EBBX--f
---------------------------------EX------?Xoo----X--------------BX----MX---------XX?BM--o?-----------------------------MX---------M?XX--------B-----------BB------oXB-??------oXE----------------------f
------------B--------BBBB-----------X-------?BEBB-------------------BBX----------XX--X--------------???-------XB------------------------------------------XBBXB---------------------BB?-?-----------XB-f
----------MXX--------------o?BB-----------------B?-------------------?-----------o?----------?B------X-B---------------------oBBM------------MXX--------?BM--XBB---------------?BB-------------------E-f
m-----?XX-------B-XXXBX--XX---TXB-----------------?BXTTB--??----M-------EX--------??--B----------XXBM?-----XB--------------------o-X-------------??B----------MXX-------?BX---?X----------------------BX
--------------------M---BBX?--|?B--------XX----o-M---||X---o-----------------------XXBB------XX?X--E--------B-MBBBX---B---------------BBBX------B-B-------------------XBX--?-----M------?--------------X
XXXXXXXXXXX-XXXXX-X|-XXXXXXX-XXXXXXXX-XXXXXXX--X-XX|XXXXXXXXXXXX-X-X-XXX--X-XXXX-X--XXXX|XX|XX-XX---X-XXXXXX-XXXXXXXXXX|X--|XX-XX-XXXX-XXXXX-X-X-XX-XX-|XXXXX-XX-XXX-X|XXXXX|XX|XXXXX-X-|-XXXXX-X-XX-XX|
