----B-T-B-------------------?-o------------E------EBX----M-------E-------------X----|--XoB--------T-----o--?-??-B---|-T---T---------X----?--------------B--X------o--X----o-X---oXXXX-o----------X-----X
-oX---XX--X-X-T----------BM-|-X--------------Xo?X---T-X---------?---------oX---E--E----X?-------------------------o-EX-----o-X---o--------X-X--------?----T--X-?X-o-X-X------X---MX-o----X------X-------
|o-o----X--------------o-?-------------M----?X--X?o--TXX--B--o----o------X--B?X-X-X---X-?----X--XT-X----E-----XoXE-------X----|B-------o--|-X-?-o---|?--TM-BT-X--X---oo---M--------T---o-------X-----|--
-E--X----?---------X----------XX------?-?BM--X------?---------T--X-|-E----------T--B------X-----X---X----X------X--B--------X----o----E-B--X?X-B--------BMM---X---B-To-----oX---o---o?To-?------oX---X--
---Xo----Xo----X--------E--?--X---------------BX-------oo---?B---------Xo-E-----X------------o-X|------o--E---o?----?-------------T-B--X------XB---M------T-----?--??----X------X-?-o--?----o-?----|---o
-Xo---X--XM------?---o-T---X----B---X-o-MX--------o---oX----X-BX-----?-X------------X---E-----XXB---o-------------X--------?--------B---M--------X-----------o---------B?----------B---o-----E-EX-o-----
-------X------X---X---------o-----?------------X------?o-BTBT------X--X--B-M-----------X-?-X----------B--o-------X---XX-XX----X------E---?-----o---X--B--oo-B-------X--X-X---------------X--|-X---------
----------X--?o-----oX-----X--?--B----o---oX--X--------o-------o--BX------B?--o-------Mo--o---------X-----------------|--o--o---------E-----?---------E-X-----Bo---------------------X-o--o-o--o----XM-v
---E-Xo------B--B------X------B--ME------o---------?oX--XB?--X?X----o--?--B-----------X--------------E--B------X-----------XB---X--------o--B--------oX--o---?-X----X-|-X---E----E-o-----o-------E-X---X
-----??---o-E-----?--o-------o-X-Xo---|----X-----X-X--o--B----X---T------X--?B-------X--X---?E-B--X---Mo-X---Xo------o-----------E-o-X--Xo-------oM-------XX---------------oXo----------B?--X-----------
-X---M------X-X-----X-XXo---o-----|--o-----------?--X---oX----------E------X--B-X----o----o-?o--X---B--T-------X-X---------------X-------o--X--E-?BoBX-----?o-XB--------o-------------o--|-X----X----X--
---B--------------------X--------X------?--------o-|---B--------X--E-T---?o--XX---o--E-EB----B-?-----T-----X----B-TX-?--X-|-------o-----E--T----ooE------------X------XE----X---o----X----X----B---XX--?
--X?--o--------B--------X-------?---oM-------X--T|o-T?--EB----X----X---XB-----?-o------o---M-------X-----------X--X------T----B--------XX-|--XX-----X------?---X|-oX?-o-BX-----EBXXX-T------o-----X-----
---------E-----X-----E----X?||----o-----X---?-B---T-o--X------?-X---B-----?---------X----E--X-?X-XM---------?-?-X--?--E----E---o--------X-B------------X--E-----o------------------B-XXX--X-Xo--o-----XE
m|----------X------o---E------------------o?--------ME--X-XX-o----B--?-------?X---X----B----XE-X---------|----E-------E--------B-X|---E----------B-----T-X----------oB----X----------?XB-o--X----Bo-X---
XXXXXXXXXXXXXXXXXXXXXXXXXXXXXXXXXXXXXXXXXXXXXXXXXXXXXXXXXXXXXXXXXXXXXXXXXXXXXXXXXXXXXXXXXXXXXXXXXXXXXXXXXXXXXXXXXXXXXXXXXXXXXXXXXXXXXXXXXXXXXXXXXXXXXXXXXXXXXXXXXXXXXXXXXXXXXXXXXXXXXXXXXXXXXXXXXXXXXXXX
