-----------X--|---o-T--?-B------o-----X---------?---o---------T---B-B-X--oX-------EE-B---B---E?----X-X----B-----Xo-o----X-----XXT---|---E--X-----B-X----XX-X-E-B-oX---X--MX--------BX-o--XXX-X------B---
------T-----BX-X-XX--X-------?-------o-E----oX-T------XX----XE-----o------------X-?-E--X-------?-----Bo-X-----X--E-Xo----------X-------BE----T-------X-XX-X-----?--o-----?--X-o----X----------------?---
-----E|o-X-XX-M-o--T-----X---o--------X?-o---?--T-X---B--|B-XT-------o----M--B----X-BX?--?----B-----X------E-B------o----o---B---T--X-o---o?-o-Bo--B----XM----------------XX--|--M-X--X-|---------X---B-
-B--BX|------o--o---|-?---------o------X------------X-------X--X---TB--X----X--------B---------X----X--X--o-E---|--B---XE------E----X------X---XB-------------X---------X---X----------XX-B-BX--B--To---
------|X---?XB----|------EX--|o-XBM-----o--X--X-o-----T---XE?--B---X?-X--X-M----X--B-----------B-----XX-B---o-----o-oo--T--------XBX----B--?X----XXXoX?----X------XX---XX---X----M--X---X--X?-----------
-----X|-----------------?-X-----X----BT---B-o---M-E-X-----X-X---B----------To-XX---X--------X-----?o------------M-X--Xo---E-----X----ooE---o--Eo|X-X--|--------------XT-X-----X-?-X----X-T-o----X------X
---|--|----Xo------X--X-----X--o----?---oBXXB-X----------------X------X--B-----------o----------------X---------------X---o----------BX---X-----X----o--o-----M-B----T------o----X----X-----B--B--------
---T--|X-X---X-----EX-------o---?-----------X--------E--X-oB--o|--B-----o-X-------X--------------|----XX----?---B------MoX-----M-------X----B----B-----?--E------o---XX-X---X--------X---o-?---M--X-M--v
XX----|?--------?------B-T-----X-X---X-o----------------------------X-E-T--o------X------o-MX-------E-T--X---X--T----X-o-X-----XMo--T---XX-----oX--X-------X------B-X----?--X---E--|-B-----------B---X?B
--T-Xo|-o------X------o-------XEX-o--?--o-T--------|M---X-o---B--------E|----------B--o-----X-XB---B-EoBT--X--|---o|-------B-X-------------B----oo--X-----XX--------B-X---B--M--------X--o---o--X--XX---
------|--|?XB-E----------XX-X----------M---------B---X-----X--X---------E----XXX---T---------------------X-XX-oo---X--------?-----?X--B------o-X----o--X-----X-----?------------T-oX----??---E--------oT
X---?-|-B---X----X-|-X------M---------X--Xo-------E--B--------------X--?-B---XBT---o----?B-----E--To-X---------XX----B--------X-EEX--------|----T-X----X--X-----------------------X-X----X---o-MX-------
X-o---|---E--|---X----X-X-B------T----------o------B----E----XBo--X-?-----|X--oX--?---Bo-------TX?--X--------X--?--o----E------B?-----o--o---E--?---------X------o--?-----------?X---X-------M--------?-
M----o|--B-------------T---XX-XX---o---B-----B--o----B------o-X-----B--B-XX----M-B--M-XoE?|----------T-X----------------|-X---?X-----X-XMBB-----X?-X-----M-XB--XX-----E-o---------o------MX-X-----------
m-?BX-|--------X-X--------E--E-------------X-----X-----oo----X---Mo-------X--------X-X----XE--T-BE-XX------X-----E--------------?o--o?-|-------------X------------X-E---M---X----------?X----B---------|
X-----XX?-------------MB-------X-----X?----?------Bo---MX----B----X------------------B---oo---M--X?----X--?----------Xo|----XB-oT------------E----X-X-M--X--EoB-------X-E--E---?---oX--------|-B--------
