-------------?---B--o---------------------?E--oT--------------------B---o--X--E----------o--------o----?-----------B---T----ooM-o---E---B----------E-?---M-E----?-----M--E----X-----o----------B-T------
BX-----M--o---------------------EooB-------------o--oB-?--------B-B---------------o-----------E------------B----------?-------o|-------?--?----o----------E-o---?---------------------o---------E---B---
---B----------o----B------oT-----?-----|-------X-------------|-T----B---B-T---------------------------M-X---------T?---B----?B----------B----o-Bo--------------o--X---------B---------o-----------T-----
E--oX-o-------ME------------E----?--?----------XE---------oB--T-------------------------E----o---E-----------------B--------------------?------------o-?---X----E--o-------BB--------XE---B-B---------o-
----------o--------B-----------------------------------T----|------------o-----T---T---------E---o-------B-----T---E?--------o------M-------E--o----T-----BB----T-------------------------|--B?----o----
--|E---------B---------------------?----------------------------------------------------E-------B-------T----------------|--B----------M--------?B------M--------?----BB?-----T---M--B----|------------E
----------------|-B----------T-------BB----?--------------------?----B-?----|--o-----Bo-------?------M------T-o--------------?-----M----T-o--X------------o-o----B-----------?--B--E-------------E---E--
---E--X------Bo-----------|----B------E----------?----B-------------M--------?o-------E----o-----------o------?----------------o-----------------B--------|---------|--------------T---XB-------------Xv
--T------E---oE----------o--o----------o------------o---------?------o?---B---Xo---?----o?B------M------o-------------|--?X---------------E---------B-------------------------BX---B-Mo-B-------B-------
------------------------?--T-----X----------B----o-------B------B----M-------?--B-------E-----X----B-?|--M------------o----------------------------M------X-----------B?-----o--|-----o----B------------
------o--E--------B--B-B-----BB--X|---B--?-o-------o----------------E?-----|--E------------------------B---------?----o-------------------------o-------o-------------?---?--|--E---|-?------E----B-----
---|-E-------|---------------o--M-B-B---Xoo-----------E--B------o--o-|-------|-M-----BM------o---B---oo-----M-------------B--------------------Xo--?--B-B-----E---M-------------------------E--o--TE----
--------------------------------B------------oo------B---------?-X------------|-----------o----------E------------M---B-----o----------M---X--?-B-BBB-----------oMo-BE----------o------B---------------B
-------------o-------B--B-----M-o-B----------?-----o----o--E-----------o----------------B------E------E-----o------------------------------|--------Bo----------?------?oE----o---------------o-----B---
m---X------B---E-------o-B--------------oE--------------T--------X--------------X-----?-?--M----------B-o----E------------------B------oo-o-E-X-----------------B-------M--B-------B------------o-------
--B---o--B--X-------------------------T----B---------------------E?------------------E---X----o-----------B----------|-------------------BBB-----BT----E--B------E-------------E---?-------T-?----B--?--
