-?XBB-----B--------MXBBXBBBB?----------------BB-MXXX----X-------------------------B---------------------M-----------------XBBBBM-B-------------------------M----------------B-------------o-oB---------o
-------------B----X---------X------BMB?-------XXXMB-X?------------------MB?B--B---BB---------XXX----------------MX-----?------------------------------------------BBB--------------------MB-------------
---------?BM?-------BX-------------BX----------------------------------XXXX-----------------------XXB----------oX---------------------BXBX---M----------B--XBM---XBBM----------------------------?------
-------oBB--------oBBX-------B-XB----MB-------------BB--?M-------------XM-------MX-------BB-B---------------------------o-------B---------X-?BB---------------B---------XB?-------------------------XXBo
--------------------XB-----------BXB?-----o--BB?---------------o??---------------------XX-----XXX--------------M--------------------------B--BBBXB--------BBB---o---B?--MBX--------oMMMXB?X?--XXBB---X--
--XoXM??B-----BB?---XXMX--B--------BX---------X------------MB?----------B-MBXBB--oBX--------------XB------B-----------B---B?-?BB-MX----BB---?XB-------------MBB----B??-------XXXMBBBX-----------B-------
-MXBM----------------BBXB-------MBBBB-----------X---------------M----------------------?-----------X?X-------XBB?B--------o-B?---------------------------------------?BB-----------MXXXBXXX?-X----------
---EXoBB--XB-------XMB-------------X------------B?BBBB-----------------XXXBB------------oX---------------------BB?X--------??X-----------B-?XBB?XX---B------B--------BB----BBX-----------XXB-----------v
BM--------XXB??B------------------XX-----------oX--BB---------X?---------------------------------------MXB-------XX-XX---------------?B-X------------XXBB---------------------XM-----------------------f
XM-----------------BBBXBBB-----XBXBB----------?B?X----------BB-----XBB---------X--------------?----B------------BXXXB----------BB---------?-B?--------------B---XBoBB------B------BBBBM-------------M--f
-------?X---XXX--------MM?-------------MXBB-----?-----------XXX-----------?-----BX---------------------------------B?-------o------------------------XB------------BX--B----BM-------------------------f
---------------------------------------------XXB---BMX---M?BXBX--------MBB---XBXXB-----------BXMM---BBBX?---BB----------------B--------B?-----------X-XB-------?XX-----MBBBX------oB-oBMXX-------------f
----------------------------------------XM--------------XB----BBM-----MMBB--XBX---------------------?EX-------XB------------------------------------------MB------------------------BB-MXB---E??-------f
----------MMX----------------------------------?X---------------------------XB-------BX--------------------------?B-MXB??XXM----------X---------------------MBB-XB---------------------XB----XBBBM-----f
m-----X---------B-BBBB---?X-----?M----------------XX------B-----BMX-----B---------BM--BXXB--------BB------------XBX?----o-B?B?BB----XXB----XBXX----B?---T-X--------B-T-------------------B--BB---------X
XXBBX?------------M-----BMBB--------BMM??BBXB---XXM-----BX------------------BB??------BBBBB?BB-BXXBXBBB-------XoB?B------------BB---B-----------------------B------BMX-------------------BX?M----------X
XXXXXXXXXXX-XXXXX-X|-XXXXXXX-XXXXXXXX-XXXXXXX--X-XX|XXXXXXXXXXXX-X-X-XXX--X-XXXX-X--XXXX|XX|XX-XX---X-XXXXXX-XXXXXXXXXX|X--|XX-XX-XXXX-XXXXX-X-X-XX-XX-|XXXXX-XX-XXX-X|XXXXX|XX|XXXXX-X-|-XXXXX-X-XX-XX|
