--o-------M----?---------o----------?B------XE--------B?EX-?-B--------T----------?T-|------B---EX---------------------T------------------oE--MX---T--------------------o-----------o---------E----------
--o-----B-EE----B-----M------E-B-?---------E--------------------------------------?-----B---o?B-B--T--------------------E-M---E-B----T-----------------------------B---o--X--o-------?----o--E----------
--o-------------|o--------E--?---------------------------E----o------?----B-----?---B---?---------E-BE-----o-----M----?-----------T------?B---o--------------------------o----------M------M----Xo------
---X-----o-------------?----|----?-?---B----ET------?------o--------T-----B-----------B-----o----------E--o-----BX----------E----?-------------E-------------?----M-------------------T------------T??--
-------B--------XE---o-------------E-E---------E------|---------E-o-M-----------------BX---|--?----M-E---B---?B-------M-------o--T--------|---M-o---------B---------------o-----------T--BM--B---?------
----------|---X--E-----?--M-o-----------M-E-o----E---------M--o--?----------B--------B----|--------X-----o-----E----o-MBB---o-------B---X---?-----X-----------------B--------------------o----|-o-----?-
-------|-------?-M---B--o----------E-?B---------------------o-------ME---E-----B--------?--oE---X-B--------?----E--B----------B-------o----------------Mo------?--------E-o|------E---|o------B--------M
--------?-MB------------X--------M-o-----------|---E--E--ME-------o-------|B-------o------B--------o-----?--------------T-----------B-----M-------B------o---E------o----?oo----------B-E--------------v
-?--------------------------X-B----B---B----------T------------T----------------------?-------o--o---------o-----o-E----o-------------------------B-M-------E---------------|-------------B--T----------
--B----M-T---o-----------------T----B------------------E-T-------B--BE-----X---|----M--------?o------?----?----E---B--B------------------------------?---------------------------|---B-----o--B-M-----?-
-E-----E----E-------X--------X---o-B------|---------------T-B------E--?B-----B-------T-------oM-o--------X---?-------X--B--------o?-?-----o-----|------------B-B-B-------------Bo-M-E----------T-B------
-T------------------------B--E-o---------?-------------B---o--|--------B------B--?-------|------------------------o--------------EX-------------------|----------------E-M--o------|----------B-o-o-XB--
--------X----E-?------------E-??------E---X--------|o----------------------------M---T---|-------B------M-------------------------T-o---?-----B----B---E--?-------X--------EB-------------?-?-------X---
--B------|----------|------o--------------B-------?------T-o----X?-------------Bo-M------E---------E--B--M-----T------E--------?--?-----?-------E-----------------------------------BT-o-----M--B-------
m--X------?--X------o------B---M-------B-o-----T-----o-E--------M---E----E---T--oo--------------------B--|---------------------------?--B--------?-------------E---B------|B-E--------------------------
XXXXXXXXXXXXXXXXXXXXXXXXXXXXXXXXXXXXXXXXXXXXXXXXXXXXXXXXXXXXXXXXXXXXXXXXXXXXXXXXXXXXXXXXXXXXXXXXXXXXXXXXXXXXXXXXXXXXXXXXXXXXXXXXXXXXXXXXXXXXXXXXXXXXXXXXXXXXXXXXXXXXXXXXXXXXXXXXXXXXXXXXXXXXXXXXXXXXXXXX
