----------o---------?--------XX--B-MXBBBX------------------------B-XX??XMM----------------------B-BBB?M?MX---BB-----------------------------------------------------------------------------------------
---MBB?XBEX--o-------------------X---------------M?-MB--------------------B---------------------------M?XX--------MM------X-----------?B---Mo------M----------------------------MB----------B-----------
---------B-------X?BBBB--------------------X-------------------------o-??B---------B-------XXBB?-----------BXX------------------oXoBB------oBM?-oB?-------------------B-------BB??M??-----------XBB?X---
------XM---XB-------XBoB-----------o---XB--------------------------------oX------EX-------------------------XMXX-X------------------?------B----------------X--BB----B------XXMB-------M?BX?X-----------
-----?----------------------?X--------------------------BM---X?BX-B-B-------------------MBBB--------X?XX-------------XB-o--XBX----------------------oB--------BB----------o?---------X??B------------XB-
-----B--------------------?----------------BE------------------------------------BX--------------------?XB--XMB--BXX----?--B--------?B-?BB---------------------------o-MBXM---------------MMX---XX------
-----------XX------XXBB?BXMBBoB-----------BB---XX-----X-----B-XBBMB----------X-?BXBB-BXX--------B---B----------X------B------X--------XBMBMXM---BBBoB---------------------------------------BMX?---B----
B---------------------o---------E-----?BX--BB-----?--o------------------------------------X--------------oX?----BB-----BBX----MX-------B----------------------?X-------MX-BX---------------------------v
-------------------------BB---------?BB---------------------------------------------------------?-o?-M------------BM-----------------------------M--E----MBBBB-----M---X?----?B--------B--------?E----Xf
-------------B-------------??BBoBBXXXM-------MBBBBX?--------???XB----------BX----BBBB---------?B-----BX---MBMBB-------------BBMBBX-----------------------XX-------XXXXX----------M?-----B---?----------f
---------------BMX---?-BM-----------XBB----------------B----------B-------------B?--MB----B?------------------XBBB---------X?B--------?B?--------BXXBXX---------------X--------------------------------f
-------B------XBoBBX-B------------MX--B------o------------B--X----------------------------?-------------------------BXX----B-----B-B--BE---------------------------------X----------------BB--B--------f
-----BB?-----MBBB----------------------B-BBXB?Bo------------------o---------B-------------------------BB---------M----------------oB?B----------------------------------------------BBBX---------------f
----------------------------?--------BB?------------BX-----------BBX--M-----BBMXXX-------------------------X-------------BB?B---------------?M---XX---------o??-----XB------X-----X-X-XB-B-------------f
m-----------------------BBBB-----------------B----?---B-?X---------B?-X--------BX----BXBBB----BX-----------------------------M?-------?M-MBB-----oXBB----------------------------------------XX?--XB---X
X?BX-----B----XM-------Eo?---------X----------------------------------BB-X-------------------------------oBMX------------------------------X-----------------------------XBMB------X-------?B-BB?------X
