---oB-----B------------|----o---------------------------o--oE------------?E----E---o--B---------T-??----------------------------XB---------o--------------------?------TE--------------?----o-----------
--o-----BX-------------------------E---B-----T-o---------B-?-----------B-B|-o--------?-B-------------?-------------------B?------------X----T-BB--B-o-----o---oB-??--?-------o----------B--X------------
M-------------M-o|M--------o----o------T-----------E------?B-------o-----X-B-----------------------?--?------------B----------E-------------------------------------------M-----------------------------
?--X-o-------o--oB---TM------------------------B-----Eo------o------E-------B------------------B----------------M---------------o-----BoBE-----------------------E--o-M-------------|-----------T-------
----o----X--E----------E-----------E-o-T-?------E--------X-----------------M-B-o-------B-----?----|-----M-ToX----E------M-o?------------B----------B---------o-?-------X--------------?--?-----B-------?
-E-----|-------B--TE-B------------------------o--------?|-----------------------X-------M---E------o--------TB-E?--?-?-BE-----??----B----------------?-|---------o----X-------T-M---------X---|--------?
--oo---------------------------??------------E-B-----T?------B-------M-----B-------o------------------B--M-X-----B---oo--------?---M-------X---B---------------B-B-----?----------B---------------X-----
-B---E-------------?----------------?---------?-------o-----o--T---X-----B-----M-------o------o-B--------o-----E--?---B--------B---------B------------B-----------------E-------------?---BMM-----o---Bv
-------|T-----T--|-o-------XME-----E--?--B--oo----------M---------B-o-----X---------B?--oT|--------o-X----BB-?------X----------o----o-X-------E--T------EMT-----------------|----E-B---------o------B---
--------o------B-----E-----------------E-?--o-B--------------------------------------B-B-----------T---------------B---M---------------Bo-o-o-EBM--B-------E-----------T-------B--B---------------B----?
-------?------Eo---------------------------X--o-----o---T-------B----?-??E-|----------------T--------------------B--?------------------------M--E-------B---?-To---?-EX--B----------------E-----------B-
------|-----------o--E---E--------------------------------o-----E--B-B---o---------?-o-----------------|--------o------oM----o---------B-?------o--o-B------------o------Mo--B--------------------?----E
------B-M-E-------------------o----------------B-----------T--?-B------B---X----------E----M---?-?---B----E---?--------------------o------------Bo-----o---------E--------B-------E---B-o-TBo---------B-
---MB---M-MB-E------B----------------?-------E-------------------------?------B-----------?o------?------------|-------------E--X-X-----------|------o--------------------B-----E----------ET--B-B|-----
m-------E-----X------oB---------?----B--E------B-------o------EM----B-------B-----------E---?-----?--E----------B---------------E----?------E-?X?--------o----T--------o-----o---------X-----------o----
---X------|o--------------oB--------B-|---o-----|-----------|-E---------E-M--o-------------------?------?-TB---------?o?-----??---------E-----o-----B----------------------o----------E-----o-----------
