?---E-X--B----o---X----E--------B---------------XXX--B---B---X-o------B------X----BX--------BE---------------XB-E----X--------Xo--BX-------------E-o--X-X-X--o--------o--oB-------X--XB-----------------
----X--oB--X--o-B-X-----X----X-o-oXEM-X-----------MX-X-X--E-?---X----------E------------X-X-------o-X-------X---B--X----B-----------X-X-Xo--?--------------B---EXo-----XE-o-oX------X------o---------X--
-o---------X----------XX-----o-------BE--X--------o-B-----X-X?----E--------E-B-o---EX----------------?------o--EB----------X--X--B---------E--------X-X---oX-----------o--B---------X---B-X-X--------B-X
X?----X-?----X-o-----XX----------oo--?---B----E--------B-X-X----o---------------B-X----------BX---X--o----X-X-------oB-----------X-------X---X------X--o---B-------X--------BB------E-X-----B--X-X--o---
----B--X--?--oX--MX-------o----X----------------B-X------------X------------X-------X--XX--------------------EX--B-------X?B--X--o-XXX-M---------XX----X------------------o-XX-------B--B----o--M--X---B
-X-?--Eo-----B-----o--B------X-------B-----------E?----?---------BX-----------o--X-----B-------XX----o--XX-E-o--------X---------o-X---------------E--o----E-o-o-B-X---X-X--B-----------XE-----X-------X-
---o--X---X?------E--XB-------o----XX--oo-X--------B-B---------XXX--X------X---X-------------M----X--oX--?--------B-----------B--?-EX--X----E-------X-------?---------------X--XX-----XX-----------?----
------o------------XX-------o--X--------X--o-B--B--X------X--------oE-X--------X----o-o----oo--B--B-----------------o-------o----o--X------X--E-------------X-------?--?-X--X----oX---X--X-?-----------v
--X-E-----X----E---------Xo--X-----------X--?--B---o----X--o--E--------X---X-B------o------X-------XBXEX----B-?oX------X--?-------M----X---?X-?---------oo---------X---o--------oX-o------B-B-------B?--
?X--o------X--X-BM-----o--o----X-------XXo-------Mo-----------B-----?X--ooX-XX--X-----?---------------------B---?B----------X-----B---X-?--EB----------oX--B------X------E----------B---XX---------o-X-?
----XX--XE-----X-------X----X--X----B----XX----X------XB--o---------XX---------X------Xo---X------?--X-X---E--o--------X---E--B--Xo-X----X----?---o-XM-B----------X--X--------------X------XX---XE------
--E-----??--B-o-E--B?-B--B----------B----XX-------?----?--B-X--X-E--B-----Xo-----------?----X-----o-----E-------X---X--o----BoX------?-B-E--------------B-------BXXX-X---X--o-----E-o----------o--?-----
--------E-B--------o-----oMo-?X----o---------?--------X---o-B-oX-X-X---o-----------MB----oE---oX-EXX--X----?X-B-------?----XX---X--E--X------B------E--X--o--X-----------?----Xo---------B------M-X--XXo
X------X--o-----X------o--X-----o?-----X-----------X-------B-B-X-X-XX-?-B---X--XX--------?X-?----------X-----B-B---o-------------B------Xo--X----X--------M------?------------B---B-X---X?---?----------
m-----|B-X-----X--------?------X------B---X---B---|M-E--X-----X--o--?------X--XE--oX-X--B|--?--X-----X------------E--M--XE-B|---o-o--X----X-------o---oXE-?-X---o--X---X-BB-X----X------|-----M--X---B--
XXXXXXXXXXXXXXXXXXXXXXXXXXXXXXXXXXXXXXXXXXXXXXXXXXXXXXXXXXXXXXXXXXXXXXXXXXXXXXXXXXXXXXXXXXXXXXXXXXXXXXXXXXXXXXXXXXXXXXXXXXXXXXXXXXXXXXXXXXXXXXXXXXXXXXXXXXXXXXXXXXXXXXXXXXXXXXXXXXXXXXXXXXXXXXXXXXXXXXXX
