---T---------o----------X------------------|------------|-----X--o-----------------E-o-----|----------?---M------------BB---B---B---EB-----|--------------?------B-----o-T------------B-M---------------
--E-M-------?B---------B--o-B-------------------------B--------E--------------M----------B--BB----?-----T--------oo----oB----EM-?-o-X-------------------------------------E-----?--------|--B-X?------X-
M-------B--o---E-B---|--o-----o--B---------Mo-E------B--T---E-----T------?-B-B---X---------------------------?--E-------------------------?----o-----|-----T--?--M----B---?-MM--------E-----------------
---------------B---------o-------------X---------------------|----B----------X-T---------------B--B--o-----o-------------o-?-M--?-------------?-----------BTT-o--ToB--------------------------B---------
----------------o--E---|---M---T-------------------o---|---------------E?-B------T-----------o-----o--------E--B-----B--------------|---TB----|--?-----X----------BE---X-----------------o---------M----
-o|-------?--------------X-o-----------------T-To--B-E---------------------------------E---B--------B--B--|-|--o---o-----B-------BE|-?----------E-------------B-B--o----?--------E--E?----B----|--o?----
-------------------------------------BB-X------?-----o?--?---------E-----------o-------T-----|-------o?-M?-----------------E-----------------E------E------?---------------B--E----E-----E--o---------T-
|------------------T--------------|o--------X-------------------?-------E----M----E--------X-X-------oE------?-ET--B-------------?----oo-----T------B--B-----B-------B------------------M------?B------v
-----X----?----------o-E--T-----------M-Eo---B---B--B-B--------------oo-----o---------B------BB-B-oE---T----?-B-T------o?o--------BB--------E------------Eo-----B----B---------|B-----------------------
-----B--M---o--B-------BE----?----------o--XBM------------E-----o----E----------|---B------E-----------------------B--ET------o-B---X--M-B--oE---T-|----o---------M--E?M---o------B--B----?---B-------B-
---------?-------------?-----E------------?----B---|--?---------------?X-T-?B--------|Bo----|--?BTE--TE------?-----B----|---B-?---M-------B-E----------?--------------------------ME---------M----------
-E----------?---|--oo----------------E------?--T--------?---|--E--------B-o-------------------oBE--o-----------------o-----?B-?--?T--B------T-----?----E----?----------------------------B--o------E----
----X-B---o-----E--------oB----o---------o--------oo-?------M-TB|------B------------o------------?T---B-BT------------------B-------B-T---------------B----------?-------EE-|---E----------E-----?---B--
----------------?-----------------?--oT--T-?B----------------M------oB---E----M-----|---X---------|-B-T-----------------B--T-o---E-------MBB---------T----B-------B------------MM----o----?-----XE|-----
m------M--B--B-------------T--o-oo--E---------------------------B----B?X------------------------|---B------?X-----T-----B-----------------?-T---?T-------T-o---------B--o----B---------------o-o--To?--E
--EB--------M------M-----E--E----------------------|---B-B---o-------o-M------E-B-------------o----?-----X--o----------?----------------B----------?B------------o-o-?--B-B--M----X----B------------?-EE
