X--XX--------------------XB-B----------E-------X----------?----o----o----X-o----B--------E------X-----------X--?----XX-----------B--?-X---o--Xo?-XB?X----X----------------Xo-X---o--B?------------o--B--
--B---T-X-X-M--Bo---M----X---------M-X-B--?o--X---o------?o-----EM--E---Moo-------X--?-----X------X---?--B--X----X-------oE--o--------o---?---?--M-------X-------oX-X--E----o-X------X--oB-X---o-----oB-
--X---|-----------?X--?--X---Xo--o--XX-o-------o------X------X--XoX-X?--?--oo-X---X--B--oXX-BX?----------B---X-X---o----------X-B-X-M--XMBE---XX--X---B------X---Xo-B----------------X------------X-X--X
-X----|----E-------X------X---X-?B-----o-------X------------X-o------XXX?-------o-M---?o-----X---B-----------B-------X----------XX---XX-X--Mo----------oX-X---X-M-----X--X---X------X-X-o---X--X-X------
------|-BX-o-X-------------o----X----X-X-MXE--oX----o-------oX-----X-o--X--XX-------B---X----?XX--X--X---o--X----o------------X-----o---o--------X-------------B----------X-X-E-oX?Eo-------X-----o-----
--X--X|-------X-X--X-----o-----o--E-----XX--?----oX-----X---o-o-BX------XEM?--X----o-X----o---?-----X---E-o---X-BB---------XE----B---X--E-X--B----------BXoX---M---X-o----------X?---XX----------o-----X
------|X-X---E-o---BMB--?---X------------B-------EXM--------------o----X-XXB-X-XX-----------------------X----E-------------B-----E--M---XX--?----o--oX---------------X------?-X----?-------B------X-EX--
X--Bo-|XX-------oE-----B-oX--------------E--Xo---?B----?------Xo-oX--?---------------B--X---------X----E--o--------o-X---B-??----Xo--EX--B-------E-----o---o--?----B-XX---------X-------------EX-----o-v
----B-|------X-X-EB------X----B------XX-----?--------oE-------X--------X--BE---------?B-X-----X----X---------X--oB-----oX-X---o--------X--oE-o--X--o-----M----------E---EX-BBo--M----o--E---X--------X--
--X-B-|----X-----X----------------------------X---X------E---------XX-XX?----E------?--B-----?---------X-----------X------B--XX----?---------B-X---------X-o--M-XXE------X------------X----X--X---B-----
BX---B|-X--?-X--X-X---------M?----X--------?----XXo----X------------B--X--o----X---o----o--X------?------X-X--B----X-----XE----B?-------------X----B?-------o--X-X-X--X-X--?---X-----X---o--------B-X---
---B--|-o-?-E-----X--------X-o--X-X-------E----X--o-XX--------------?o------------?-oBE--XXX--------------XBX-----oE--B--------------?---XEo---------------------X---X-MB--X----X----XXX-X--?-X-------E-
--?---|--TX-o---o-X---o-------------B-B--------X--X--XB-----?-----MB------E--X--EM-------?---o----oXX-B-----X--X----BX--------X--o-M---EEB--o?o----X----E----BX-----?-o-------------E?-------X--------XX
--oT--|--|---E---XX-TBX---?T--?BE-?X-------------------B--X--?Xo--E-------X-------T----M-------X-------?-X---X------X--X-T-ooX--oo------------?---X--?--o---o?--oX-------------------MX----o----B--X-X--
mX-|-M|--|--XB-----X|---X-XT--X--oB-M-M-BX-------X-X----------?-------X-X---------T-------X------X-----XoB-X-----X--MB---T-X-Xo--X--Xo----o------------------B-X---------o--o--XX---o---X-----X----X----
XXXXXXXXXXXXXXXXXXXXXXXXXXXXXXXXXXXXXXXXXXXXXXXXXXXXXXXXXXXXXXXXXXXXXXXXXXXXXXXXXXXXXXXXXXXXXXXXXXXXXXXXXXXXXXXXXXXXXXXXXXXXXXXXXXXXXXXXXXXXXXXXXXXXXXXXXXXXXXXXXXXXXXXXXXXXXXXXXXXXXXXXXXXXXXXXXXXXXXXX
