-BXBB-----BB-------BBBBX?B-X?XX--------------BB-MB------X-------------------------B---------------------?X----------------X-XX--BXB--------B--------------------EBB-----?-------XB--MBB--X-----------?Xo
-------------BM---?---------XM-----BMB--------XXMMB-XB------------------M??---?---BB---------XB-----------------BX-----?-------------------------------------------BMo------------------------B---------
---------?BB--------BX-------------BXB-------------------XB-----------------B---------------------------------------------------------------------------?BB?XXX-------------------X-M--o---------o------
-------oBBX------------BXXMB----------------B??--X-----XXB----B-B-----------------------BXB-----------------------------X----BB-------?--B------?M--------------M-----BXXB-B---------BBXX------BXBB?---o
--------------------X?-----------BXM------o--XBM-------------?-X--------o-------------?BB---XX-BXX--------------------------------X--X-M----------?-----?--?----------------oB--------------------------
--XoXM??MM----BB?---XXM---B--------XX---------XB-----------M?-----------X-BBX----BB---------------XB------B-----------BX-----------XBBM----------------------oBX-----------------oMX----------------?X?-
-M?------------------BBB?-------MXMBBM----------X---------------X------------?-------------------------------------------BX---B---?-XB------------oB--------------------------------?B----B-MXB--M------
---M-XBB--BB-------XMB-----------------o---M?-----------X---------oXXX-X-X-XX----?BXMXX----MB-X-----XBBBM?X-MB??X?B---B?XX----oB-BX-XXBB--------XXXXBo-------?BX-------------------?BXB---------BB-----v
BMMBB-----?XBM?BB-----------------BX?-----------XXM?BX---------------------------B-?MMMMB-------?-----?MMB--MM--------------------?M--B----------------------o----------------------------B?BX---------f
XM-----------------BBBXBBB?----XBXBo----------XB?-----------BBB----XXB---------XXXX-----------?----B-------------X-------X-----------------?B-------------B---M-----B---?X-XX-----M-------------XM----Bf
-------?XB?-XXXB-------MM??B-----------XBBXMX---?X----------XXX-----------XX----XX---------------------------------BMXXX---M---------------B?X-----BB-----o--------------------o--------------------XB-f
---------------------------------------------XXB---BMB---MBBBX---------MBBB--XX------------B--------------------XB---??BX?---X-XX------BB-?X------------XX------BX-------BX----XBXMBB-BXXXX------B-----f
----------------------------------------XM--------------EX----M-------MBB------X---?B---------BBMBBB------X----B--B---------?XX---------------B?X----MX------------------------X?---------------BBX----f
----------MMXB---------------------------------?X---------------------------XB-------BX-----------BBBXB--B---------------------B?---------BB-------------MXX?BB-----M-oBBX---XB--------BM?oB---BBBoB-o-f
m-----?---------BXBXB--T-?------B-----------------BXXB----B-----B-------?----------------------------------MB--------?----TXB-----X-------------X--oMM??-BXBB--------TXX-----E?------------------------X
XXXBX?X-----------M-E--MMX-----------T?M-----------??----M------------------XB-----------------------------X-----BX---o---BEX?X--B---?---B---------------------------|B-----------B---XXXX----------B--X
XXXXXXXXXXX-XXXXX-X|-XXXXXXX-XXXXXXXX-XXXXXXX--X-XX|XXXXXXXXXXXX-X-X-XXX--X-XXXX-X--XXXX|XX|XX-XX---X-XXXXXX-XXXXXXXXXX|X--|XX-XX-XXXX-XXXXX-X-X-XX-XX-|XXXXX-XX-XXX-X|XXXXX|XX|XXXXX-X-|-XXXXX-X-XX-XX|
