----?------------BX-B-B------B---X--XX--M---?------X--o--B---XB-----o--------EX--o---o----X------------X-------XM---X----X--------?XX------BX?-----oE---?-----o-M-------X--------?--X---B---E--B-XE----X
E-----T--oM------X-X?-----X--------------XXo---X-----X-----XX--X-------XB---E--X-----X--BB-o--XE---Eo----B-------M---------X----oE---?X--X-----------o--X--------E-------B---o----?------B---X-o---?-M?-
-----o|----------?----o--B------------E--------E--B---X----E-------B---XEo--oX-X------o---o---XX---o------o-o--------X---X-------B---------oX--X---X-X----?-XX--------------X-----------X---X---o----B--
------|--EXX-E-------BXo---X-----X-X-B--------X------------X?o-----B----------o-------------XoX-------------------E----BX-------X-----------X---X--X-X------BX----------B--------E---------XX----oM--B?-
---X--|B--X-?-----B-------o--X--X--X----X---B--EXX---?---o-----------XB------M-----------E---------E-----------X-----------X-Xo---B-X---------B--o--X----X-E----------------X--B----B-?-X-----X------o-X
------|-X--XE---------o--M-------X----XX-------XX?-----o--XMX-X---X-X------XX----X---X------X---EXX----------------------------E--X-----B--B----------X-X--------B----XE-o----X-------------X-M---------
-----X|--X-----XXX--B-------X-----X---B----o------B--------E----o------------------B--X--X--o----------X---o-oB------X-XX--------BXX-B-o-----B-X---X-----BB-o--o-------------X-----XX-----X-----X-B-BX--
------|------?-X-------E--o--M------------XX---------X---------------------o-?-BB-----?--X-?---X----X-X---o--X-B-----o---X-?-------X-B------B-XB----E-----X---------o---B----o--B-B-------X--XEo-------v
-oX---|---XX------X-Bo-X------------ME-----B-----------X?--B--XX--?--X-----X------X---X-----o--X----X---------------E-M-X-----o--------Xo-------------B----o-----------X-----X-------X--Xo-?-X-X?-----X-
-M--o-|-?-----X---X--X--X--o------------?X--XX-B--?X-?----X-B------------o--X----------------B----------------------------------X-----o--X------------?X----X-BB---X---X-----E----o-----BX--o?-E--------
------|BXMX--------X-o-B-----------MX--B---B-X---B-?---o----XE------X-----X-------oX----------XoX-------M---------B-X----------BX--X---------X--------------X---X-BXM----------o-B---o---E----?X--Bo----
M----X|-X---o----E--o---?-------X--------E-X-X---o----?---X-X-X-X-Xo--B--X-------XX---------o---XEX-BE-----o??E-------B---------o-XoB--oMXX--------B---o--M---------B-EX--------X--?----X---E-X--X---X--
--TTB-|--TX-XE-oX-------XX-------------X?XEX-B----X-----------XX-----X-----oX-B---o-B-E-----X-------o------B---X---X--M-X-----E-XX----------------E--------B------X-----X--------X-----o-?---o---XX-E--X
o-||--|--|-------------XXo--X---------B-------XT------B--EXX------?-E---------X---------T---E-E----------B--X--E------X-X--o--?----X-X------X----X-T-------?-------o-----------B-X-Xo--X------o---XTX---
m-||X-|-B|-o----------E-XX------o--o----M------T--------------?-----o---X----o---M?-----|---XB------?-----XB--M-----X--------X------X-----------?--|---o--XTX---B-------B-o--??----X---?--------X--T----
XXXXXXXXXXXXXXXXXXXXXXXXXXXXXXXXXXXXXXXXXXXXXXXXXXXXXXXXXXXXXXXXXXXXXXXXXXXXXXXXXXXXXXXXXXXXXXXXXXXXXXXXXXXXXXXXXXXXXXXXXXXXXXXXXXXXXXXXXXXXXXXXXXXXXXXXXXXXXXXXXXXXXXXXXXXXXXXXXXXXXXXXXXXXXXXXXXXXXXXX
