------------?---------B-------oX------BMBBB----?-----------------------------XBBM---M-M-----------------------o---------oBB---??X-------M-MX--B?------oB---------------------------oXB---BXX?B----------
---------XXXXB---------------------------------------------------------BB-B?o-------XB-----------B-------EXXXB??Mo--BXX---BBXBX------XXX?-----------B------------X--------------------------------XB----
-?-?---X-------XMB---------------BB------XB-----BBB----XXBB-------------XM?-----------?---BBBM------oBX---XB----??---------BB?---------------oBBX--------MB?------------------------------XMX?oXB-------
BX-----------------B?XXB-BB------------?------------------------X--BBBX---------------------?X?B---------BM?----XXX-----BMB--------------X-MB?BMXBM--------BB--B?BXB---------X--XBXX?XBo----B---XBXX----
---------------?B----M-------B-oX-oX-------?B-------------?------------------XB-----------------------------------X-------------------XBB?BBBM?B------------o??XBBXB?BX----------BM--XX---X?------------
--------??---B-X------XBBB------------?X-B--------M-----------------?MXX------BXM-------------------------------------MX---B--------B----------------X-------------oXXXX-----XM?---------XM-BX?------?B-
XBB-------------BB-B?-?X-----------------o-B--------M--------BX-------------------M--X---B?X----??XXBB-----------------B-----X-----------XX--------------?----------------------------------------M-----
---------------------------?BXBX-BBXXX-------------B-----------------o-?BB----BXXBB---XXM-B----B----M----------------------------------------X?BX----------B---------B-----MX-----M-----------------BEMv
XBB-----?XMM----------------MBBB?---------------------X?----o?X-----BB-------BMM?B-------?XMB-------BXB-------------------oXB-o-----------------M----------B?------B-B-----XB---------?XEB----B--------f
-----------------------------------------------EB-----------------------X---XBMMBoB?-XXX-BBBB--------BXX-X---------------B-------XXX?-------------XM------------------?BM--M-------M-XB-------------MM-f
-----?XX?BB-BBX-----BBB---o---B?----M------------------oX---------------o---?---------------------------XXMoX------------BX-------B?---------BBX--X------X----MX-------B-B?--M-M----B------?X-------?--f
--------------------X---BBXE?B-------------BX-------------------BB---BB----------X------------B?X-------------------------------M?-XMB-------?------?B--BB---B--------------?---X?B--o-------X---------f
-----X--------X---------X-MXX-----------------------------------------------MBM-----------------B---------o------?BBB-----------B?--B--BB--------------------X?M--oM---BB--BMoX----o-BX--XXX-X-----X---f
--------------------MXXXXB-------BBM-XB-----oXX----------MX---Xo--XB-X-X---------------------------------------------X------MXXX?--XB-----------------------------X---------o---M--------XB------------f
m---------XMMXX?B-----------------B--------------------------T------XX---------------o?---------------?B?---------------B---B-XX-------------------E-----XB----------------------------?------?--o-----X
---MB-------------------M--------?--------oBMXB--BBB-MBBBX---|--------------Mo-----------?XE---------------BMMM?-X-BM-------------------------M-------XMB--------B--XXBBXXXBB--------------MM---B-EM-?-X
XXXXX-X-X--XXXXX--XXXXXX-XX-X|XX-XXX-XXXXX-XXXXXXX-XX|XXXXXXXXXXXXXX|--XXXXXXXXX-XX-XXXXX--XXXX--XXXXXXX|-X-XX--XXX-XXXXXXXXXXXXXXXX---XXX-|-XXXXX-XXXX-XXXXXX-XXXXXXX-X|XXXXXXXXXXXX-XXX--X--XXXX-XX||-
