--X?Mo?B??B---------------------------------------------B------------------------------o??-BX?--------------------------------oBM---------BM??----------------B---------BB-------------------?----------
--------------MBB-----BBB--------BBB---------oX---------X?BBX?MBX-XXXX--X--------------B-----MBBXBXBBX-----------------BBBBBB----------XX-----------BBBMBBBX--------------BX----------------------------
--?BBBM?B-o-------------------BBX-------------B---XB-------------------------------------------------------B-------------------BBXB-----------------------BBo-----------------------------BBM-??BX------
-----------B??------------BXXX----------o--------------------B?B--o?BXX---------------oBB-?XX----BXXXBB?B----------???---------XXBBB------B----------BX---X--------??B----------------------------------
-----X---B---XX----------BX--------------------BBX-XMBBMB------XBBB--XBBBBB-BX------------??X---------------------?XBBBXX??B----------BB---------------BBXXXBBB-------BBB-------M-BBBXXB----BB--XM------
-oBB-B----BM----------EBBBX--B------------BXXB--X----XBBB--XXXBM--------------------------------?--M----------BXB?-----------------------------XB--------XXB-----?----------------------------X---------
---------------------------------BoB-----------------------EXBBBB-------------------?----X--B---------------------------------------------X?BBB---B?--BBX---o--XXXM----MBB----B-----B---------------XXB-
----------o-----------MMB---XoXMXBBB---------X----MB?B---oBB-XB---------XBBMBB----------------?B----?XXBBM------B-------XX-----BB--------BBBBBXBBB?BX-----BB------MB?B------------------------------??Xv
--------X--------------E?------BBB----------------XXBX----------------B-----oXB-------------------------------------BXBB--BBXXBXXBXM-----------XBBXXX--------------BBX-----XBXB---------------------XXX-
------------X??B-----------------------------------------------?BoBXBMXX------M---------MX--MBBB-------------------?B----------------------oB?B?-----ooXB-----BBMBB-------?XXXMX-MBBB-------M-----------
----XoB?XM--------------------------------------------------------BoM?------------BX?M-------------BBX------BB-------------XX------o---X--BXBX-BM----------XB-------XXX-------X-------------------------
MXB--XX----------------------XX----B-------------X?MM--oBXBXXXB--XXBX--------BX-------------BBXB-------o---?X?----------?XB--------------------XB----BXBXB-----X?X-------------BXB----oMB------?B-------
--------X-----------?B--------------o----oXBM-------?BBB----------BB--------------XXXMB-BXB-----XM-BBBB---------------BB-------EMB-------------------------------------------BM----MBB--BBXX------------
-----BB?--------?T-MB-------------?X--?--------------------B?-------------------?BBX------------------------------BX------------XXB?-----------------------------XB---T-BB--------B-----------XB-------o
m-TB-BBB---------|XMX-------?BBM---?BB---------BMB--B---??T----XXTBX?T---XXB--X?--?--MTB-T--B-BBB--BXB-----T--------XM---T-MMXTMTM----------oXB-----BBB----B-B--------|X?------XBBB-XB----------------Mo
XXXXBBXX??BXXXXXXXXXXXXXXXXXXXXXBXXXXXXXXXXXXXXXXXXXXXXX?-XXXXXXXXXXX-BBBXXX?-BBXXXXXBBBB|XXXXXXX-XXXXXXXXXXXXXXXXXXXXXXXX-BMBXXXXXXXXM-BXXXXXX-XXXX?BBXBBBBBXXX?XXXXXXMBXXXXXXXXXXXXX?BXXXXMXXXXXXXBXB-
