------------------X---X---------------------B---------------X-XB---XB-------------------------XBB-----------------B--X--XB------------------XX----------X----X-----B---------?--------------------------
-------------------------------EB----M--------------------X--X?----------M-X-------B-------------------XB--?-----BBBXB?B-------?B---------------?BEB---B?---------------------?---------------X---------
--o------X-------------------------------?--XB------B-X-------X--------------X--M-------?-----o-----BB-------------------------------------------X-----X----B-?-----?X-M--------M-------EM---?----X-----
---EB-----B-B?--o--B------o---o?---------------------X-----o-------B-BBBBB-E----o--------B--------B-------------------------------------------o-----X---o------o------------------------?BX?------------
----------oXXM?X-------------------EB-----------XX----------B----------?----------M---??---X-o??----------XXX-?------------------BX--B-----------?B--------M---BBB-----B---BB------------BBB------------
?BB-----MB----------------M---oBB?---B--------------B-B--M---------o------------XB-------------------------M-------------------B-M-BB----o----XM------B---?X-o-?-------------XB---------------?X-----XX-
-XX-----o--oX--------o-B-----BBBB---------------X--B----X---------------EBM-------------B---?--Xo-------------------------------BB-------------------------o--BB-------E------Xo-------X---------------?
BXB---BXB-B--B----------------------X------oBBMB-------B---------------BBBM------------XB---------?oB---B--X---------?-?---B--------------?------?------MBB-BXX?M?X-M?----B-------XB------X--------B---v
o-------------------------------------BB-BBo-----------M-----?BB?--?BB------B-BBX------?BBMBoBB------?-XXBXXXM?B------?----------------??M?XB??--??BXX--B-XXX--------MB------?------------X---------BXMf
---------B-------X---XX---------------o------------------------------B------------------------BB?----------------oBX----------M---------?-----EX--B-------XE-----X--E----------------E--------X--------f
------------------------------------o------------------BMB-------------BMB-?X-----Xo---------BM--XBXX---B-MMB------------?B------------??X?-----------------------------------XX--------------Bo-----B-f
-----X---------X------X---XMXB-------------------------------BBM-ooB----------?---------------------------------------X----B--------B----XB---M-?--------XB------X-BBB--------------------------B------f
-----------XMXB---------------------------BX-BXMB--------------MBX----X--------?B---oB---------XB-------------BBB-------X--------------------------------X?----B---X-------------?B--?BBB----MM--------f
------------oBBM-------EB-----?X---XXXX-X--XM-------------------------------B------------------B------------------------------B--------B-----oXX------oXBBMBoMoX?BBXB-----------BBBBM-----B---------B?-f
m---------BXXXX-------------------XBX--------M?E?---------------BBMXB-T-X--------X------B-----------XX-------?--------XX---------------X--BBB------------BB?B??XXX-----------XBBBBX--XM--MX?-----------X
B-------B-----------?MB---X-M--BB-X-X---B-XBXBB?MB--B-----MEB?-------B|--X----------X---TBB--XBB----------X---?--X--------XBM-BM--------BX---XXXM---B----------T-----------------------B-------XB------X
XX-XXXXXXXXXXXXXXXXXXX--X|XXXXX-XXXX-XXX--X-XXXX-XX-X-XXXXXXXX-XXXXXXXXX|XXXXXXXXXXX-XXX|-XXXXX--XXXXX-|XX-XXXXXX-XXX-XX-XXXXXXXXX-X-XXXXXXXXXX-X--X-X-XXX|-XXXXXXXXX-X-|-X-XXXXXXXXX-XXXXXX-XXXX----XXX
