-----------------------X---X-oX-XX-E----B---Mo-------------------------?----B-----E------E---M-----o--------X------X----X----?-----X-------X----------X---XoXBBX-----X--X------o---o----X----X-o-B--?---
------T-X----------M------o-------X-X------X---?----E--BoB----B-----------------X--------X--------oMo-X-X------E-?-----------?---X--------B-o------MX--------o-B---------X--M-X-B---X--B--o------------B
------|----E--X---o---XB--XB---B------X---B-X-----oo--oE------B------?---------X---o---MXX--X-------o-----oE-X-------?------------------X-----o-------B-o----XX---------------E-----X---X---------o---o-
----E-|----o---------X-------B--X-XX-----------------?oo-X--o----X---X------------X----BMX-----XoX----X-o--------------?---------o-------X?Bo--B--B--?------o--M----------------?B---------B-------X----
B----?|--------------------B?--?--------------E-o-X----oo--B----EoX-------E---------?------------?--------?o----------------X--o-Xo---X--X-X-BoX-----X----XB------?-X------X-------X-----E---o-----XB---
o-B?--|o---------o--o----BE-----XB--------E-?---------------??-------BX--E----X---M--BXX------?-----B-----T-------X---o-----------------o-X------EM-------X---M--------o------E-----o-X-X--o------X-oM--
--o-o-|---X-----BEo---------------X--X------X--?-------------------X--X---B---X-o---XB--o-----------------XX--------B---ooX---BB?--?-------X--X---BX-XB----X----?X-X-?-Bo---EX---o-------X--------------
o--X--|--------------B-------?-------o---X--MX--o----------X-------o---M-------------?--X---X--X---------X-----?---X-o-X-------?-----X---X-o-?--------B---X-E-X----X-X?-------?-----------o------------v
------|----o--X-----?-X----X--XXB-------------B-----X-E-B---X---XX--BX-----E----X---------o-------------?-X?----X--B-----o----XX----X----------BX-X--B---X-?-----E---MoE--E-o-----------X-B--XXB---E-M-X
------|X--------o------E-?-----XE-----X----------o-o-X--B----X-?----?-------E--X---o------XB-XBX-B-----o------oBo-----X-X-X---------E-----o-X--------B---o-o-?--o--o-B-X--------B-----X--------X-------E
---X--|o-XX-?-----------------------oX-----o----X-oX--X--X--------------X---X----------X---B-X--oX----X---o---X------o------X---------------X---o---------o--X---X--------o----------X-------X--B-------
----o-|----o--oM-----Xo-----X-------X-o---B--X---B-----?------------M------X-E-------Xo-------B------M---------XE-----------X-o-XM--X-----B---oooXX--X---------X-E--MB--B----X-------X-------Xo---o--X--
--oT--|--?--X---X----B--------------BXo-EXB-----BoB------B-X----------BoB------X--ooX---X-o------------------X---o-X------M----X---X------X-------X----o-------o---------o-o----o---E------X----X---X-?-
-X||--|--|--------X--T--XT----------?--X--B--X---X--o?--o----------M--X--X-----------X--T--E--------------------M--X--o-MT------X--------X-----ET-T?-?---T-----BE-?------X--------X-----M----X-o--B-----
m-||--|--|----------E|-X-T--X--X--BX----B---X---X---o-X----E--M---X-----X----B--Xo------T?-EB----?X-----MX---------X-----T----X--?---E--?T--?---To|-----BT-E--XX-X-X-----X------B--o-----XX-X-X---X--B--
XXXXXXXXXXXXXXXXXXXXXXXXXXXXXXXXXXXXXXXXXXXXXXXXXXXXXXXXXXXXXXXXXXXXXXXXXXXXXXXXXXXXXXXXXXXXXXXXXXXXXXXXXXXXXXXXXXXXXXXXXXXXXXXXXXXXXXXXXXXXXXXXXXXXXXXXXXXXXXXXXXXXXXXXXXXXXXXXXXXXXXXXXXXXXXXXXXXXXXXX
