-----?-----X-------X-------Eo---XE-Xo---X---o--X-BoXE-----------------------B-------?----X----E--M---oE---X---------B-----o------------X-----XXo?--X-oE--X------XX---------o---EXX---E---XE-EXo-B----X--
--XBX-T-X------------X-----XE--X-E----X-oX-------BX-------X---o-------------E---o----------B-----------------?------X-----BX--?-B?-----E--X--E--X-XX--B----E------X-----B--oE--o--B-T-------X-----X---X-
X-X---|-X----B--X------X-----o-------------B?----X---B----------XX--X--o---BX---oB-X-----------E--------------?-B-----E-----------------------X?----M--------X-----o-------X--X-B---|--------------?-?--
--o---|---------------E--------X-------X--BoM--oX-?E-X-----XX?B-----o-o-----Eo-?-X---X-X--B----??------o-o----X--------?------?---?XXo------MB---B--X--X--------o-E-X---X--X---?X--o|-B-?---X--X------X-
-----X|---MXX----EX--X-EX----o-----------X----o-BEBB---X--E--X-----B-------?B------E----?--B-B-Bo-----o---B--oX-----B---B---X-B?-X--X----E--B--------o--oX--B--------------X-------X|X------B--------X--
------|--------X-X-X-o--X-----?-----X--X----E-------X----E-----X--XB---X-----E----oX-o------M-X-------X---B-------E--ooX----E---oX------M---?----E---X-----M?---X------X---------X--|--X-X-------X-?-Xo-
--?-MX|o-X------------X----X------------------BX-----M-------B------X----XX---B--E----B------o--XE-X--X--X--------XX--B-X-EE----E-------EXB-X?------?----E?---E------------E--X-XXX-|------E----o------X
-XXX--|--------------------------X----B---BXXBoo-----oX---X----------------X----XX------XMB------X--B-X-X--?X-o---X---oX--X--o-----------?-X-----------E-X-------XoX----MX---o----o-|B------B--Xo--M---v
------|------E-----Xo-----M-----XX-X---------X------------?B----B--X---------------------X-o-----X-?--X--X-?-------X----X-XX---E-X--------X-----X-----XXB-----X-----------------o-B-|-------------------
---XX-|---?----?-X--B------B-B---X-?----------oX--BB-------X---X---o---------------o---?--o-X-o---------X-----B------E--X-----oo-?-X-o--B---o--------------B--?-oX-oo---o---BXo-----|o--X-----X-Bo------
-----||E-----XXX-------?---------------------X------oX--------X-XX--X------XX----XX----X---M---X-E--?--E-----X-?------oo------o-?--X--|-EE---------X-E-----X-X--X------------XX-----|X------------Eo----
-o--XX|--B---------------?---X--X-EX??-------------BX-EX------E-B--E-X----------X-----E--B-B---X---XX------X-----B--EB-------------oX-X----o-X-------E----------X--X---X------B-----|--------o----------
XEB--X|--o-B---X--------EX---BE---X---X-E-?-------------X-----o-----o-----X--X---X-----------------------E-------------o--MX----?X----B---?X--B---X----XX-X-----o------o-----X------|--oM--------E---X--
------|----------X-------X--?X-E--?---------------?-XX---------X--------?oM-?XX------X----------------X-X--Xo--E---X----o-o----------X-o-----B-o-?-X---X--X--o--B-----?----EBB--E--X|-----------XoXB----
m-----|--------X------X----X-----B---------X-X----o-X----------XEXB-----X------o-----X-------o----------X--B--X?----XX--X---B---o-X-------o-------X-?--X-----------o-X---X---X------|------o----------B-
XXXXXXXXXXXXXXXXXXXXXXXXXXXXXXXXXXXXXXXXXXXXXXXXXXXXXXXXXXXXXXXXXXXXXXXXXXXXXXXXXXXXXXXXXXXXXXXXXXXXXXXXXXXXXXXXXXXXXXXXXXXXXXXXXXXXXXXXXXXXXXXXXXXXXXXXXXXXXXXXXXXXXXXXXXXXXXXXXXXXXXXXXXXXXXXXXXXXXXXX
