--------------------------------XM-----------------------------------X?---------o----------------BB-------------------------------------------?---X-------------------------B-----XX------------MX?X----
------MBBBBXBB---------------------XBB-BXBBB-------EBB-----------BB?---------------M--E------------X--------------M-o--------------E-o?X-----EBM-MB---X-X-X-------------?M-------------?B----------oooX-
MBX-------B??--------E---------------------------------------------X-------------------BB-E?------X---BB---BMB??-----------??B---------XMXB------BX-oB--------------------MBXX--------------------X-----
----??---------------B---oBX------------------------M--o-X-------------?-Bo-------XX----------?--BX-------BX------BXB----XBX-----------X--EB--BB-X---?----------B-----XB--o---B--------XBBBB-------o----
---------------------------------------------------?X--------BBBM---BB------E----XB--X---------B---XX?B-----------------M?M----------B-----X?--------X-------------o--B---------------------------------
-------?--------?B---------MBMMMBBB-----XBXB-----------BBX--------B--MX--XXXX---------------------------o---XE-------------X?------------------------EBB-----B?------o-------XB-----XXB-------------XBM-
------------------------XBX?X?--BB-------------oB--------------------X?B-----?X?X-?B-----B----------X------oM---X-M----------X----------EBXX-X-BBB-----------X----X--oB---------BXB-------XX------------
----------MX-------------XM--XX--------------------BBX-E-------------------------------------X---------o-------o-----------------BX-----XX-----------------oB---------?------X-------X---XB--X---------v
XB----------------------MX---------------BBBB-------M-----------------o---------B?MBX-B-----------B--o-----o-B---MX-B--BX-----------------MBX-B-M--XX------X----B--------M?--XB---E--------------------f
---------------------------------XBoX?------------------XB----------BB----o-------o-------------B--X?X--------------EX------------XM-------------------oX-oX-X-------------B-----------------------BX--f
------BBX------X?XBBBB----oX?--oBBBBBB?-------------------B-X?MMMo---------------------------BX-oBB?X--------------------X------------------------------??B--------?M------------------------?B--B--XXBf
-----------------BB-----o--o---X?--------o--------XX?------------------B-------M-------------B--------oBBBE?----------------------BX--------B--------------------------------oX?B-----?BB------oBBBB---f
---------BBX?X----------------------------------X---------------------BBX-???--X----B--------------------XBBMMBoXM--------BB--------------------------------oo--B--------------------------B-----------f
-----E---X--B--MB---?B--------------------------B-----------XX-------XBXX-------------X------------o--M----------------XXX---------------------------MXX-------MX--------X----B---M-----?-----X-BXB---Xf
m----TB-MX------------------------------------B--oBBB----------?BM------------XB-------------------XB--T---------MB?o?BXo---------X---------------------B----XX--------------------------BB----M?---XTTX
-----B------------------MXXo-B-------------B---B-------XBXB----M--T-------M?BXXXB-------X--------------?XBBX-BB-X-------------------------?-------B-------XXXXMBo--------------BBMXBBBB---------XXX--||X
XX-XX-XXX-X-XXXXXXXX--XXXXX--|XXXX--XX|XXXXX-X-XX--X-X-X-XXX-XXXXXXXXXXX-XXXXXXXXX|-X-XXXX-XXXXXXXXX--XXX|-XX--XX--XXXX--X|X-XX--XXX-X-|-XXXXXXXX--XXXXXX|X-XX--XX-X|X-XXX-XXXXXX-XXXXXXX-XXXXXXX--XXXXX
