oMM-------------------X---------XM?-----X-E---------oB-------MX--------MB------------M---------XX----------------------------X--------?B--------------oXB?-----------------BMB----------EB------MX-----o
oBX---oBBBBX-----------------------?BBXBX?X--------EBBB---------XB------Xo----BB-X?----------BBBB----?MBX---------MXBM---?BBX-------BXBM----------?MX-------------B-----------o----oX----------------o--
-X---X---------E-----------MX-----------------o----o---o-X-----XB-----X------------------------------------------------------B-----X----EB-----------M------------BoX---------------------------X?------
o------M---------------------------X--XX-----------?MM--------------X-?--------BB?------oBB?---MBBBB-X----B-------------??----XEX-------B-XB---------?MB-?X-----------------------------B---------------
?B------BBB---------?Bo------B?------------XX-----?X------------------o-?MB-----X-----------X------o---B--------------------------XB------?----BM---------------------XX---o------------------X-----BB?-
-------B---B-----o--BBBMXBB-----------------------------oXB---XX-----M-?------------B---------------------M-----B-------------------??oB-------oo------------BM-B-----------------BB-XX--oX--B----------
--BM-------------------------BX--------------------------B------B--------------------BM-----------BX---oBB---------------------------------oB----------------XBB---------M------------?------X--o-------
---??-----------------o-?--X---------------------------------XBM-------?--B-------------B-----------------------------B-----------BX-------M-------------------------------?B?-----B--------XX---------v
------------------------M----------------X?XX-------XB----------------BBB-------BBXBB--------------------X-------BB--MXXM----X--X-XBB-------EX-----------BX-B---XB----XXB--------X-------E-------------f
-----?-------------------X--------oBB--?----------------B-----------MBB---oM------o-------------XBXX----------------E--------------------------??X------BX-XB---?------?----oB----BM--------------M---?f
---------M?XXX-----------------M----------X-------------------------------------------M--??--------M-------B---------------?--X---ooM-----------?B---B-------?----------------------X------------------f
--------------o---?B--------X-XB---------------------?---------o----------------------------------------------B-------?-------X?------------------BMB-----------------?BB-B-oBXBBB----------o?---------f
-----------------------?--XB-----MB----M------o---o------X?XBB-Mo---------XM--------BX------X?--X--------X?----oXB--------X---------------------------------XXXXB?---------oBM?------XXXB--------------f
-----------------------X-----BB--o------------------B---XX-------B-----X--------BB-----------B---------------------------------B-----------MBBB--------?---------------B------BXXM--M------------B-----f
m------o-EB--------------X-?----------X-----------------X--------------------X----BB----o-----o----ooB--------------B----------------------------o------XM--M----------------B-----o----------------?X-X
----------BB-o----------------------------------M?--o---XB----------B--E--------???B--------------------------------------o---------------oB-X------E----------B-----------BB--M--X----?B--------------X
XXXXXXXXXXXXXXXXXXXXX-XXXXX|X-X--XX-XXXXXX-XXXX-XX--X-XXXXX-XXXXXXXXXXX-XXXXXX-XXXX-X-XXXXXX-XXXXXXX-XXXXXXXXX-XX|XX--X-XX||-XX|-XXXXX|XXXXX-XXXXXXXXXX-XXXXXXXXX-X|XXX-XX-XXXX-XXXXXXXX--XXXXX-X-X-X-XX
