-X-X-----------------------M---oBBBBM?--MBBMXBB---BX------------------------X----------B------------------X--XB?-XB-------------o----B-----BB-?--------B------------------------------------X-----BoX---
XB?---B?---B--------MB-B-B??X??--BXMX---?BBX----------XB------------BB-?-------??MX--------------------------?B---------------B-------EMoX-----------BBB-----M-----X-MBBXXXB----------------X----------M
--XMB---X-XXXBM----------M-----------XXX---X-----XX-----------------?B-------------------------------M---XB-----B----M-X-------------------BXB----X--o------B-?-B?------X----M-----------o---X----B-----
---------------BBB----------------BX?X--------------------oBBM?XXB?X-------------BB-------?X--------X?B------MBM---X--------------------------Bo---?-----------XB-oB--------------BBXX-B--------------B-
----MB--?---------------B?X-------------------------B----XBB-----------XX---------------?B---B----------------------------o-B-----------------------B--BXXB------B------------M-------------?--------?--
--o-----BB-----------M??---------------------------------oB-------------------------------XX?XX---------------------B--X-------M-------B----M-?-----------X---X-------?----BE-------X----X---------MBM--
--o-o-----------o---------B----------B------------X------?------B---------------X----------------------B-------oB------M---B---------B----------------------X---oXBB?X---?--o-X--XBB-E-------------o----
XX--X----MM--------XMX--------------------BBB---------M-------------M---------X------------------E------------------------X--X----------XXXBB---------------X-----------?------------B-----------------v
BX?-----MM?B--------B--------------MM--X----?BX---?--o-------------------------B-----oBB---------o---E-XX--X--------M-----------o---MM-----B?B-------------?M---------------------B-B----EXMXX?M-------f
--------------BBXBB-----o----B----------X--------B-BBX---MBB-------X--XB---------B-----------B--E--BBB-------XBX?----B------------B-XX---X-----------------------X??-------BX--------------BBBMB----X--f
-----B-------oB?-------------------BXBB--------E-------------------?--------------------XB------X---B--?X----------------X---------------XBX------BB----X--BB-BM-XB------oXX-----B-MX------------M-----f
-----------B-----------oBM?----B?----B-------B?------------X-X--------------------EB----E-BooX-XB------B-XM---o--BBBXoBMMXX-BBX--------?X-----oX------------------------------------------oMXX-------XXf
----------------------------X-XB----X---------------XBBB-----oMMoBB--------BB--------B-----BBB----BB----------X-------XBB-BB-------BBB-----------X-------------E----------o--XX---------------?--------f
--------XM--------B-?BX------?------B---------??B---------------M-----XXX---?M------------EB--------BBX-------------------------o---------------------------?--X------oB---MBB----------X--------BBX---f
m-------------X----------------X---------B--TX---?BMXB-TBX--B------oM----E-----------------XBB--------------------M??BB--------BB-----------?--------------------TB--?M-------B?-XBB-oB----------------X
X-----B--?X----XM?X--TBBBB-----oB-----------B----------|X-BXX------BMB------B--B-----?M----------BBBXM---------XX---------M--B-E-------BMX-B--oXB---BBBX---------?----------B-T-------X-----X----TXXXX?X
XX|XXXXXXXXXXXXXXXXX---XXXXXXXXXXXX-XXXX-X|XXXXXXX-X|XXXX-XX-XXXXXXXXX--XXX-XXX|XXXXX---XXX|XXXX-X-X-XXXXXXXXXXXXXXXXXXXXXXXXXXXX-XXXX-X-XXXXXXXXXXXXXXXXXXX-XXXXX|XX-XXXXXXX||-|XX-XXXX-X-XXXXXXXXXX--X
