--------------------E-X--------XXX-------E----X--?-X-o----XXE----o---X--------Bo?X---------B--?----B--E----X-----X?-------------------------X-BoM----------?---X--XX--------X--X--X------E----B?---X---E
----X-T-?------X-X------XBE-----XX--------o---o--?--?-o-X-BBX-------------B--o-M----B-X-ME--Xo-X-----o-X---X---X----?------B---o-o--------B---------?--X-----oXMB-E--oX-B---B--Xo----B------X--X-X------
------|-----B-----------E------XEE-------oB---Mo--oXX-----?---o------B---M-M---X--X-----EB--X--E------o----X-X?X----o---X---X---------X?--X----XEo-M-X-------X-XXB---X--M-------------X-X-X--?---BX----X
-X----|-------E-------B-X------?--?X-----EX-X-X----XBo-----o--X--oo------M-B-E-----?--B-----X-XE--XX-----XX-o?-o---XM-----------E---o-----Xo--EXX------o----------?-----X-E-B---X--X-X-B----M?X----X--X-
------|--o---X-----?Xo-------------?------X-X------------------X-M---X?X----B--EM-X-o------oM-----X-----E--oo--------B--X-B--M---B-------X--------X----o----o--X?----?-X-------E---------o-o------------
---BX-|X-X-----X-----X----------BE-------o-------------------?--XB--XoX-X-------?--------X------X-------?-X-----X---------------o--------o---B------XXB--o---------E--X-X-X-----?--X------------E---X---
--X-B-|----M------------B-?---B---BX-----------XX-B-E---------o--o-?-----------EE----------X-----B-Eo-----------M--XX-----B----E-o--E--------o--X--XX-------?--?--X---------E-X-----X-X----o--X-X----X--
---X--|--X---------------X----o-------X------XX-?--X---XX-?-o-------X-X-----X-------oB-X?-----------X---B--E--X--X--Xo-X-?------X--X?-----o----X-E-?-----o--------------------?-X---X----X-?o-------oX-v
------|-X---E----X--B-X------o-----X----o---------------X----M-?------X------?---XE-?----B--------BB--X--X------------XX-o--oE---------o-X-----XBX--X-B-X-X-----o---X---M--X--o----X-EX-----X----B----X-
---B--|------o------o---------X---X----X---X--------?--?---------X-------X-----o----BBo----B------o--o-X----------------XB----M----XX--oXo---------o---X---XX--E?-------M-----E-oX--?---------X-X-------
X--X--|X-X----o--X----X---X-----X-B------XE-B---X----?------------X----------o--M-X----------B-----E-X-B--------E----X---X-oB------X---B-----X--------?----X-----o--X---X-o-X-----B--?M---------?-------
------|----o---E--X--X------o-X--B-----------XB---M-B------X--X-------------Xo--oE---o--------------o----E------?--X---------B-------------EBo--E----?--------X--BX------oo------------o-------B-----B--
---X--|--E--------?----B-----M----MT-X----X-----B-X--?---------X-------X---X----B---X------X-X--?---X-XXX-oo-----------------X-X----M-----o--------------X--------X----Xoo---XX-----X---X--Moo-----B--X-
-----o|--|-------?X---X----XT--X---|-----------------------B----------o-----T---EX---E-X-------------X------X--------X---X----------------X-E?-------Xo----o-o-----B----X-?--------?M------T--T---B----X
mE----|--|--o-M-BXX-XXBE----T------XX----?--XE--B-?------------B----E-X-X-X-TX----X--?o-?--M---?------o-X-E---X-----M-----------------?-----X--X------------?--X----X-----X------------o---|--|---X-X---
XXXXXXXXXXXXXXXXXXXXXXXXXXXXXXXXXXXXXXXXXXXXXXXXXXXXXXXXXXXXXXXXXXXXXXXXXXXXXXXXXXXXXXXXXXXXXXXXXXXXXXXXXXXXXXXXXXXXXXXXXXXXXXXXXXXXXXXXXXXXXXXXXXXXXXXXXXXXXXXXXXXXXXXXXXXXXXXXXXXXXXXXXXXXXXXXXXXXXXXX
