-----------X-?------MB---oM-o--B--X--X-X---------EX------o-?-BX-----XE-X--o----X---oM----oX----E---X-------o--------------?-?-X----------XX-----X---X--X--X------------X------------o-----?--------o-X--
-X----T--B----o-----X-----XoM------------X-o--------X-o---o--M--------X---------X---X-?-X---------X-X------------X---o---?-------o--?XX--------X--EX-X--------oX------X-----XX------oB-------o----?-----
-----X|--X----M-X--------X---X-B-----------o--XXoB----XX-X--------o----X---X-----o-X-------------X-------X----o------?--o-------XM----------X--o-----X??--------------X----X----o--o--------------?-----
------|X--oX----X--------X?------X---M--o----X--M-o--XB---X---X----B----o-----EX---E-M-------B---XX-----oX---E-M---XX-X-----X--M-X---------Eo------------E--X--?-E?--E-?--?o---------X---------o--------
------|B---oX---o-----M-----------o------?----------?------B---E?--M--oX-XX-----X------o----------------X-X-X----X------B--X---X----X-X-----B-o--X--X--------o--?---XoX--?o--XB--X---oB----X--XM--------
X-----|X--X-o-E-o------------X------X--X-X?----------------------E---XB----BX--------B---o-X--------B---X----------XX---?----------E-B-------XX--XX-----E------XX-X--EBXX---X---X-X---o--BX----o-------o
-X-B--|-------X----------Xo--X---oX-o--------X------B-------------E----X-X-B---X---X-----o--X-----X---o--E--Mo?--------BX--M--?-XX-?---X-Xo----B---------XBX--------o-B--o-------BXo----o------o---EXX--
------|----------------XX-XX--X-B---o-----X--X---X-E-----X---------B--o---XoX---XX-------X-----------------B---X-B--?--Eo-o-------X------M-E--B--XX------o---------------oM-XB---?--?-------------o-EX-v
---o--|X-----B---X-X------------X--X--M---X---oX---X-X-------X-----------X--X--X------------------X--X-----X-X-XE-------------X-o-----oo?----?--------o--o---?----X--o--X?X----------EXX------BM--XBB---
--MX--|----------X----------E----?X--E-----X---o----X-----------B-----------X------B-----X-X------------XB--X-----X----------oo-----------------------X-------X--B-?-------M--?B-------------B---E------
-X--X-|--?-BX---B--E--X-o--M---X------X---X-o--------?XoEB------------X--X-----X--oX?------X------------------o-----X--E--o----E------X----E--o--o-----M---B-------?------------o----------Eo-----?B--X-
-----X|-B--X-o---Xo-X-----EM-----X--M---------B-?----?---------------XXE--X-M-----------B-X----E-X----MX---o---Xo---X-XX---EX--E----o--o--------------------------X--------------X-X---------X--------B-
--M---|--T----------X-X-------------B-----------X--------o-?-----------X---X---XXX-----X-E--X----o--X----o-----------------------E-o--------B-----XX---B-----?----------Eo-?-XX-----X--------X----X-----
---M--|--|-------X-E--B--X----X-----T------X--M-o--------?----o--------?-o--?---------X--E----T?--X---------X----------T------------------XX--X-o-X---B-----XXB-o----X----X--o------XMX-----T-----?X----
m-X---|--|-------X------B----XX-----|X-------X--B-oXo---X-------X--o------B------B-oX----X----|oX-?XX-X----------------|-E----Xo---------o-----B------------X----X--X-----o-?----M-B-----X--|X----------
XXXXXXXXXXXXXXXXXXXXXXXXXXXXXXXXXXXXXXXXXXXXXXXXXXXXXXXXXXXXXXXXXXXXXXXXXXXXXXXXXXXXXXXXXXXXXXXXXXXXXXXXXXXXXXXXXXXXXXXXXXXXXXXXXXXXXXXXXXXXXXXXXXXXXXXXXXXXXXXXXXXXXXXXXXXXXXXXXXXXXXXXXXXXXXXXXXXXXXXX
