-XX-B-----B--------X-B?-XX-?B??--------------?B-BBB-----oXMX--------------X--------MXBBB----------o------XBBB----BX-------------------o--B------B--------?----X--------EE---XX------------------BB?M---o
?B-----MX------X------------X------BM------E------B-MMX---------------?----XX--------BMM-BB------------XX-------X----------B-----EB--MB------------?XB-M-----X----------------------------------------B-
X----------o------------------M----?-----o--X------------------E---------------------o?----------------o----MX-o-------B--------M-------o-----------B----------------------?-----------X?-BXM-----------
-------------------BM---BX--oBo----M----XX---------------------E----o-----------X?---oBX-oB---------BM--------------?---------BX---B---XB----MX-------------X-BB------------------X--BX---BBXM---MBB---o
------------------E?-----------------o-M-------------------?--------------B---------o-----------------B-XX-----------o------?X---M-B--M--X------BB---?------------M-------------------B-----------------
-------?X----------------------oBM------X---------------o-BB------EXBBXB?-----oX--BB---B-----------------?---------X-------------?B---------E--------------o-----X-o----M---------X-------EB------------
-B-------------XXX--o-----------------------oB----------------XX------------------------BX------B--M--EM--X?-------------------MBB---------BX--X-----o------oXX------------------o---MMM----------------
-XXM---BBX----BB------E------------M-----------EB--XX---M--X-BB-------B?-----o------B-------------X-----------------XB---------------oB------X-B-----B-----o-----?--------------XB---------BB------E---v
X-------------------------XBXB-o-------------------XB-------------------X-o---B---------------------------B---------B------X--E--------BX------?--B-------BBX----X-----B------------X---------o--------f
-------------------------M?B--------------X--B--X-----------------------------------BoB--------BBM---------XX??M-----B----oB----oB-----XB---------?------MB------BBBB-----M-------------------X--B-----f
-------XXM-o---BEX-----------------oB------------------------E----BX----------------------X------------------BBX----------X-----M---oX------E-E---------M--------B------------------?------X-----o--EB-f
--------------------o-o------------X----------------X------X-------------------------------EX-------------------XB--o?M---o----o---o-o------------------MMX------------X------X--B-------------o---M---f
----------X-----------E----o----??----------------------BX---------------------------?-----X------E-------X--XM-------BB---------o-----------------M--------M--------------------E?----E?E-------------f
-----oX----M-----------------------EB-----------BMM-----BBX--------XX--B---o------------o------X---XBXoB-XM-XX-------------------------B------B-----------------M---------X------------E-BX------------f
m----------------------------------T---------------o------X-----------------B---------------X----------M-----o----BB?B-X----------------?---------------------B-------------------------E-----MX-------X
------X-----------X------o----X----|?--------?---?-------XBBB--o----X------------------?XM-----------MB------XB-B-XB?---------------------------M-?---?-M----------Xo-----X--B---------T---------X-----X
XXXXXXXXXXX-XXXXX-X|-XXXXXXX-XXXXXXXX-XXXXXXX--X-XX|XXXXXXXXXXXX-X-X-XXX--X-XXXX-X--XXXX|XX|XX-XX---X-XXXXXX-XXXXXXXXXX|X--|XX-XX-XXXX-XXXXX-X-X-XX-XX-|XXXXX-XX-XXX-X|XXXXX|XX|XXXXX-X-|-XXXXX-X-XX-XX|
