-----B---?-o---E--B--------------X-X--XX--X-------------|--------------|-X-----X--X---o----oo---------B--E-M---E---------?--X---o---o-|----o--X--------------?----XE--BE---BB-----Xo---X--X----?---|----
Bo--X--X--BB--?X------B?----E------------o-----Xo---X---o-X----X------o--|-M----X-X---o---o-X-o------|--X-------B---X---------B--X----?-o-o-?----o-------oE--------o-----BX--?B--?--T-?-------X--XXX-|-E
E-XX-X-----B------X-EX---------o--------o---X-X---X|-B--------------------o----------X-----|--o--X--XX---X--------o--------XX-X--X-|X|XB--E--------------B---------X-XX----B-X--X---|-----------E--E--?-
--Xo-o--X---o----o?------B------------------M---BX-----o---X---Xo--?----X--M--X-XX----------E-------------?-oX-o-X---XM-XX--?B--B------o|o-Xo--E-X------|---E-X-B--X---------B---XX-|-----|--Bo--X---B--
--MX-?---------E---Xo-M---o-oX----X--X--B----B-------B--X-B-----------------XXX----o----------X--o-----BX--E-o--XX-------------X--B---M------BM-------------B----?-------B----------|--X?--X--o----oo---
-X-M-----------EB-X--X--o-MX--------B--EXo-----X---B-X-----B-B--------o-B-----E---XX--------M-----X-----------EB-?------o----o--X-X-B------X----?---oX--E------o-X-?---X-X----B-----|----------------B--
XX-o---B---XX-X-----------B--X-----o----EoB-Xo---X-----B-B-X|--B-X-E--------------X-X-?X-B-----B--o-o--X--?-------M----o----B-?--X-----X--------XX-----B--?-------X------X--XX------|----X---M-------o--
-XX--X-o---|--X-----?-X-X-X----o------?-|-X---BXX----o-X-----Bo-------------o----------X-------E---------------X------?---X---------------X--o--X-E--X--|--------|---------B--XoB-X-|-----------B-----Xv
---X------X--X-oM--------X---o---------------B---X----|---XB-----o------|X-B-------?--?-------------X--------o---------X?-------X-----B-X-XB-o------X-?--------------X---------?oE--|---o--|-------oo--o
--?----M---oEo---?--------------oXX?------XX--X-|X-----o---------M-X-----------o--X---X-o----X-o--B-Eo-----B------o|X--XE-o--X--X----X-----X--X-------o-X-----X-----E-X-------BXX---|-----?E---B-o------
----------X-------B----------XX-M-X-?----X---|-oE----o-o-XX--------?X------B--X--B---X-----EB---XX-X-X-B?--B--X---X------M-XXX--X-----------?-------E---B-?---oX----XX-----------|X-|-----|-X-----------
-X---o----XB---|--X-B------------------------B--X-XXX-X-o----B--?------X-B---B---XX--X--o--|-------?--o--------X--o-E--BX----X---X----XX-------XB---XXXX--|-X-----------o--------EXE|---X------|--Xo--Xo
-----X-----oX----M-o----------B-o--XX-E------------?-B-----EE-------B--------E----X----o----X-o-E-X---------X-X-----o--------M---X-----X-oE-----X-----?--------X--------o-----X--X--|---o--?-------M---X
--------X-X---|--XX-B------------B-o-X---|X-XE-----o-X---o-X-----XX-o---o-----|-------o-|-------B-------|-?---B---o-X--M-o----------X-----|-EX-------------X-----o-X--X------E--|---|--X-XM--X--B----E-B
m-----|---B-o-B--?-----oX-?-------------------o-EB-------B----X-----M--M----o---------M--X--X----------------------X---X-------------B------ME-oX--X---X?-----B--M----E-----X-------|--------?-X-------o
XXXXXXXXXXXXXXXXXXXXXXXXXXXXXXXXXXXXXXXXXXXXXXXXXXXXXXXXXXXXXXXXXXXXXXXXXXXXXXXXXXXXXXXXXXXXXXXXXXXXXXXXXXXXXXXXXXXXXXXXXXXXXXXXXXXXXXXXXXXXXXXXXXXXXXXXXXXXXXXXXXXXXXXXXXXXXXXXXXXXXXXXXXXXXXXXXXXXXXXX
