---TB?M--------MMX?XM|B-------------E?X---o---oX------BBX------Xo---------BMXXooXB------oo-?--EX-----XB----??X---?--------XM-----------------|--XX?B-|-----?-oXX-X------------------?X--o?------?---o-X-
---|--------------X---------X---BBMBTB-o?X-?o-----?MXB------XX-------?M---------B----BB------------?-X-M----B---------o---TB---B-----B--------------------------XTX----BX--XBB-XB----B------------------
-------B-------------------T--X-BX-----T-------M---------oB----------------X-----o-------------------------T-----------------------o-------------B--------X--------------------B--X-?B----------XB--X---
-----?--------------------------------X|B-------------------------------------X-------X---X-----o---------X-----------T------B------------------------------XB-------------o-?---XB?BX--------B---------
----------------------T-----------------B----------B----------X-------XBBB-------B---B--------T-----T----X------XBB---|----X--o----T---BX-----M------M---?-------?M-Xo--B---------------XMB------X--BX--
-E--X-XX--------XX---------B-----B-----B-------BBBB-XB---Eo?-------------T---------XX--------------B|---?--------B------------X-B--BBX-----?---------------?-?TM-----X------------------T----------BX-E-
|XB------Xo--------M-------X---------------E------oX----------------oXX--|------------BB?------T?----X--------------XB----B---------XX------------T---X--?----|--------------------------XBB-----X------
-----BX------XX----------T-----BBX-------??----------B----oBX??X------------------E?-----BB?-----------------XoBo-MB--------XMBBMT----------------------oX-----o-?--X------BBX-----XB---------------M--v
X-----------------M?X----X-----B---X--T-------------------M----X--------------X?-----------?----E-----------------------MBX------Xo--------------B----------------M-MX----------------BXB?------BB-----f
---------B------M------------T-----T-?|?-------------------X------------XMBo---------E--------XB-------X-----------TXB--------------B------------------To------BB----------------------B--------TX----of
-----------------------------|-X-----------MB?-------------------------X-----?------TX------B--------EE--------T----X-------------B--------------------|M-----MB-BB-------------M----------Xo?--B-----Bf
-----------E----B--------X----------------E-----To?o-------T---o-XM---BBB?-T--B-----|--MB---T?------B----o----------------T-----BM------T--o---------------B--T------------------------------M---------f
------B-----XT--BM--------------------o---B-------------XB-|-XX--------------BXB------BX------------T---X-B--------o-----------oX--X-E--|----M--------TX-oBX--X--X--o--X-----X-M--------------------XX-f
-----o--------??-?---------X--?BB---??---------o----?XX-BB-E-?---T------------XX-----------B?--M-------------------BX----T-----------------------X---------?XB--XM-------------------------MX----------f
------?-E?B-B-?------------X---E-------T------T-----M-----------X?X-TXX-B?-------XXMXB--BBB----X?B-----------BB---oB---B--B---X?--------X-----------?--X------XXB------------------E---o----T----------X
-----------------XM--------------------|---------EM----------------o|-o---BBB-Xo---------------XB-XX--B?BB------X----o------------------B----E--BB---M-----------------------To----BX-oB----|-----B----X
XXXXX--X--|X----|XXX-XXXXXX-XX-XX-XX-X|XX-XXXXXXX-X|XXXXXXXXXX--XX-XXXX-XXXXX|-XXX-XX-XXXXXXXXXX-XXXXXXXXXXX-XX|XXXXXX-X-XXX-XXXX|XXX-X|XXXXXX--XXXXXXX-XXXXXX-XXX-XXXX--XXX-X-XXXXXXXXX-XXXXXX--X-X-XXX
