-MB---o--------E------B-oX---------M--E-----------X---o-------B----o----o---X---X--X----E--X--o--o-X---X---X--T-?---o------E----T---------------B-o---X--B-o-------------oE-o-----X-----------XB------ME
o--B--T----------o-XB--E----MX--oX---X--o---M---X-XB---X---------------X--------------Xo----X--?XX-----E---X-T-?-----X------B-T--E-X-----XE---X-----------oX-o-----X-XX--o?------X----?-----X-------B--X
-----X|B-B-T--Xo-X--o-----X---E-X-?X--E--E----X------X-----X-XX-X------?---X-------XX-----E--------X-X-?---------------X-X--X---oB------X-T-X---X--XXX----E---BXE------------X----X-o-XX----X-----B-----
---X-X|--o--?----?o--?---X-------X-----XXX--B----o-XXB------------XM-oo-----X-----X--?-X-X-----?--X---B?-XXB----o----X?-------M--------------o--Mo---T-----X-M-M---------B------X------XB-----XX-XX-----
----M?|----------XX-?--B-------o---o---X---------------EX---?o-B--X-X----------?---E-XXX----X-B-X------XX------?-------E------X-----o---o---B----X--B---B------------X---X-------o-o-----XB---------T-X-
o---X-|--BX----M------------o--E------Eo-----E---E-----X---o---------X-B-X-----B--o-B--T-----------X---X--X-X------X-------X-X--B-o---X-----T----E-X--B-B-oX--XXB----B-TX-M-oX--o-----o--BX-----oX-o----
-X----|----X-?--B--XTX--B-X---X---TX----------E-----EX-----B--B--M-----X-------oX----X------------X-----B--X-------------E-----TXX-o---------?-o---o------X--E--X---B----X-----X-o----?---E----T-B--?---
-X----|-----XX-B-T-E-BXB-EX--?--------X---------o--T----E-------------X------oo-----?-------Xo---T------X-----B---E--X--oMo--B--X---------EX--X------------X---o---o---X---o-TX----o---X-X-E--T-----B-Xv
---EXX|-X-BX--------B---------------??-?X-o-o----?--?X--B-?--------------------X-------Eoo-----EE-------Xo---Xo---TBX--?--o----------Eo-----T---X--Xo----o-B-----X?-oXXM---XT-BXEXX-----?--X------Xo-X--
------|---X---X--X-----E-o---BX-?--------B-----X---XBB--EX-X-----B--------B-T-----BX-----TM--X---B--XXX--------X-------o-X-------E--B-B-B----------XM-X------Booo---Eo?------X--M-X--oo-E-X-?----------X
-X----|---Bo---------------------X-----oX-X-oX-X--X----X-B--X-X--M----------------BX--EX----?---X--o--X-----o-B----------Xo-----------XoX-XX------T-----------oX---------XoXE------o--------------------
------|--X-X-------X----X---X---B-E-o----------X--X--X--X----?---T-o-?X------Xo-XX-B----X---XX-----o--T--B-?----o-?-X-E---o------X------Mo--o---o--------?---X---------------T-E--------B--M-MoT-X?-M--X
Xo-To-|--T---?----XXXX-X------o-XX---E------X-----B--X------------X-o-X---------B-X-?-------oBE-XXo---T-----X-XX--X-----EX-?-----------EX----XX--X--?---E-------B--T--------X-XX-X--X-X--o---?X-E-E-----
X-----|X-|XB--------B--B----X---XX----X--------------E-M----?-oB---oT------o----BX--E-X-TXB---XX--o--------M-X----------E-------B------E-T?------------XBT-?------------X-o----E-------EX-X-------------
m-----|--|B--------------XXX-o-M---?--X-----o---XX---XBX---EE-X-XMB?T-----B--B-----EB-B-|-EE--X-XBX----X---X---B-X-------X-------o---?---|----X-X------X-|--X-----------------X------X--T-?----?---XB--X
XXXXXXXXXXXXXXXXXXXXXXXXXXXXXXXXXXXXXXXXXXXXXXXXXXXXXXXXXXXXXXXXXXXXXXXXXXXXXXXXXXXXXXXXXXXXXXXXXXXXXXXXXXXXXXXXXXXXXXXXXXXXXXXXXXXXXXXXXXXXXXXXXXXXXXXXXXXXXXXXXXXXXXXXXXXXXXXXXXXXXXXXXXXXXXXXXXXXXXXX
