X------M-o---B-X--o-o-XM-X----X----EXo---B----T-o-------|o-?oo---X---o-o---o----E-----X-BoX-X---------------X-----------B--o------BoX---o---XE----MX--?---o--T-o--X?EM--oX--M----EoM------------o-XoXB--
-B----?----o----?-M-X------o-----------XX-------X-?--X-------X---X--EXX-|----E--------------o-X--?-o---------?----Xo--------------X-BM-X--?---------B----M?------TX---X---XB-o-------X--oX-X----BE------
--?X--------oo--------BX--?--X---XX-Bo-------BB--o---T--X-------E-X-X------M--BEX----T--XB--X--oX-B--E-----------B-o------X-X---o---o---?X--?----X-----B--B---T-|--B--XXX-?--X-X--B-Bo----?-X-X--M------
--|-----E-B?---T----E--X-B-------------XM?-------X?-----?BM-X--XB-------------TX-E-------?-----X------X----X--oX-T--X----B--B--X---X--B-M-----X|?------M--o----XoB-------B-o------X--------XoE---------X
------o----T-----B-X-----o-------------M---X-T-B|--X--?-B--BX---------o----X-------X-X-Xo----X-X-?o-----BoM--------X--XX---o------------TM|X---o-X-X--M---o--X-X-------T-XoX--B-------oX|---X----TX-----
-X-------------o----X-XX-------E--M--X-X-X--o--T-------XB-E---M-BX---X-----B---X---X---T---o-----X----X----X----X--|X-EM--X------------?--o------oX----o----Bo-X-----------X---X-----|-X-----|XX---?-B-X
-------B-B--X-----XB-X--o-------------o----X--------------B?---B---BX?X-BX--E--X---X-----XX----oX----B-B?--oX-X--oX-E--X-------X-E--X-X-----oX----X-------o--Eo-X?--X-----------------X-------MX-X----T-
-|----X----X----X---o----------?-----XX-T--o--X----E---X---X--o--oBo------BT--X------X---------X-X-X|--o-----o---BX---X----X--------o-?--o----BX-X------oo-E-T---?-B?o--B--------X---o--X--|---X----Boov
-------X----Xo---o---------------?-X-B-X--XX--X?--M--|o---|--T----o------?--------X-E--XX-----------------X---o-----------X--X?--MBX---X-X---------oE-X----X------X------X-o----o-|----B-E------X-X-----
-B-E--T---?----E-----XM--?----T--------o------------XXM---------?--XXX-----X-o-X--------XX--X--X---E---X------XXM---------X---o--X--E-XX---------XB-----X------XX--o-------X-----------T-X----XXE-E--o--
---E-----X---?-X--B--E--X--o-X---X-------o-----X------o---X?-o---X--E--Xo---X-----X----------X------X----B------X-----E--------------XXX-o--------?--o?X-------o---X-------XX-----?---------------T-|-X-
-------o?-E-XB--X--B-----X-To----X-X-----X--X----B----X--------Xo--------T--o------------o-BX-|-X----EX-------?-----------X-X----o----|B-o-----X-BX---XX---B--X--M-----X-T----E-----E---TXo-E-----------
-TX----T--X-M--|------X--------X--E---o----|X|-XX-------X-------X-EX--------B------X------BXXo----------------B--X-X--X---X-----X----------X--TX---------X--X-o----X-------------o---X-T--XX?---o---X-X-
------X--X-B---Mo--X-----------?-?-o?-X--E---T-X-o-o--X-EE--E-----------------X---B-------oB---E?|-----Eo---X-X----X------XX-X-------------X---B-X---?X---X-B-X----------------o?-X----XoX-E------Xo---X
m---T-------|----XE-X--------XXB----o--XX----o--B---B--B---X------X-XX---XX-------X---X--B-o--M?X----T-o---|------------B-X-|X-X----X|---------------|--X--------?------?---o--XX------X----B----?--E---
M----Bo----E---X------X-----------oo----X---o------B--?oM---X----BXX---?-E---------T-------B--T---o--E----X----------?X--?----X----B--X--E-----o-----B--o-o-B----XB--XX-----BEX---------------------X---
