---E-o---o-------X------X------X---E-----o-------X--oM----------o-?--oX--X-o--BX--X--X---o-----------oX-----XXX-E--XX-----?---B-B----------?X-----o------?o--B---B---oX--------B--M-------------B----B--
------T-------M--E------XX---B--------?--------E-XoX----BE--X-----X-----o--------?X-----o--X-X---------Bo--------X------E-o---X-X---X-------oX--o--X--o-E---B----M--------------E--oB---X----XX-M-------
-B----|--BXX-X------?------B-----B---X----XX--?--X-------X----X-X----------X----Xo-X----E------?-------XXX---------Xo-X------M-o--MM--BX-X-XX-EE---B--X---XBEo---o--X?-----oXX--XE--o---E---B----o--E---
------|-------M-oE--?X-o--X--X------B--o-------XBXX-?------------------X-oX---o----o--------------o--B-o--o---X--XX------?--X-X-XE------X------B----?---?--B-X-X---M--B---E----o-----------EXEB---------
---X--|o?------E--------o-o--o----XX-----------?B----?-----?--------o-X---o--X-----------------B---oB-------X-o---o--B------X-B-------E-B-B-XX--o-----------X--?-X--X-o-----------o-?------XX?--------o-
X-?-M-|------o--X------------oX?------o-----X--------X-----X----oXX----X----o-X-------X---------------Mo--X-----------------------X-X-------XXo-X-----------X--B--E---------o-o--B---o-o---E-X-X-------B
---XB-|-X--X----oEXM-X-------X--X---X--------X-M--X--B---X------X----X----------B-X--------X--------------------X------M----o-------B-------X-------B---Xo-----B-------------------------E--X------o---E
------|--B------E---oX----o--XX-------?o-------?---B-------o-------o-----?-XXX-X-----X-X------o----o-X----B----X-------X-----X--E--X?------?B----B--?-?--?X?-?------------o--o-----------XX--E--X-o----v
-Xo---|--------o-----------X---X--X--------X------o-X----o-----B--Xo---X-----oB---X---B----?o-----oX--X-------BX------------o-------------X-X---?-E------B-BE-----o---E--X--------X-X--X------?------X--
--X-Eo|o-------E---------Xo-BB-----M---E------M-X------o---X----X-B?----X----X-----X-----------o-?o-----E----X-X-------BX-ooX-----Xo--Bo-----------B--------------X--------M-Bo--oX--------------X---EX-
--M---|-o---o--MB------X----X--X---X----X-X--B---o--M----B--------X--X-oX----M---B-XoX----X-BX?----XB-XX-?----XX----o-o---o---o-B-Xo-------XoXB-?--X------X-X-----??----E-X-----o-oX-E-o----------X-----
--o---|---??--?---X-------?-X---X--Xo--o--------X------------?X?-----X-X----oXBX---X---X---o-o-X--M-----------oo-----XX-------------B----XX-X---XX-----X--M-E---------o--E---M---M-?E----X-X----X-------
XX----|-XT----E--XX--o-----X--B-BXoM---X-T-----X--------X----M-E---B---oB?----------M------------X-B--oM--------------X--------------o--------?---EX-E-----o---Xo--X--?-X---------?X---------XXEX-------
----X-|--|-----X----------?To-XE--------?|---X----B----------------T---------------o---E---------X----M--X-X-----XoX--E-M----o----BX-E------E--oX-X--X----oo-------B---X--------X---X?o------T--X----X--
m-----|X-|------X--------X-|-X-------XB-XXXXX-----oX---------X--?-M|--?------o-----------E---BBo---X--X---------X------?-o-E-----oB--oXB-------E---?----X-------------X--------------X----o-o|--------X-
XXXXXXXXXXXXXXXXXXXXXXXXXXXXXXXXXXXXXXXXXXXXXXXXXXXXXXXXXXXXXXXXXXXXXXXXXXXXXXXXXXXXXXXXXXXXXXXXXXXXXXXXXXXXXXXXXXXXXXXXXXXXXXXXXXXXXXXXXXXXXXXXXXXXXXXXXXXXXXXXXXXXXXXXXXXXXXXXXXXXXXXXXXXXXXXXXXXXXXXX
