--------------------XXXBB--XoXX-----?XBBXX----?MXB-BEE-----------X--------BXBXB------MBB-----------------BB--------------------------BXB----------M------------------------------------BX?----------BBX-
--------B--------------X-E---------------?-o---M?--------o--M--o----X--------------o--------------------E----------------o---B-B--------M---------------B-------------------B------------B--------------
------------------------------XX--------E-X?------------M-----X??MXB??--------M---------------------------XB--------------M??----BB------XBBBXBX------XX------?-----MXB-----------------------X--BB-----
-?-?-----------BXB----------BM----??BBB??BB------------------XMX----BBMB-----------------------------------------B-----------------------X------------------BB-----------------------MBX-------BXBX-----
B-------------B---X-B----B--------X---------------?-oBXBB---------------X-B-----------oX?---X------B-------------------BBB---?B----XM-------XB-XXM?--------B--------oB------------------X----BX--------X
------------??B----------------MMX-------------------BB---------oXX--??M?B--BXX---------?XB-?XB-?B--??-------BMX--------BBB-----oX------?--B-BBBB--------BB?-MBMX--X------------------------------BX----
----------?---------XXB--XX---------------M-----?X---o---------X--------XBB?--B-----o-------X-BBB-----------------XX----------------?BB-o---------??----XMMMBBXB-MXB-----------------BX--XX-------------
B----------?-BBX--BB---?----B--BX------------XBXXBX?BX----BBB-----------------------------BB--X-----------------M?BBB-X--------------------XXX--BXB-------MBB---XBBB-BMXX?B-----------------BMX-M-----Bv
B----------------------M-?------------------MM--BBX-------------------------?-B------------?--------------------------------------B-----------BB----B--------B-----------------XBB?------------BBB-----f
-XB-----XX?--oXBMX----??------------XBEB--??B--BBB---??----XM--?BB-X----E-B--X---o-----o-B---XXB------BX-----------XBBBXBo-?XBXBoB?X-----B-------------------------------BB------BXX--XXB-?B----------Bf
----------?--------?-?-?---------?BB---X?--EX-X----M--------------------------------------B-------------------BMB----------BXMX-----XXB--------------??--------XX----XX?X------------M-------------B?--f
-----------------?MB-oX?X-----------B---------------M-----------------------o?M?-X-B------------------------------------??-----------------BXX--------------------------X-----------oBBBBB--XBXB-------f
---------------?---?X------BM---------------B----MBM---MXB-B-----X------------------o?------?---X---B----XM---------------------------??----------BB-------------?MBB--oo-BM--------------X------?---oMf
---------X--X?-----BB-BXB?----------?----X-----o------B?-------------------------------------BBBB--------------------o--------BX--------X??X---------X-----------B---------------------------X---?-----f
m---------BXB?BX-XXX-?------o?B--BB---T-------T----XBooBBB--T---------BBBB---XXTX-----E----MB--XB-------------------o---------------M--------T----MBXX--------X---------o---------?-------BB--------XBTX
X------------BB---------X-BB----------B---oBB-|B-?----------|X----------B----E-|------B----X---?----EB-BB-------------------BX?B-XXB----XX---B------------BB-----------------------oBBBB--------X-?X--|X
X--XXXXXXX-XXX--XXXXXX|XXXXX-XXXXX-XX-XXXXXX-XXXXXXXX-XXX-|XX---XXXXX-XX-XXX-XXXXXXXXXXX--X-X-XX-X-XXX|XXX-XX-XX-XXXXXXXXXXXXXXXX|-X-XX-XXXX|X||XX-XXXXXXXX-|XXXXXX-XXXXX-XXXXX-|XXXXXX-X-X-X-X-XXXXXXX-
