-------M--------------------------Bo------M--E-----B------o------T-o--------------------B---------o-------T----B--------EoT-o-B---|---E--------------------M-T--------?-------X------X-o--------------M|
-B---o----M----------------------B--o--------B------------------E-----------M--BM-T----------------X?----X-------o--o---E-------------E?--|T-o--------E----o---M-o-----o-----o-?-----------------E-----E
---------------|-|---o--|---------|--o-B-----------------------------------B------B-------B----------?---o---------------o-M-------Mo--o---------------------------o-----?--oB-o---B-----------o-------o
------B----X-----?----o---M---------?--oE------B-----------B-M-------B-o-----M--M--------oE--o-----------B-------?--------EE-----------o------T----?-----------o-----Eo----------------o-----E----B-----
------E---X--ET-------T--T----|----------------o-T-----------o-----X--------o-------E------------------T-----|------Eo----?--------------E-M--o-------B---M------TT------|------------B----------B------
-----------o-----o-----------|------------o---------B---------T-M--o---MB----o------------??------------E----TT-----------E------M---------------------M------------------X--o-----------------o----|---
------?------B---?----|-------?B---?-----?----o-------------------------E--------?------o---------ooo-----------M--M-T--|----?-----B---------B------------o-|-E-------o---o---o--M--X----------T--------
B------------------B------------B---------------E---E-M----------------T----------------------------------|---------------?---|o----B-o----?--------------B--E---?----?--B-------------------|--o--B---v
--------o---B------------E--|-------o------------------|-------------?-T-E-----o-?T--o---?-----------------o--------o--------------------------------o---|-M--B--B-T----------B|--B---X---B?---B--------
---------o----B-E--------------------E-------o-----------|----------------?---?-----M-M--------------?------?----?------o--o--X--?-----------------M-----?-----TE-----?------------------X----B---------
-----o-X---------------------X--------E-o---o----------------E----X---B-----------o-------------------------E---?-T-------E--------o-----------E-o------T----X--BB-------------?--------M-----B-?-------
----------|--MB-|--o-B----?-----------------?--|-----|------------X----------E---B--TE-------------?---?-------oM--X-B---------E--E--?---o------------?----------o|---------E-T------B---|-o--------o---
-M-X-----BE--------BM---|-?T----------------------o?-E---?o|---E------o----T-T-----o------X---B---?-----------o----------|---o--T--o---------------B-----------------------------------B------?---------
--?--X------E-------T----------------E-----B---?-----X---------?----o------T-----o-o-?-------o-----|-------------oB---M------------------------------B---o------B---------?-B---------------------E-----
m-------E---o?-------E------------|---------o------T----------o-|-?---B-B---------?--------------X?---?--?B---E-----------o--------------T--------E--o----?T--M---B----o----B-------??---o--------------
------Eo----E----B--------o--B|--?----------?----B----------T--o-E--|---------M------------?-----B----E---E-------E--o-----o--------------------BT------------oE--?----|--E-------------B-----B-------B-
