-X---------------------------------------XXXB----X---o----------------o-BB??M-XXX---------------------------oB--------------EXBX-?--------------BXBo-----------oB---------------------XBB-----------oB--
------BBM------------??X------------oBBXBXX------------------------------------oXX-----BM-------------XM-----BBM--------------------------BB?B---------BX-------BB---BBXB----------------------------BBM
-------B---------------------EM?-----------------------------BB?----------------------XXXo?B----BB----------------------------X--?------XB---------oX-----------------B??----------B---------------MBB--
----B?X---------?X----------------XX?----------------oMBB-----X---------BXMB--------X?--XM--------------------------?-------BX--------MMBXX----------------------o?-------------------------------------
---BBX-----------------------------oXX--BM-----BX?--oXXB-----------------X?----?BB-------------------?XX-------------oXBX---------------------M--------------BXBXX---------------B------XB--XX--------B-
---------BB----------B?----------------?BBBB---------BBM-------BB----------------------X-------XX--XBBXX------------------BBBB----X?----M--?BX?B??-------------BB-o----------------------------------oB-
--------------XBXXBB-MB?X----------M?-----------------MBBB??BoB---MBXXBB-----BB---------------oX---------BXXX--X------------XMXX--MBBBo-----------------------X--------E---?M--------EBB----------?MB---
--------------------------------------------XMBB----XB----------------------X---MBMX?X-----------BXXX----B--MXB--MX?-------M--------XX-----M--------ooMX-------------------------M-----XBBX?-----------v
------------------------o----?B----------X---XXX-----BBB---------B------------------------E-BBoXBXX-----------------------------X-----------X-X-----------------BBBBBBBB---X-----BX-----------?----o-MBf
---X------------------BBMM---------X--------BXBB-------X------------BB--XBB-----------X?XXB?B----------------B-------??M?-----------BBB--B-------BB-------XX?-------MB?--oB?MXM------------------------f
----?MMBB----BX----X---M----------oBX?XXBB-------------X----------X--XXB----oX-o?-----------X-------------BB--------------------------BM-----------------------M?BB----BB-----------------B??XB----B---f
-------?-------?B?XX---------oXB-----BM------------------------XXB?X--------oX-------------X-----B-------------BBB----M------------------------------------??XM-------------------------------XMB------f
---B?-------B-----------------o----------B?B----------XBBB---------Xo-------EB-------X?------BBB-----------MBX?-X----------------------?BMBo-----XB??--------------------------------------------------f
--BBM----------------------------B------------------------MXBX-------B--------XX---o--------BB-T----XB-------------------BMB-------?BM?XXX-----?M?---------------X--B-------------------XX----------XBBf
m----B--BB---XMXX---------------TXXMBXX------------TXXXBX-----BBM--------X?--------XB-TX?B-BXM-X-T------T--------BXB------------------BBMXX?----X?XB---------BBB-TXBXM-B------BBB----TMM-?-------------X
XXBXXXXXXBMBBXXXXBX-XXXXXXXXX--B|XXXBBXMXXXBBXXXXXX|XXXXXXXXXXXXXXBX-BBBBB-XX-XXX-BBXXBXXXXXXXXXXXXX-XXXXXXXXXX----B-BXB??-BBBBXMB-XBXXXX-XXXXXXX--X-XXXX--XBBMXX?XXXXXBXXXXXXXX?BB--|XXXXXXXXXXXX?XXXXX
