TXo--X----BB-----E-o-------------o--------B----|--o---?----Mo----X|--E-----X--------o-X-oE----?----XT--X----X-TX-B--o------X-X-----T------------X-?o----oX------X-o-X-o------XoX------X--E--------XXo?-E
-----o---B------T----X-------?-X--o--X------------TXM-M---X-----oB-o-----o----------B-----o-----oX----X---B-------o-----E-?-E--X--X----------X---X--oo-----E-X-----o|--o-----X?o----X----XB---|--------X
X-Xo?-o--B?----X----?--B-E-?-o-o--X--T-X---X-X--X--X-X-----oMX------X--E-------Eo--|o----?----?----o-X-?--------X---E-X-B-E----------o----B---?--X----?--X-BM-|T-----X---E?-X------M-------B-----E--o-EX
-----B-----B-?o-X------X---E?---X---X---?----------B-------------XB-M----MB------o-----XoE--X----o------o--X--------X---o---------X---------E?---?-B----B----o---E-E-----TXo-----BX----------o-o-------X
---X-----E-------BX--X-------X----B----o------Xo--B--------T--M-X---------X?o-oB---------X---X-----o----------X----E-o----------------B-o---T-M----------B--------B-----o--X-------X---------T---|-X----
B-------|----o---XB------Boo-----------X-XBB------o--X------------X---X-----E-----X-------X------Xo----E----------X-|------B---X--------E-Bo-X--X-X---X-?o---------T?---X----BX-oo--------E--M---B------
-X--TX---|-------X--XX-------Xo-------T--------E--------o---XB-o--o-X-?-----?--?------X-----M--|-------X-------?------oX-E--|---X------X?XXo-------o-T----------oXE----------M----M-?-------------o-----
M----B|-----o--------o------?o---X-E--o-XX---------o-------o-oo---X---------X----o--oB-------oX-?o|------Mo--M-------B-X----X-X---?---X-X---EX-B--BX------M?-------Xo-|--B---------X--o-X?X--Xo?------Xv
X----o-?--XE-----o------------o----------B------o-X--X----XE-XXX----E--|-X--B----T-?---------E--------M---X-X-----?E-----o-X---------X-X--X---XX------B---X--X-X----------?------------X--Mo------M-o---
-------|-----E----Mo----------X-----------X-----X-------o--Bo------|X----X--XX-X-X--------XX----?T----X-X----------M----X-o|---------X---o----T-X------E-o---------?--ME-B----B---X----?---------oBET---
------------X---B--T-MXX---X-X---M-----X----------Eo------B-------M?---o-?X--Xo------B--XX----------o-----------?-------XTE----------o-------X------TE------M------------B------o---?X----X---X--X------
-Eo--?--X-B---------X-X-----o--X-oBXM-o---XX----X-o|B----------o----|--------Xo---------M-oEE---------X-?--X----------X----E--X----X--XX-----X----------B--X---o--X|----oE-X--E?------X----X--MXX-X-----
----M-----o---B-B--X----MB-o----XXX--E-----X------oXo-XXX-XBB--XEo-MEM-o-X----XE----X------o-B---T--X--X--E-X--XoB---?-B----o--o------oo--o---?BB-B------X------oX---E--o---ooXXX--X---------E-X-------E
-E---?------X---E-X---XB---------M|-B---------XX--------------------X--X-X--?--T----------------M--o--B---------Xo-|X----B-----------B---X|o----|--o-E------X-----BB-o-X-------B--X-X---?--------X-?-BX-
m--BoE-----T-------------X--To----o-|-X--B---X--------T---T-M---X?M?--Xo??-E-?BE--B-X-o-|-M-?---T--X----XoX-----?-------------T------------Bo----------?-----|M-X-B--X-|X-X-X---X-X-------X---X------|-X
XXXXXXXXXXXXXXXXXXXXXXXXXXXXXXXXXXXXXXXXXXXXXXXXXXXXXXXXXXXXXXXXXXXXXXXXXXXXXXXXXXXXXXXXXXXXXXXXXXXXXXXXXXXXXXXXXXXXXXXXXXXXXXXXXXXXXXXXXXXXXXXXXXXXXXXXXXXXXXXXXXXXXXXXXXXXXXXXXXXXXXXXXXXXXXXXXXXXXXXX
