--------M-----B---------------------XB---------BB?XB-XB------BB?-----------B---BXB------XBX---------XXXX---------------B-------------------BB?---M---------B-------?-------------------BM------B?-------
---X--------------------------BBBM---XBX----------------B---XBB------------------B------------X-------------MBB-----X--X??X------E?---X---M------Bo-------B?BB-----------?-oB--EB-----------M--X-------M
-BB???B---BB--------BBBB?BB-------------X---X----XMME---BBBXB?---EXX---MXB-------------------------B-------XBX-?BB------MBX---B------BB-BB?MB?B-X--------------BB??--oBB----------BBBBBX----------------
-XX-BBX-------M-------------------------------------------------------BB--------B---?B----------oX-------------oBB----------BMX--------------B-------X-----X?BB-----X--X---------BBB-??XBB-----------XB-
--------------------------------BXXBXB-BBX--------------XXB-----------------------MX--XXB-----???XM-------oXB-X---------------------B-oB?---------X-----B?X-------B----MB--X------BMM-------------------
-------------------MB?BXX---?X--M--?MBB----oB-------------------------B?--BB-oXBX--------------?---B----------oBBB---X----------?XM----------------oB?-------------------------B------------?M--oBB-----
---------MXBXXXXXB--------XMB-----------X---B??BX---------?MBBB-----------BMX------BXXB---BB--X-------B?------------------------BX?---M----------?BB------------EX-----BBBBBBX??-EXB----------XX?-------
-------B-----------BB--------Xo---B?X----------M-------------------M---BBB?---M---------XMBB-----------B------BoX--?XB----------------------------------------------------M?----X??B--------BMBBBX-----v
--------------------------------B----B--XM?BMXBB-BBXX----------------BMXB-------BX--------------------B?XB-----B??-----------------------MB---XX------XXBXXBBXM-----------------BMBXX-------BBX--------f
BX----------M-------------------XM--------?-------MMXBo-----MB---------------XX--------X--MBXM-----------BBBX-----------BXM------BBXB---BXX-B--BXB----------M------M-XBM-B------------B---------XB-----f
--------XXXB---BoBXB------------------X--------BXB--BX-B----oM---X-------B--------B?BBMMX--------------XBBB----------------------------BX-----------X?BMXB-XX----------o?XX--MBBBB--BXMBBBB------E-----f
---------------X?--BXXXXMX?B---BBBBX-----B-----M-------M?X-----------------BBBBBBB--X----------------------B---XXM-----------XX?----o?MX------X?BBX--------BB--------X----BBX------------------XB------f
------------------ooX?--o-------------------------------------XXB----------------?-X-----------------MBB----------B------?B?X------------------------M---?---B?-----------------------oB---------------f
------------X------------BB------------B-----------------?----------------BBBX----BBXBX----XBBB---EMBB?X--------X---BB----------X---B-?BBX?BB--------------------------------------------X-BBXX--------f
m--------E--------BB-B?---BM-------B---B-----M-----BBB------BB---B---MBB------------TX------------------XBB-----T-o----?-MBB---------B---------?BBoBBBB---BB------------MB-----MB-XBXX-?B--------o--M--X
XBB?B---XX-EX---------------------BM--?X-B?MM------M-----------MXBXB?---?-------------M--------------XXBB--BX------------BB---------BB------?-?B??-----XM--BM----?--------MB?-------B-------------X?BBBX
XX|XXXXXXXXXXXXXXXXX---XXXXXXXXXXXX-XXXX-X|XXXXXXX-X|XXXX-XX-XXXXXXXXX--XXX-XXX|XXXXX---XXX|XXXX-X-X-XXXXXXXXXXXXXXXXXXXXXXXXXXXX-XXXX-X-XXXXXXXXXXXXXXXXXXX-XXXXX|XX-XXXXXXX||-|XX-XXXX-X-XXXXXXXXXX--X
