------?------------------M---|-EB--M----?----|-B---?-------o----o---T----------oMo-----|----|--------------E-B--B-EB-------------------------------------------E----------o----------?-----------o---o--
--o-------o---o---------------M--------X--?B-------------X----------X----------|-------------M------M--------?---B---E-----------X-X-------?-----B-----E----------------------?-------------o----B------
---------------------------M---------------?-----B--------------o--|--B------?---T-----X------o-------?---EB----------ME--------------E----o--------o------o--|--E-----------------------|---E?o--------
---|-------o-------------?----o--B-------E-B------------------------o--o--o---------------------B-----------?----?-----------o---------------o--------------o-----o--|------------------o--M------------
----------M------M---B---------|-o------------------------?---|----?--o---B----M-------------M--?|---------|o---------B--B--B---------o-------?-T------------------X------o--?--X--------------?------M-
---o------|-----B--?---o-----------o----o--------------X-B-E----------B-----E|--o-T--|--------?oB--oo-----------B----------o---??T--------X---?-MB---------------X-|-----XM--E--------MX------------B---
---B------------------o-------------------------B----------o------------E?----------------?----------|----------------B-----E----M-------B-E-----?oE--------E----o-Mo--------------M----?-E----------T--
--E-----?----E----------?--o--------o------------------------------|-|-o------o-------M----E-E-----o---?----------M---------|------M--------------------B-------?-o---E---------o------o|---E----------v
---------E---T----?-----?-------o-----------------o---------o----------B-----------------------X-E-------------o-oB-----M---B-----o-?B-------B-------------|-----BX--oo-E------------------------T------
------------|-----?-------B---B-------o--o-----------E--------B---------o------B-------------?---o--o-----------------------------?-----o----------X----E-EB--?---|---------B------B------o-------o---M-
-------EM---o-?-----B----------------X?---B-o-E------?--------o-----oM--|-------------------T-?-X---------B----------M-E----|-?-------------oB-----------------?----------------oT------o--B--o---------
-------?----------?-E----------o--E-o-o-----X-------?---------------B-B------------E----?------?-------------?---E-E---------------T-T---------B-E---M--M--T?-?-XT-B------?|E-------------E--------o?---
--?---B---------M--------------E------B--?-----------M-?------------o--BoE-?-------------------------------------T----------------E--------o---------o---E------o--B---?-----------------B--------X-----
-o-------T---------------|---------M|-E-o----?-?--o---M---ME-------X--o-------------?---B?---X---B---------------o----------TE--T------------------T--------------BE---oE------------|-----------|---MB-
m------M------B--?----E----B-------------M--E----Eo----o--M-----Bo-------E-------B----T-?TT-------------?--B-o---------|-----------T-o-----M-T-------------------?o--?-B---------o--M-----M------|-----B
XXXXXXXXXXXXXXXXXXXXXXXXXXXXXXXXXXXXXXXXXXXXXXXXXXXXXXXXXXXXXXXXXXXXXXXXXXXXXXXXXXXXXXXXXXXXXXXXXXXXXXXXXXXXXXXXXXXXXXXXXXXXXXXXXXXXXXXXXXXXXXXXXXXXXXXXXXXXXXXXXXXXXXXXXXXXXXXXXXXXXXXXXXXXXXXXXXXXXXXX
