--------------------------------------------oB-------B?-------BXoB-BB----------XXM-----M?------------------------------XB----MX-------BBX-------BB------B----MB?---------B?X----------------------------
--?BXBB----E?MX-------------------M?MX-----------------X--------XX---M?--------------M---M---?BBXM------------------o----------E-------oXX---X?-------------oXB----BBX---------?X----------BX---??M-----
--------oBBX---BXXBMBMBBX--------XX--------------------XBXB----X----BXX--------------B--------------XX-BM?X?B---------X?--X------------X---------BM-------o?X-------------BB----XX---BBXEB-B-XMX--------
----------------------o------oo----------?XX-------o-----------------------?XB----------------------BXB-----oXBBBBXMBB----MX-------X?BX?-------------------X?X--------oX-------------------BB??-?-------
-X?--??----------------------------------X?BBXX-----X------M---------------BB??-----------XBXM-------X------------------B?X-------XBB-------------------oX?-oMX-----------BB------------BMMB--------B---
-------?XBXBBX??----------------B-------M--------------o--EB-----XX---X?M--XB?B-------------------------------------------o?----------------------B??B--?BBX--BB---------??---------------??------------
--X?-BBB--------------XB--------BX----------------?MXB??M---------------------BB--------BX---------------------------------BB?XX-X?M---MXBB---X-M----------?BXMBBBB?---------MMB?BB------------?--------
---BMoBXBXB-----------XB-oMM--------XBMB??----oXM---------B-----------oXX------BBXX-------------------------BX--------------------B--?X---------XXBX-B----------X?-----EBBB?X-----------XBB--MXBB------v
--M--------?X?--------B-------------X-----------XBBX-------------E?--------------?oXX---------------XB-------B------------X------X-----------?---XB------------B-BBB---BX----------------BB------------f
oX-----------BBB------X-------B------B-----MB----XM-X------BBXX----------X?BB-------------------------BBB-----XB--------B----------XX-----B?-BXB--------oMXX-X?--BB---EX?-X---BBXX------------B--MB----f
----B---XB?-X?BX---B------BX--B------?B-----------M-----------------BB----------B-----------------BXXX----------------?BX--MX----EM------oM-XXBB-------BX------XXoX-----?B--BB?-------------XB---------f
-X---------------XX--------------MXB------------B?----?----BX--------------XX------MXX-?------M----M---?BX--------------B-------------------------------------------------B-------o?---o---------------f
-----------MMBM--------?B------------------BB----------------------------------------------------------?--BBB?X--------MX-----------BX------------------------BB?B------------XB----------------BX-----f
-------------oXB?----XBBMM?B-------------B--?BXX----------XB---E?-------BBB-------------?-----------o----------------o-----------??B-----------B---------------------------BX?--XB---------BB?TMBBB?--Bf
m----BT-X-T?-------XB?X-----T?---MB?TX-BB---BBX---------?MMTX---------EX??---------------BBBBMMXBTBB-----T?-------------------------XXXXX---TB-------------TX----TXXM--BX-------------T-----BM|BTX---B?X
X-?MXX?XXXXXX--?XXBMXXXXBBXX|XXXX-XX|BXXXMXXXXXXXXXBX?XXXXXXXBBBBXXXXXMXXXXXXXXXXXX-X?BXXXXXXXXXXM?XBXX-X----BBX-MBXXXX?XXX-XXXXXXXXBXXXXXXX|XXB?X-BBXXXXXXM?XXMXX?XXXXXX?-XXXXXXXX-XXBBBXXXB?-X|XXXXXXX
