-X--------E|--?---o---------------o------M----o-BB------------X-XB-X---XM--B|---|---o-X----o--X---X--E---oX-----|---X------o--X------------o--X-B-----BB-X-------X---------------------B---X------o-----
XoX--XT-X----X---B---------------|--------------X-----MBX-oXM------B-----B---------oX---EB|-Eo-----B-o------?--X-------X---------------T-BX?-o-?-------o-------o-----X-oX--o-oX------?------------------
---o--|E---M----EE----?-?-----X-----XX----------T|X----oT-oE------o----?B----------------B---|--oo---o-----X--X-----B---XX------X--------X-----X--o-?--X-XXTXX------X-X----EE?-------------?------E-oX--
-o-X--|----------------------------XX--M-----B---XX-X-----o--------X----oE--X------------------?|--X---B--o-|------o------------?---T-----X-E---------B-----X----X------------X----------B-------o------
-----o|oB-------XX-X|-X--------X-----oX---X----X|-o-MB-------X-------------------|-o--BX--XX-------------X--MB------X--X----X-----?---?-----E--------?|-X-----X------------B---------X-XB------o---X----
------|----------B------?-o?-X-X---X-o---------MX------B-o-------o-------X-----E--BB---------o-XXX-|-----------o-----oB--|-----o--X?-X-------------o----X---X-B--X-------?---B------------o--XX-|-------
----B-|X---|---?----?------------X--------------BM----B------X--T-X-o---------X-X---XX---X-XM----o--X-X-----B---X---X-BE-B----X-X----X------B-o---------TB-------------X?-?------B----|---X--o----|--XXB
B--XXE|-----oE--?--------o--o---------?--X---XXM-o---oX-E---B----E-------X---XB--?|---o---X---o-------?--------o|------X--B---oo-------ME------XX-------?o--------o------X------|--X----XoX-EB--o--XXB-v
-----E|--X--X-X---?X-------XXM--------o-----E-XTX-----------o---B---X--oXX-X-XoBXXB----X------|--X---B---XM----B---------B------XXXE--X-----E----X-Xo--XM-o--BX----X-----------XB----XEE----------X-----
---X--|---T-||------o---o-----B-?--|----X----E------o-|--E-------o-------o----o---X-----X----X----X--M----|--B--XB--EX---------X-X--X-B----X----XXT------X-----XB------BX---X-XX---BM-oX-|o--------o----
----XM|-X----E----XX--M--X--X--T--BX--o-E-oBo-XX--X-X-o-------o----X--o--B--------------|-XX----E--|------o--X-o----------XX--T---oXo------?-----X--X-----Eo--X------B---E---?X----------------E--------
--BX--|---------X--X---TB-----?-XXXXT-------o-X---o--X----X--E-o------o----B---------o---oX---?--oB--------T----B-----XM---X--T--|X--E----X?--oM----X--X--o---XX----M--?-----X-----------X---o-o-X-o--X-
------|-X------TB---o-----M-?------X?-M---oB-----oX------o---B----o--o---------------------------B---?-X--X---o--o---o----Xo-X----?---o--------------X--X?--E-o----X---B--------B--o-X--BBo-------X-o-X-
------|--XX----o--|-X-X-----X--|-X-B-XEM---------M-----B-X-X--o---o-B-oo---X----------B---XBo-XX----X----------?o-----|---E-oo---X----X--T---B---XX-------B-MX------MX----X-----Xo-XM----XB-------M-----
mB--X-|--XX---|X----XX-|-----M----XX-X-----?----------XX------------E-B-o--|X?----XX-----X-----X-------M--?--B-B-X--X-E---X------o--X-----X---|----XM-------B??-X----XX--oT--------oX-----o?---X----X---
X-E---XX---X-X-o------oE-oB------XT-------B?---X----E-?---E-o----------E--X----X---X----MX------o---?--------X--------B-?--------X---E--|X---E-XBXX------X--Bo---B--------X-o-----------B---o--X--------
