--XE---------------?--------M-----XXXoBBBMM--X--??B-----------B------BB-------XB------?oBMBBX-------BoB-------MBMB-XXB--------B-XMB-------------BB-------------B---------XB--BB---------B---------------
---o--E?------?XX---B------------------X-XXXB----M-------------o------XX-------------------------M------------M--E--------------BB--??-----------XX-----------------oXB--------------BBBX----MX--X------
-----------------B---------B-------------------------o?---------------XXMXBB-------B--------E----MB-----o--------------B--BBM---------BX?-------B-------------M--------------------BXB-------XB------?B-
--B---------?-----------------BBX-----BBB-----------------------------B----------------------------XX----------------------------------------------------M?B------------------------M?-------------MBB--
XX------------BM-------XB------B--BB------o?----------XMXXB-----------BBB?----B-B---BXB----------------X-------oXX-----------X-----------------X?----XBM---------------M-----BM?B-----?X----??M--------E
--------------BMBXBXX?---------------BBBB-------------------------?BB?---------M-B--BM-B--X-----------BBB-----BB-------------------?XBB-XX--XMX-----------------B--------------X?XB-----?X-------------X
--X----XX----X----M?-----?----------------BXXM-E?oB------------------o--B---------?B?X---X?--------B---------XXBXXB-----B-----------------B?------------------------------X---------------------X-MB--X-
--------------B--oBB---------M--------B----BBXXX-M-------B-----------------X--------------BBB-----------E----BB----XXXXBXXX?M--------X------E---MB-----BMB---?---------------o------------------?X----Xv
----------EB---------------------------------------B?X-------BB-----------BMB---o----------------------------??B---------------------B---------------X?BEBB-----------------o-------X----MB--------B---f
?-----------------------------------------------XMM?-------------??-----------------BMXBB----?---XMXBB?----oBMBMBX?XXM--------------??BX?---BB?B----B-----?B----------BB---------------------X-BM------f
--------------------------------------------------------BX------X--X---------?--X?B------XB-------MX-------BB------BEX------------B---XXXB?-B---------------M----??BX------BX?-------------X----------of
--------------------------MX?----B--------EBB-------o----?X-------M----BBBBBM-BB-----------------XMXB------------------------MBBX----?M-----------------XX-------------------XXB-----------------------f
--------------------M-B----------M-X---------------------------------BooXXX?----------------?BB---------------------------B---BB-------------------------X-------X-----------XB------------------------f
-----------------------------------------B?B-B--XBB-----------X------??-????B------------BBX-------------------------o----------------B------------------o-------------------------BBBX-XBBB-----BX----f
m--------T----------XX?X--B?----------------o-------------------------B-X---------M--Xo---------X--B-BMT-----T?---------------------BBXo----oBB-----------T----oMX---------?M?X-----------------o------X
X-B?B--BB|M-BX--?XX---------------------------------------------BB?-X-?B?----------B------------XMMB---B-----|B-B-MX---BBB-BBX--BB--XM----TX?-X??-------------------------MX-B-------B-?XM--BoB--------X
XX-X-X||----XXX---XXX-X||XX-XXX-XXX-X-|X|-XXXXXXXXXXXXXXX-X-X|XXXXXXXX-|X--X-XXXX--X|X---XX--X|X|-X--XXXXXXXX-XXXXX---XX-XXXXX||XXXX--X-XXXXXXX--XX-X|XXXXX-|XXX-XX-XXXXXXXX-XXXXXXXXX-XXXXXXXX-X-XXXX|X
