------E------XX-X---E--M-X-----X---BX----Xo---------X---M--X----X---o-----MX-----------X-X-EXo-----------X---o------o-------?------X---?----B-B-M----X-------o--------oEXX----X-?----------M----------XX
E-----T-X---oM--X-B--------------------X-o------o---X----------------X----------B------o----EB-----------XX---------o---E---X-o---------X------------B?E-XX--------X-------X-B-----E------X-XM--X------X
X-----|----X---------X---?o----o--X--------------o-------------o-XEE------X-----X-----X-----X--X-o-----X---B------------X---------MX-?------X--o-----------E-X-----BE------E-------?-o--XXM-B-----------
------|------?--X----------E-o-oo--X--------X----B----E-XX?------X------?-----------B-------oX-B--X--X-----B----E--o--X-o-o----M-X------XXXM-XBX--X-E--X------------------X---o-?--?------------Xo------
E-XX--|----------------o-----X---XX-----Xo---M------B-------E-------oo-------X--X-X-o-----------X-E-X-?--?------oo-------X--X-X-----B---B---B-o-M--X---------X------X--------------------o-----------Xo-
E-XX-X|-oX----------E--X----BB----X-X--E-B-----X----M--o?-------X-??B-------EEMX--------XXB---o------X--XBo--B----X--X--XX-------------M---------E----X-X-?-----X----M-Eo-XX--X-X---??------?---------XX
--E---|XX-o----X---o-?----XB-------X----------Eo--B---B-------B---M-------?--X---oo------------M?-------X-------E-----?X--o----------o--X-------B----X---X-----X-------Xo--E-X------------------XX-----o
--X-X-|---X-XX-M--?---X------o-----Xo-X-XXo-E----E---B-----MX?----X------?--BX------XX-X----B-o-----X----MB----B-X---XB---Xo--X----o--X---X---------------X-------------------E-?-X-------E--E---------v
X-----|-----B---E-------------------X----X--?X---?------X----o---X-X---X---M---B----------B------oM---oX-X-X---oX---------X------------B---?EXX------EX----------------X----XX--X--?-?-X--E--?----o--XX-
------|B-oX-X-----o---?-E---?----X---------------X-X--o-----o---E----------o-?---?---XX-----------X-----X--o--X-----------E-----o---------oX-------X------B-oX-X--X-----o---X--X---o--Xoo--XM-----------
---B-o|E-X-----------------------------X-X--X------?---X-X-------------o--o---E------M-X---E-------o--o-------X------E--XE-XX-oB---E-------X-----X?---o---------------?---X-?--E--X----B--E--M-XBo------
------|-------------B---EE-X------BX-----------X---X---o--X---oE---X-X-X--B----X--M-----X--?X-----X-----o-----------B------X------X-E---------B----BX-----B----B-M---X--X----------------o-------X----E-
X--X--|--o------?M----X----X--XE----------o-B------B--oX---X-----B-?-------Xo-----X-X-----------X--X-X-----------------X-----E--X----X?B-----o---------B-o---X-X----o---XX-----X--X-----o----------Xo-BE
------|--|-----------M------T-----B----T-E------EB--X---B--E---X-X---E--Xo-----------X--X--------?----XXB---XX--TT-X--o--M--------------o-------E-------X--oX------M-X--X-------oM-----X--X-X----B-MBT--
m---E-|-o|-X---?---?-M--Xo--T--X--X----|-------------o-------X--X?-----XM-?-------X--B----X-----E------------|--|T--X---------X----M-----E?---X------EX--B--B-X-B-X-B-----o-----X-------M-X------oX-oT--
XXXXXXXXXXXXXXXXXXXXXXXXXXXXXXXXXXXXXXXXXXXXXXXXXXXXXXXXXXXXXXXXXXXXXXXXXXXXXXXXXXXXXXXXXXXXXXXXXXXXXXXXXXXXXXXXXXXXXXXXXXXXXXXXXXXXXXXXXXXXXXXXXXXXXXXXXXXXXXXXXXXXXXXXXXXXXXXXXXXXXXXXXXXXXXXXXXXXXXXX
