o?B---------------------------MM------B---------------MoBBBM-----------------oB-----------BB?XXX---------BXBX---X-----BX?M-------------MB--B---------BXXMX----------------------------BBXXX--BX---------
---oBM-?XB----------------MB?------------?BB----------------------------------XBMX---XMXBBMB--------MX----BBM--oXB---X-?---------------BX--------XXB----M-B---------oBX-------------M------??X?BX---B---
o?-----E----MM-----------?B---------BBB-----------------XB--------B-BXM---------X-BBXBX-BBXBB----------MXXMX---BBM---------------o----BB------?MB-------------------------BM--------XXXMXX---BM-----?MBX
o-B----------MBX-----------XX---------?BX-B------XXB---BBMB------BMB--?MBB-------BBB----BXB------------------MX---B?B--------------MBBX---------------oBBB---B--BBBX----?M-MBB----BM----X---??X-------o-
---------------------?BBB-------------------------------------------BXMBB-------------------BB---------------------------oXB?B-XBB---------------------------MBXX-------BBBB---------------XX?----------
EXoBB--BXM----B---XBXX--------------?---X?BBX------------------B?B------------------------------------XBXXX-------------------------BBM------X------------------------B-XX--BX-B-------------------?----
-BXB--B?BM--------------------X?--------X--B--------------------------------------EXXB---------?XXXB?B--X----B------XB?--------------------------X---???-----?BBooBX-------MB------MX-------------o-----
--------B---------X-------------------XBM-------------X--------MXXXXXX------------------XMBB-----------------XBB------------------oXX------XBX----------------BoM?--------------BBB-------?---oB-oB-XXBv
--XMB-BBXXX-------------oBB-----MBBBB----------B-------------?X----------M?--------oB------------------?-----------MBB-BB----------MX----------------XX---------B-----oBBB----------------XX-XMX-------f
---------------------------?B--MBB---------------------------------------------------X-------BXB------------------X?XX------BXB----BXB--------?XMBB---o?XXXBBB?-----MXBB--------BB-----X-----oX--B?--XBf
-----------------------------------XBBBBo?-----o-----BB---------B?------------BB-----------?B?oMMXB---B-----EBXX---XBX?--------------------EX----oBXo----------------M-------------?XBXB----------?----f
-----------M-------------o----M-----------BMM---X---------------XBX-------------B--B?-----?B------------XB---------------------------X--------------M----------------------BB-------BX-------B---------f
-----------------BMXB---------X---------XB?B---------EBB---BBBB------BB----?------------------------------------??BX-BBBBB-----------------?--------o--------------------XB-----XBBB-------------------f
------B?-------------------B----------------------------------XBB---------------------oB?XE-------------------B-------------B-XX-----MB------------BBBMB------BBBMB----E-------BBX-?XBBXB--------------f
m-------------------X--------oX-------BB-----------------TB-----BB--XBX----------------------------XBMBXXBXXB-----BM---oB------------------X------------??B?B------------------------------------------X
X?--------------XX--------------------------------MMXMXMB|XXXMB-------------B?BB---------BX---------------BXX-------BBMBBoXB--M?--------------------BM--B-----------------------------MXXXX------------X
---XXXX-XXXXX-XXX-XXX--X-XX-X-XXXXXXX-XXXXXXXX-X-X-XXXXXX-XXXX|X--XXXXXX-XXX--XXXX|XX-X-XXXX|XXX-X--X-XXXXXXXXXXXXXXXX-XXX-XXXX--X|XXXXXXXX-XXX-XX-XX-|XXXXXXXXX--XXXXXX-XXX-XX-XXXX-X-XXXXXX-XXXX---X-X
