------X---o-----E---E--X------------?----------------X-X------o??---o-M-------X---------------X-E-B-XX-Xo-B-BoXX?---?----BB-X----o?-M-------------X------E----o------X---oE----X-------X----X----Xo----B
-------E-------------X--------------B-----------XX----X--X-------X---------ooB-MB-E---B-B-----o-----------X-?-----oE----XMX--X---------------?-B-X---?----------o-------?--X-X--------o-E----M---?X--XX-
---X----BEB----o-X----o---EB---?---X-E-------X------X--X--X?-----X---E--?-oEX---?--??---------o----oo---E--X--XE-------------B-o-------o---B-B--E-X-o---E------------X------X----o-----oo--?----X-X---o-
-XE-----------o-Xo----X----------------o----X--XX----------o-----------X------o---?BoXX-XXX---X------------------E--B------------------B-X--------o-o-----B-------B-------------------X-X------E--X-----
-o-----o--?----------B---------?--------------X-B---o--X--X---M----------XE-X--------B--------X------BoX---------------?-------o----o-------------B---XX--?--------------B---XXX---M-----X?oo--X----B?--
----XM?-X---XX----X----X-----?X--M----X-o-X----X-X---o--E--EM--X------X-X--X-X----Xo-?--E-X-X----E---------XX-----X---o--X------B-o-----X-X---------------------X-o-------------B-?--------B-----oE---X-
---E-----B-----X---B-E-----X-----------XX-----M--?oM-X---?o-----X----------X-----X---X--B-----------XB-----------M-?---o--X--------X--B-X-----?X-X--X------------------E-----X-XoM------o----X------X---
---XX----X----X--E?--------X--B-----B-B--X-o------B-Xo----------?-----E-X--------------------B-----X------------BX---B--Eo------------XXX--XX--B----X---Xo-X--B-X--B---XBB-X---B---?---XM----X----XEX--v
------X----oX---Eo------E-X--B--B-o------X----E-------------?------XX-----------B----E-o------o----BX--X---X---B----o---?-------------------------B--o--------?--M-X-o---------E-----oo---X--X--X---X---
----------X-----------X--X--E---X----o--M----X----XX-----------X-------------o-Xo-X-----o-?--XX-E------B-E--------XX-?XX---B--BB-------oX-X--MX--------?-----oB-X---o-------X-----o---MX---------EX-----
----X----?-XX-X-o----?-o---------B----B-----M-----------o?--------X-X----B-oE---------MX---M----X------??--o-------X--B-----XX---B-B---BM-----o--X--------------o--B----------E---E-----XX----X-E------B
------------------o--E------------X-X-X-----X---X---o-------o-----o--X----B?----X-Mo---------B---M-o--------X---o--X-o------X--E-o----B-???-o---o-Bo-----------XX----E-----------o---X-X------X-B-X---o?
---------BX---X---o--X---?BX---?X-------B-?--------------?--X----X--X--M--XXo-X-----------------X-oX---oX--o----X---------o---o-o-------------M----X-----X-------o-----X--X-----B-Xo-----B-----BX--XXX--
---B---X--?--X----X---E-------X-X--X---XB--B---------oo-----X---X-Xo-o---X---M--XE----?---X--?-----------BXo-oB------E-o-X-B-X--o-------------XEX--B--X---------XX-------M---------o--------E-X-oX------
m-E---|-----------o---Xo--X--oX--?------?--MX-------o|B-----Bo--E--?----X-B-X-M-X-o-X----B---oX----M-X---B|---oXo-----------X-o------o-------X-----E-------------EX-?X--X--?-----X-o--------X------?----
XXXXXXXXXXXXXXXXXXXXXXXXXXXXXXXXXXXXXXXXXXXXXXXXXXXXXXXXXXXXXXXXXXXXXXXXXXXXXXXXXXXXXXXXXXXXXXXXXXXXXXXXXXXXXXXXXXXXXXXXXXXXXXXXXXXXXXXXXXXXXXXXXXXXXXXXXXXXXXXXXXXXXXXXXXXXXXXXXXXXXXXXXXXXXXXXXXXXXXXX
