----------?B-X-M------BBX-------X----X--------------?---------B--------BXB-----------------BB--------------X?----------------------------X-------------E------------------------X----------BXB----X-----
-B------------BM--------------B---------------------B-------------------------------------------X-------------------o--------------?---BBX-oX--X-XoXX----BBXB----------------B---EX-------M-------------
---XMX----------X---?------X-----------------?------------------------------?----?BX---B-----B--B?BM----ooX-------------------?--E-------------M-----------------------X----B----------o------o-----BBM-
---------XBXX------o---X---X-------------------XXX----------o-------o----o--o-----------XB----XMB------------BX----X-------------B----------B--------------X-MX----------X------------------------------
--B?B----------------------------M-------??-----XB-------XM--XB---E-----------B---------------------------X--------B---------------oM------?X---------------------------------------?-X--------X------o-
o---------X---------BX----------BB-?BB--?XX-BB-----------E?B-BM--------?XX-------------------X----E--------BBBM?--------------------------oBoX------XM---B-X-----------------------BBBB----MX------E----
----BX------------------------------------------BXM--------------------oX-B----X-----------B---X--------------------------E------o--------------XM---------------------o--B---------B---------oXB-------
-------------------B--X-X--oXX---------?B-?---------B-----o--------------------E--X----EMM--------------------B?B-------oBBB----------BBX----------E-------?------------BX-----B--------------------o--v
---BX-------B--X--X-----------XX----------B??-------------X------XB----oX------------BM--------E--------BB------?--------------------------------?------------oX-?M--------X-----o--X?-------o-----?---f
------B---------o-----------------------------------------------X------------BX-----?-------------------------o---------------B--------X---------------------------------------XBX----MBX---B------M---f
-----------B--------------B-------------------------------------------------------XX---X----BBB----------------BB---??---------------BM----M--oB-------------BB----------------o----------------------Xf
-----oB------------------B-B------------------------------o------------o-----o------------------------o---------------------------o-----------------------------XX-------------MB----o-----------------f
-----------MB?X-----------BB----------------------------?-----B---X?BBXX---------------------B-B-B-oX--------oBM-------E----o-------Bo-----------B?X-----------------M-------BB--------o-----X---------f
-------------B---------------MB------------------------oX-----BBM---------Bo-------XX--X-o--------BB?----X-----------------------oB------------------------------X--------------X?-----------------XM--f
m-----X-------To-?X?--------------------?---o----o--------------MM-------oB----------?-------M----X------------?--XM----------------B-----------------------EX?-----X-------------oB-----TX------------X
-X?XB------XB-|---------------B-XB--?-B--M------XX-----B---X-X---Xo-B--------?XXBXB-----XX----X?--------------BEBM---X?X-BB----------------------------------------------------B----oB--B|B------------X
XXX-X-XXX|X-XX-|-XX-XXXX-XX-XXXXXXXXXXX-XXXXXXX-XXXX-XX-XX-XX-X-XX|XXXXXXXXXXXXX---XXXXX|X--XXXXXXXX-XXXX-X-XXXX-X--X-XXX-XXXX--|XXXX-XXXXXX-XXXXX|XXXXXXX-XX|X--X|XX|X|X-X|XXX-XX-XXXXX|XXXXX--XXXX-XXX
