M----------?T-B------|-M----X-|---------B---T-o---o--B--M-------------XM---------------M----X--T--------------E-----?--BB?B?---??------B---------------------------------------?---X-----------o--------
-------TM------------------------------B--BX|----oX-------------------------------------------o|X--------------XXB-------------BM-----X------?BB?---Bo----X-X?---------o------X-------------------o-----
-----M-|B---------?B-X-o----X---o?-----------o-------------B-M--X-B-------------B|--------------B-----------X---------------------?-----------oM-TT--o-X---X-------B----------X-----o---------TX----TB--
-----------------------XX----T----------------Boo--X------|----------------------------TB-X----?---o--------?--X------------X-------B---------------o--------o-------X-------Xo-------BTo-?---B----B----
B------XMo-------X---?BB-----------M-----------------------------X---M---o------------------|---B----o---M--------TB-----MT------------BX-------T---------o----------T-------o-X-------|----------------
---?---E-----B-------------------------E---------------X-----TT----------------X--M-X----------B---------------M-------oB-|--------B----------o-------|---------M---o---Xo---------E---------o-T---T----
------------------------------------------------o--E-----M--||B-------BX------------B--o---X------------------BX----BBB--------oX----------------B----------XB-?B-------------------M?--------------MXX-
-o--------X--------XXB-------------X-----------?X---B-T-B------?----------------T---T----BB-----o-?------?------------X--------oBB-------oX-E----------M-----B-----o-----------------------o-------E--Bv
---T--o---------T---?-----B-----o---T-------B-o-------------T---------------------B----|X--------X--X-----oB---------o---------------X---------------------X----o-------------|--X----X---E--M---------f
-B-------------X-|--------o-M------?---------------B-----------------------?--------------------X-----------------------o-------M------------------------M-------E----B---M-o--------------------------f
-----?X------------X------XB---o--------------?-----------TB?|--------------------B--M-M--------------------?M---------------To---o---T-X-----BXBX--TB-----o------------------------?-----------B------f
-----------?---X-------?-------E-M-------------------X-----------B---o-----B-------X-B------------M-------E--Eo--------M-------------T-------B----E-----------------------o-B-----------------------E--f
--------E-----?------o-------oX--------------B----------EX--o--o-----?----------E-------XXo--------E-----B---oB--------BX--------XB----X-??--------o-?----------E----B??--o-M----------------B------T--f
------------T-X----------------?---B-T--M--ME-----EX-------?------------X---X----------------------B----M--|-------X--------------X?---------o?M-----o---------------T----XB--B------B------o-X--------f
-------?---o-B-----------X-----?--------o----------------------o----------------o----?-B-T-----X-------Mo--------------T---o------T-E-------X--------o-o-----M-------------------MX-o----------------E-X
-M----------------B-X-----X------------o-----------------XBo----BB--------|o-----------X-------------?--BBBB-o-----B-T---------------------B-------------------X---------------------MX-----EB-------BBX
XXXXX--X--|X----|XXX-XXXXXX-XX-XX-XX-X|XX-XXXXXXX-X|XXXXXXXXXX--XX-XXXX-XXXXX|-XXX-XX-XXXXXXXXXX-XXXXXXXXXXX-XX|XXXXXX-X-XXX-XXXX|XXX-X|XXXXXX--XXXXXXX-XXXXXX-XXX-XXXX--XXX-X-XXXXXXXXX-XXXXXX--X-X-XXX
