---ME--E-E--BEE-o-EE--E-E------------?EoE--------------oM-E-----E-EE-E?E-?-|--B------E--EE------o-EE--E-EE-E--EEEB-?--B--o---E--E----------E-X-|T----BBE----E-----E--E---?--------|-------M---E--M------
T------E-ET---EE--B--oE---E---------E-----E-E--E-M-o---?----?-E---E-----B--E----------------B--|---M-----E----E?----E------B---|o-------E--o-E-Xo---------B?-E----EB---EE-EE--T---E--E----T----E--------
-E-----EE---EE----E----EE---E------------E-?---E---|o----E--E----M-E-?---o-----XE--B---E-E----E---E--------E-EEE--ooo-o----E---E-EM----?To---E--E-EEE--oE--------EE-EoE----E--T---E----------o--E?-EEE-E
X|--------E-E-|-o-------E---?-B---Eo----------EB?----E-E-E--o-----E-E-----E---E--B--B--E-?--TE--X----||--Eo------------------E---T-EE----o------X-E-E-E|--?E|---E--E------E----?---E-E--M?--?--EE---E---
-E---------EE----------?--EE--E-------E----------E----EEB-E-----------------E-----EB?---E------E------E-------X----?----|o|--E-----TEE---E-------EE---E-E----E-EBE--o-?--E----E--E-o-E-E--E---T--?----EM
--------E-----o-E-B-----EE-?TE--|-E--------E-o---EE-o--o-EoE-EE---?-EM-EEo-B-E---E-B-E-o--B---B-----E------E-E----oEEE------E---------E---------------EE---BBEEM----E----Eo-----E--EEE----------E-----B-
-E-?-----EBBE-EB----EE--T----E---BE--M--|-E------oE--o-E--EE---E-E-B-------------E----------E----?----TEE-BEEX--------E---o----B-E----E-----oE--------E---T---E---E----------EXE------E-----E-o--T-----|
----E----o--------E--|-T-Eo-----------E-E--E--E---o--E---BEE-E-BE--E-------------o-----|--o-E?------E-B------E|--T-EE------E-E-E-o---B--BE---|M-E-E----o------------oE?|X-EB|-M----B-E--E-------|-T---Ev
E-BE-E----B----E--?------EE-----Eo?T?T---E-E----E---E-E------E----E------?-E------XE--M-----------E-E-o---E-E-------EE?--oE---E-----E--o-E-?--E------EB---E------E-|E--Eo-----oB----------oE-E--EE-BXEEE
--E-----------E--|----BE--------E?--E-X-E---E-T-?---EE-E-E----B--E----o--B---T--E---?---------M---EE-EEE----EX--E--B----|--EE-E--?--o----o---BE--E---E---B--E-Bo--BEE-T--------------E-BEM------E-B-M--E
-E-------?----|---------------?E--E-----EB---EE--E--E---X-----E-E--E-------E---o---?-EE--E-E----o----E---B-?E--?-BE--E--------E--o----------E------EBEEEE---oT--E--EEE-EoE?E---------o---oE-----E----X--
B-------?--E--M-----E---E--E-?-------EE--EE--------o--E-----EE--------E--oE-X-EE-o------?|----ME---ETB---o----|--EE----BoEE--E?---E--E--------------E?E---EE---E------E--E----E--EE--Eo---E-E--------M--
M-?oEE?--E---E-----E-EE------E------o?-EE---EE------E-EE-Bo-----o------EX|E-E---------E|--|-E-?--E-B-----E---------EoB----E---o-EE-E--E---B-------E--EEM----BEB-E---EE-E---------B-----X------------E--o
----oE-o-EE-----?--E--EBE---ME--E-EE----EE--E--BB---EE---B--------------E-------------EE-----E---M-E-EE?----EEEEE-------XE---T-E?-?|-----E-----E-----E------T-o--------E--------EBT--E-------XE-----E-o-
mo---Eo-----o--E-E--oB--------o-E-E---------EBE-Eo--------------E---M--EE--E--------------E-E---------oo--------E------BE-------X-BE-E--E-----E|----BE----E----T-----B---------oo-E-E-EB--------EB------
-EEB-E-E-EE-E-oE-??B--B--EE---B--ET------E---?------T--------E---BE--E---E-?-E----EB---EE--------------E---E----EE---E---Eo-?M-E--B---EE------o------------E-E--?--Eo------?EEE-E--?----E?--E-----B---o-
