--------BB---X--M----oXM--------------------E------------XX-----------------X------------------------M------------------MB-------------------X---?--BBB---------------M--?MBB------XXMBB--------X-------
------BE-EB---------XX-M----------------B-----?-------?--B-------?B--BXBX---oBBBBB--------------------------------------B?--------XB----------?XXXXBB---XBBB--------------------------------------------
-------BBBB-----------XXBB---?BX--------BBBM-----BBXB----------------------B?-----------XB-------------oBXB------------------------------------------------XBBX-Bo------B-------B?----------------MB--X-
EB?------oBX----------X-----------------?--------oXBBBM?X------XMXX--?X----------------------B------------X-----------------?MBX---------------------MB?------XXo-------?-X-----B------?MXX--?XBoB------
----------B?X-----B------------BB-BXB---------------------BXB-------------X--XXMM---------------------------------------B-------?B-------------------B?---------M----X---------------------------o------
----E-XM----------XXB---X----------BMXB-----------------------------------------------E-BX-o----------o-------------------BB-------------------------------BBX--B?X----XB-----BBX--o-?X-B----------B-X--
--------------------------------M?------------------B-----------------------------------------------BBX-B?BBM?-----------BBXBX-----------BB------------EMX--B---------BB---------------------?BXBB------
Bo?B-----BBBBX-B----------------BB------------------------------X-------------------B---------------BBXo--------o--XMMBBBX--BX--M-??B--------------MX------------BBBBB?BB------?BB--------------B------v
--------------B---X----B-------------X---XX--B?M----?MB---------?X??MBB----XXBX-------------------BBB---------BM--------------------------------?----oM---------B?XB-------------------------?M?BMMB---f
---------------------E-oM------------------o--------X--------X?XB---X------EX---M--o?----------------------------------BM-MXX-----------------------?BBXX?--------------BXBB---------XXB---------------f
-------------B-X---------------------------E-X?-----------oB-BBB-------?X---------X-------X-------------BB?----oBB?----------?XXB----XXB-XXM-----------BMM-??---B------------------------------BB------f
-----------------------------------?BX-------BB-----------------------oX-------X-----BB------BXBB-----oB-------BBXXo-----?B?BBM---------------XB----------XX---------XXB-----------B?----oBBX----------f
-----------oX------E---------BB------Bo------oB----oB--------------------BM------B------------------X-----------------------BXBX----MX-------?XMBB------BBBBXBB-----BBBBB-----------?----------X??---o-f
-----------?----------------------B-------MBX----------------E--------------------XBB--E---------------?--XX-MBX------------------------XB---------------BMBB-BBoMB------------------------BBB---------f
m---------------o--MBX?------------------------------oXo?X-----BXB---------------------oXB-M--------------o?---------B---XB--T---E---------BBB--------M-----------------XB-----BB----------------------X
XX---X?XB--BBX------MBBBBBX----XB-------------M-BX-----------XXBXB-------------o----BX--?EB???M--XX?B----------------XB?X----X--------------------XM-----------------?B----BXXBB?-----XB------B?BB--??BX
XX|XXXX-XXXXXXXXXXXXXXX|XX-XX-XXXX-X-XXXXX|XXXX|X|XX-XXXX--XXXX|XXXXXXXX|XXXX-XXXX-XXXXX|X---XXXXX-XX--XXXXXXXXXXXX-XX-XXXXXXXX-XXX|-XX--XXXXX||-X-X-|XX-XXXXX-XXXX|X-X-XXX|X|XX|XXXX-XXX|-XXXX-XXXXXX|-
