---------?-BXM-MB-B-B-------Xo----B--X------------EBX-----------------??-----EB--B-EBo--M------?--T?----M----------X------------X------XMX?------------T---------------X--------XB--BX----------------T-
-----------------Xo-------T------------EX----BB----?X-------------------X--M---X-----------------B-Xo-B---------B---------XX-BB-----------o---?-------X|----E------------------------------------BT-----
-----X-M---------X?-------B-o-------------------T-----------X----------------BBMX---MB-------?---------oB-------X------X----oX---o--B---XX-----------X-X-----BM---------------------------------B--oo-B-
-----------------------T-T-XXB----------XM----------XX-------BX?----B---X----------?-BB-------oB-------BBBBM-------------------------BX--BBB-T-------------------BX---------Xo-----------------T----o-B-
--oX-----?X----?-------BX|?--XXB-B------XB-----------------------------BB------o--BB-----XBB--?B-o?-EB?-T--------EBX-------To--B-------------T-------------MB?B-------------------------BXB----|--------
X---M------------oX--------XB---BB----?B--MBM-----------------?--XMXB----------?B?----------B------?----|X-------X?B-----B---XB--?-----------|B-T---B---------------o------BX---------------------------
-----------B--???-----------TB---------------XBXB-----MBB?X--------------X--------------BB--T------------XX-------oBB?----B--------X?XX--M------|XX----oXX--------------------XX------------------------
-----------------T--------T-----------oX----o--------------------BMB-------XXX-B------------|B---------------------?B-TBo----??BXBM-------------------oB------M----------------------B-----------M-----v
-----------------MBB------|XX-----BBBX-----T----------EXX----XBB--------------T-----?-----B----X----------?X----XB-----B?B?--?X-------T-o----B---T???T-------?--oB--------T-----B-------MM?--TM-------Bf
-?BoX------oX-B---------------------------B--ooXBBXB---M-------------------B--|-o-XBB------Bo-X-------------------o------------T---------?---------??B-o------?-----------B------MM---T------|-BB------f
----------------BBM-TBBX---------X?-----------BX----M-BB-------MBB-------M---------T----B-------------?XB-----?--M-------TBX---|?----?-------X-------------XBBBBBBBX---------------------------X-------f
------oM?X---XX-M---MX?----BB?Xo----------X?------------------X?---------B--------o|-------XBXTXBXB-----------?BT-----------T--------------T---B?-XB--------------BBX-------------BB?----X-B----------?f
------------X-------XB?T?B-----M-------------?B-----------------XX----MoB-oX---X-X?XXM--------?BXEXTB---T-------|BX------X--|--------------T----B--------------oXM----------oB-------------------------f
---------B?---BB------TBXBMX--oMX----BX?-B------------X------M-----------------EBBBBB---T----------|?---XX-----B---?-----------------------|---------X--------------------------BX-----EBBX-----B------f
m---------?BT---------B?E?------?-----X---XXMXMX-o--------BB----------o------MBB--------|---oB-----TM?B---------------M-----X----XB-M----------------------o---X-----XX---o---B--M---B---XX-XX------BBXX
------------|--------------E----------o-------X----?X----X------X---------EE--XX---------------BBB------------------------EB-B?-B---BMBB----------MTB--BB------BX-MX-----?-------------X-----XB-------?X
XXXXX-|X--XX-XX-XX-XX-X-|X-XXX--XXXXXXXXXXX-|XXXXXXX-XXXXXXXXXXX|XXXX-XXXXX--XXX-XXXX|-XXXX--XX-XXXXXX-XXXXXXXX--XXXXX-XXXXX--X--XXXXX-XXXXXXX|XXXXXXXXXXXXXXX-XXXXXX-XXX-X-X-----X-|XXX-|XXX|XXXXXX---X
