M---BXMB---o-------B------------------o---------------------X--------o-B--------E-----------------X------------------------------M----------------X--------------------------B----XX--------------------
--oXB--X---B----oB-X--------------o-B------M--o--X------X--------BB?---------------MBXE----------------------E---o-BoX-------------E-?-B---------------------------------------XB-----------o-----------
-X?--o-------B-----------X---B-------------X---------?-----------------------E------------------------------------?--?---------E---------------X-------X-----------------------B------M---B-------------
-------------------------M--------------------------M--M-?X------------MXXo-------XX----------?M-BB-------B-------BX-----XBM-----------X--E---BB-o---?----------M-----?---o---??-------XB?BB----X----BB-
-X-------BX------------------------------X-------------MX-------X-B?--o---------------X--?------------BB-----------------------------B-X--------------M----------------E--B------?------B-----------X--o
---------------------B-EM-------BXX------B------------B-------------?o-X-------------------E----------B---XB-----------------------o--o----o----------BBX-----MB-----B---------------?M-----------------
------?-----BB-----------BB-----M--------------B---------------------XB------M-----X------------------B--------B------X-------------------------------X--------o--o----------B------X-------------------
--X---------?------X-----oX-----XX-E-M--------o----?-----B-X------------MB-B-----------------------BX------B?X--------B-B-----BX-E--------X-??-----------XM---------------X------B------M---------?XX--v
-------------o-------------o-------------XX---M----o-----o---o--------B---------?--B--M-----------o---o------B---X--B----------------------------M---o---?---------B---MMB--------------------B---X----f
------------X--?---------M---------E-------------------------------X------------------------------o--------M----X---oX-----------o------------B-B------M----------X----------------------M--------E----f
-------o------------------M--------B---------------X-o?B-----?-------------M--B-B-?--X-----------------o----------------------------------------oo---o---X-------------B--------------B----------------f
---------X--------------o-------?--------B-------EBX?B------M---------------------------------------------o---X----------o--------------------M----X---o-o---?-----------E---------------------Bo------f
-----------X--------B-X--X-----------o----BB-----------------B--------BXX--B?BX-----XXB------------B------M--o---------------B--------------oM------?------B-----------BB----------o-------------------f
--------------?X-----------oX--------------o------Xo-----------------------o--------X-XB--------------M-----------------XB--------------------X------MMX-------MXB-------X--X--------------?-----Mo-X-?f
m---------------------------T-----------------------BBBXT---MXB----------------?X------------BT-M-----?-X-------?o?BBBXBo---------X--XB----------------------XX--o----------------------E----?---------X
---XB-----------------------|--------------------o-?----|--MX----------M-BX-X-----------------|--------?BB-----B-B-----X------------------?-------M---------?--EBBTX----T?-X---------?-----T---X---T---X
XX|X-XXX-XXX-X-X-XXXX-XXXXXX-XXXXXXXXXXXXXX--XXXX-XXXXXXXX-XXXXX-XXX-X|-XX|XX--XXXXXX-XXXXXXX-X-X|XXX---XXX-XXXX--XXXXXX-|XXXXXX-X-X-XXXXXXX|XXXXXXXXXX-XXXXXXXXXXXX-XXXXX-|XXXXXX--XXX-XXX|XXXXXXX-|XXX
