X-----------X---o----------B------M|-o----oXE--B---------------B--------X----B--------X--|---B-----E----------EXX-?----B-------E?---B-X|--------XX-X-X---X---XBo-X---------X-o--X-X-----X-XB--X--B---X--
X------X-----o-------X--------X-E--X-?---o-----------X--??--------X---X-------o--o------X-X--X--?-----EB----oX----X-X|-------E------?----M----E-XB-X----o--X-?--X------?------o-------o---X-----------BX
----B----E-o---BoX------X-?X--------------------X----X--X---?------TE---o--X-X?oB---X--T---X---------X-BX----------o?-E------o?----------oX-----X?X-----------E--M--|oX-------X--|-X-oXX--X------|--B---
o-X---------M---o--o----|--XM?---XX----|X?--E----XXXX-----B-oB------?-XXX--|--M--?----XX------------XX---o---------MBEX?--?------?B---------------------|X----X---B?E-------X----o---------M---BMX?-M--?
-o?---------X----X------X--?--|BBo-------X---|--X--o---------Bo--X-------T------E---TM-------EX--oM-X-o-o-E------B--E------B-----X-?oX-E----X--B--o-----B-------T-oX?----------X---o--BX--|------------X
------------E----o-----B-----Boo--B---XX----||XX-------o-M-B-------X----?-X-o---o-E------E--M-X----B--X----X------o-T---------------B--X-?-----o-------X--oX-X--oX----------X----------?-o?--B-B---E--o-
-----XX-o-o|--MX-----XE-M---B--X---B---------?X----------|--X-XX----X-----oX------X---X---------E----X-B-X-----X--X-o---BXo-M-----X----------XX---B?-------X----------X-------E--------XX------E-X------
-------B------o-XX-----E--B--o---XXo---?----X------ToXE-----X?---X---?X-X?--Xo----B------?-|---------------------------X----B-X--XB--?-----MMXB---------o----XX-X---M--?--X-E-X---?---|----X------oX-X-v
-X---?---|--o|---------XX-----X----X-|-o--?X--X----X---?-E-?------------X-E--X-----BX--------X--T--Bo--B-X-X-oX---B-B---?o---?--oE-----X-|--X-?--?---E------X--?B-o----X--X-?T-X------o-?-X-B-E---------
--X--------------MX-o-----B-X------|---X----E---X-oEXMo-----X-X----|----o-X--o--X--XB--o-----------------|--oB--B--Eo------o-------X--?--X-------X----?------T------B--?o-X---?--oX----------o-X---X-oB-
----X----X-----X---XXo-------?------M-oM?---o---o-M--------o-------X---X-----------o----oXBX-----------o--?------TooX--XE------X--?--------?X----XXX--Xo-E---X-X-----?-----||-Xo-----o--------X-----M-X-
--?X-X--E--oX----X---|----E-X-----|--X--X-Xo-o-------oo--o---------T---T?---?-X----X--E------BXX---o|-----B---o------BX?-------o------X--E------E--E-o------X--|----B-------oo----------X---BX--EXX----E
--XXM--X---E--------o--B-----o------X-o----E-X-X-----------X-oX-------BE---------B-------------X-----------B--X---------------X--X---E------T-X---------------M?-----X---?---E-E--E-------X---B--X-E----
X|T---X-XE---T---X-M--oEB-E------T-oM-------X------------X------B-------------X--XXE-----------X-XX------X---------|B?-------------XBo-----------B--X?--T--EE--X-XM----B--?o----X------------B--B---XBX-
mM-------o-----E-----X----X-B-E---X--------XX-o-------XX--?-o--|oX----XE----XM-o?M----X--X-X----X------X----X-------o----------X--------X---o--X-----o---BB--o-M-?E---BB-o------XT---T------X-M--oE--X--
XXXXXXXXXXXXXXXXXXXXXXXXXXXXXXXXXXXXXXXXXXXXXXXXXXXXXXXXXXXXXXXXXXXXXXXXXXXXXXXXXXXXXXXXXXXXXXXXXXXXXXXXXXXXXXXXXXXXXXXXXXXXXXXXXXXXXXXXXXXXXXXXXXXXXXXXXXXXXXXXXXXXXXXXXXXXXXXXXXXXXXXXXXXXXXXXXXXXXXXX
