----------BB-------------BX----?B----BB??X--B-----------------------B?BB------BB--oo----X------------?------------------------MB--------BB----------B--------------BX----------------------BB-XX-----B?-
-------E?----------------B------------BB----------------------------------------B--------------------oMXBoBBM--------------oXB-------------BBXX--------------BB--BM----B--------------------X?X-BBB-----
XX--------?BB-XB?B------------BXB-BBBBB----XB--XB-----------XXBo?MXBX--------------------?------------------B-----------o------B?XX--------------------oMX-------------------BM--------------X-M-------B
--B------M-----X--------BX------------------???B----------------------o?XB-X-----------------X---X-------------------------------------------?B-------------o--------------------------B----X----------o
----BB-------------?------E----BBBXB------------BXX--XMB-------M-------X---?----------------------------BB--BBXBX---BX?-------------BB-------------B--------BBBBBB--B------------B-----------M--X-------
oXBX--EM----XB----XBX-M----XX---------MB-XBX---------------------oMBMXB?-----------B??X--------------?---BXB------------------B----BBB-----?-----------XX------------------------------?XB----------B?B-
-----------MBX------?--------------BB-------------------XB------------------B----BBBX--?-M?BB--------------------------BBXB----BXBB---oMMB?---------------?------------------BB-------X-E-----BB?----oB-
??------------Mo----------------------------?-XB-X-----------XX------------------XB----------------oBB-------X??X---?X----------?XXXMX---------??X------M-----------X-----MXXBXX---XX-------------BB-E-v
--------BB-?B----------------B--B-----------?B-------------BBBX-XB?--------------?--BB----------------------------------------------------BBB-------------E-?MXMBM---M?--??----------------------------f
-?X-B-----B-------?B----MM-----MM------BX----------------XX--------X?--------------B?XM---XX---BBB----XB--BXX---B---------------------------B-MBB-XXX---------------B?BMoXB??-BBX---BX-----------------f
------o??-?-----------------------BB-BB-X----?B?-----MBBB--------------X--B----------------------------BBBMX-------------------------------XXX--------XXX?X------X------------------------BBB----------f
-----------XB--------------------XM-EB----------------o-------------X?X-------------------------?BB-------------XX?M---X-----------------------------------------oB-----BB---------BBBX---BB--------B--f
------------------------BX---------------------------------X--XX-------X------B------------------B-------------------------------oMM------MBBBBB------------?--------------?M--------BBoMB-------------f
-----------------?------BXBBB--------------------------------------------M-------MoXX----BBB---------------BXo?--------------------BBB-------M--oX?X?----------------BB--------------?---------------B-f
m-------------------o--------??XB------------?B---B-----XB--------X---------------------------B---B------XB----X??----------------------------------------o----BXB--------------------------BBBM?------X
TXX?-----BBXX----?---oB-------------B?BBBB--EXoM--BB?B------XB------BM-----X-----------o-??--------------------B--------------X-----BX?----B--------BB--?X---------B---------MB----------?B?-----M--X?BX
XXXX-XXXXXX-X|XX-XXX|XXX-X-XX|X|XX-||||X--XX-XXXXX---X|-X-|XX|XX--XX-|XX-XXXXX-|-XXX--X-X--XXXXXXXXXXXXX-X-||X--XXX-XXXXX-X-XXXX-XXX--X|X-XX|-|XXXX--X|XXX|X-XXXXX|XXXXXXXXXXXX-XXX|XXXXXXX-XX-X-XXX|-X-
