------------------------E-?-----o-B------X--------M----B-M----E--o------ET---oB--BB----------B-T------------------B----------M-E?---|B-----BE-----M----------------------------------B-------X----------
----------B--------o----------E-------------?--MM----EB------oB-B------------o|o----|---T------|-B-----------|-------------------------M---B-TE---------------------B------------BE--------B--T---------
B-------------------M---o--B------------------X?--------o--|----------B-----T------X--------M--------X-------------X----o|oB---------o-------BB----------------------------------------------E-o-E-oE--E
E------?-----------------B-----X------?-?|-X-----B-o------M-X-X--------B--X-B--X----?--------o-|------B-M------------------------B------------?-----o-----o-----o---?M---o-M--------------B--B----------
-|---------E--B-----------B-------B---------X--E----------o--o--------------E---T--------o----T------B------------------------BX-------o------?--------?BM---------E|--------------------MB------|------
--E------o-----B------------o---T------MB---------------------T----------o-----B----o-----oo-|--------o-----B---------------|----?---------------------------------------------T-----------B-------?|---
---E--E-----?-----------T-----------------------M------------T---------E---o--o--------------------------B------o-?M---B---o-------B|-o------------B-X-------B---------|-----TE-----------E-----B--?----
-o---BE---------------oT---------|B------?----------------o?------E--T-----B-------BBB-B--E-----E-----oo--o----B---|-----------o----|o---B------|-E----------T---E--E-?---------------|-----------oo---v
|o-o---M?---------------------?-o------E---------------o--------B-------B-----------?-------o-----------T-------?o-|-o--E------?-----------T|T--------------?---o-----------------------o---M-?---------
--------E-|----?-M---------------------B---?---------B--------oB-------------------?-?-----B----|----------X--B--------------?-------------E----------B--M---o----------o-----B------T-E----------------
-X--------o---------------------B--o-------E-------------?----T-----B---------M-----------X--------|----------------------E-----------X----------------------------?o----?-----o-----T-------------E----
X----oo--B-------oB---------------------------------------E-------E-EX---------?o--T-----------------Xo----------------B-----?------------o----------------X----o-------?----o----B---T------T-B--TE----
To-------E--T-------B-----E----------------?--------------o-E---o--B----------------------B-----------X---T--------o-----------------B-------------------o------------------|-----?--------M-o-------X-o
-M--------o---------------------------oT----?T-B------?T---X--E--------------------o------E----------------M------------------Eo-E--||-B----------------E-X----o-----------------TBX---------------E-?-E
mB--------?-B-------------EE----?---B--X------o-----T-?--BM--B-------|T-----------o-|---------E--------M------------------o--------------------T--------o---B-----B-------------------B-T----------M-|--
XXXXXXXXXXXXXXXXXXXXXXXXXXXXXXXXXXXXXXXXXXXXXXXXXXXXXXXXXXXXXXXXXXXXXXXXXXXXXXXXXXXXXXXXXXXXXXXXXXXXXXXXXXXXXXXXXXXXXXXXXXXXXXXXXXXXXXXXXXXXXXXXXXXXXXXXXXXXXXXXXXXXXXXXXXXXXXXXXXXXXXXXXXXXXXXXXXXXXXXX
