-----o-------B----XX---X---X----X-o----X-------?----X---------EX----------o?-----oEX--B--BX-----X-X---X---?X---E-------E-------B-XoX---X?XEB---?-X---X--X---X--------------------o---XBB----X----oX---B-
-E----------------Xo--E--E----XE-------Bo----E-------X--X-----------X------?B---X----E--B--X---E----?-----?-o-o-o---o--BX-E--------o-------o-----X--E--------o----------X-------------E-----X------X--EX
----------X---------X--X--o-X-----X-----------Mo--------X---X--------E--------X---------------------------?----------?--------oB--X----X----B----X----------?-----B-?-------X-----M--------------B------
?X---X--?-X----------------MX-----?--M--M----X--M--?-?-M--X---X------X------X-----------M-------------?---------------M-X--BE-X-------X---XX---X---X-B-----X----------o-----B--B-----o----X----------X--
------o-X-------o----M---------X---o----B--X------X---?------X---X---X-X-?---X--------?-------?--o-E----XEEo------B-BX------------------E-----o?-X-----X--------------o--X-------?XB---------o---X-M----
-X------X-E?-?-----X--X--o---X--X---o--------X----o---X---o--Xo------------XX---E?-X-?-------EXX-X-------M?----------X--X--E---B?X--X-X----B-X---------o--X-X---X-----X-------------------?--XX-o---E--o
B----XX---E---X------------X--------B--Xo---oX--XM--XX-------B---X---E----X-MX------X---X-X-----------E----BB---B--o-------?----XX---X--------o-----o-oo---B----X-XXX--B---------o---------BX-XX-----B--
------------X--X---X----------BXX----X-------------EX----X---X-oE-----X-XE--B-----X--------Xo---XX-------E-----------X-XE-----X-X-----o---??-B-----M---------------E------oX----X------E-----XX-X--X---v
------X-o---X----?-----X--B-------------X-X-XX--M----X--X--X------------o---------X---------X------------------X-X------X----X--X---XEX----X?-X----BX------?-?-o-X--oEX--o-------------o--------------B-
--o--X----------B----X--X-------EXo--X-E--------X----o----X--o-----X---B--XBE-M----o------X----X--o-X-o------------o-----XXE--X-X---X-------X--------X-?B--------o----E-----Xo-----?----X-------X----?--
----X----?-E----X--?-B-----?---?----o---o--?o---B-----------M-M----X--------XB----XX---------X-B---EBX-------X-----?-----------o-------E------BB-----X-o-X--X----?-X--X-X---------------o----------X----
oE------XB-----E--o----?---o--B------X-------------o?--X-X-------X---------------X-?--------X---?--X-------o---X--------X-XX---------X-B----EX?o-XM-o---o---B--o-?---o-B-------------o-X-----o-B------E-
X-B-E---?M----B-X---X---?X---------X-----?XX------X--XXo-X--X---o-X--X--X---X-XMX-----M----X-EXB--X----B---X----M-----X------BX--------o---X-?----X-----Xo-BE-B---X-X?--X----E-X----------X-------o-o--o
---------X--------------o-B-MX------?---?---------o-----?B?---M----o-X-----E--XB---------B-o---------X--X--o----------?------X-B---------B-X-X--o--B---------------XM----XX-o------X----X?-X-?M---B-X-X-
m-B---|o----o----------X----M--------X--X----?--XX---X----------oX------------X-?---------XX--o-B----X-E--------EBX-X-E----?-X--oX---X---B----?--B--------------?MB----------------?----X----?E-XB-X?---
XXXXXXXXXXXXXXXXXXXXXXXXXXXXXXXXXXXXXXXXXXXXXXXXXXXXXXXXXXXXXXXXXXXXXXXXXXXXXXXXXXXXXXXXXXXXXXXXXXXXXXXXXXXXXXXXXXXXXXXXXXXXXXXXXXXXXXXXXXXXXXXXXXXXXXXXXXXXXXXXXXXXXXXXXXXXXXXXXXXXXXXXXXXXXXXXXXXXXXXX
