---o----------M-------o---------?------|----------?-E-B---------?--------o---------------o------B-----B--?-----------------B----E-|-E------------T-o----B-----M----?------?--------o-----T--------------
-------------------|--------E-----o------------Bo--B-------------------o--BMo---------B--------------------o|-----B-----B--------M-----E------B-------------------|---B-----oB---EB---M-B---------|EE---
---------X--?XX-------EM--E----E--------------------------------BT--X----?-----------M--E--?-----B---|-B-----X---EB--------------------o------o----T----o-B----E------------B-------?------------o------
----?-o--X---------oo------B-----?---------?----------M-o-----------------E--------T-B--B--?--B---------------------------E------MM---------T----|--?--o--o-------------M---E-oo-o-EB-------------------
o--------?----------?-X----o-------------------M-------B---------o--T-------o-----?---X?--------------?---M-----B-----M---------------X-T-----------?-E------?---oM-------|---------o------Bo-o--oo-----
--?----T---B-o-------|--------B---T---------oB--o-M--------------------?-------T-Mo----------X----T-----------------------------------------------B-------o--E--------??----------BT------------E-----E-
-------M--o-----------B--------------?B------------T-----oEB--o-----X----To--------|--E----BB-----------------T-------MTE--?--------o----?-o-----------?-----------------o------o----------------o----M-
---o---o-X--E-------o--MB-----E--E----------------B-----?-----?----------B---B----o-T-------o--------B--B-oo--?----------------------|----B------|---E---------MB--o-------o--|-B--------o---X----oE---v
B--------E------|------E-B-------o-------|-T-E-------E?-------------|------B----E---?-------T----E--B----------------------?-E--------|------X-E------------BX--E------------B-----o--T------------o--o-
-----------E------M--------------B----B---B--E--T-----------------B--B--------?------------T--E----------o---------o-X-E--------------M----------------------------|--------X------T----B------T--------
-B-------B----------X-o----o--B-----B----------B------o--B--------BX---E-------?o-B------------B-------------T--EE-------B-----------o----------------XB--E----------------B----B---------E------T--M---
o-o-E-B-M-----o-------------M----B------B?-M----B----------------------B-------------?T--o----------X--------T------X-------B-----?--------o----o------?T-B--T---|?-----B-B----?------Xo-?o---------o---
------MB------oE-----------------BE-E-XX|---------??o-----B--------M-B-M-?--?--?------E---------------XT--E-M-----------B----o------X-----B----E---------------------B----------------|----BB------B----
--------------------BBo--------B--E------------------|-------M-----E-----o-------------------------?------o-----B-----o------?---------EoB-----|----------B-----------T----o---------------TBo----------
m--------E-o-o-----o-----BE------o-------B-----M----------------------------------------------------------B-----------T--|------X-----T?----E----E-E-----------E--X--------o--o-B-------------------oo--
------B-------------------B-?-----------|---?--B--B----------E-----------E--------------------|---------------X---------------B-----B--|?----o-----|---o------------------E---M------------------T------
