-X--------M--------X-------B-o-XX-------B---------B---?B?X----M--?--X------o------X---------------------------X-------X-X-?------Xo----X-X-XXB---XX----X---B---oo--o--XX--?oX-X--?----------X-BM----oo--
----E-T--X------------o-------------X?-----E--X-o----X-----X---o--o---B-------------------X----------o?-X----B--X---X---M-X-o-X----o----------X-o----------------XEX--X--------------oXXX-----X---E----E
----E-|X-Xo--B-oB-X-------?-o-X-X-X-XoMX-o---?----X--------X--------B-B---B---o---M---------------------M-o----X---X?-M--o-----------------X----M-X---X---o---X---?----?------------X---XXM-------?-----
X---XX|--X----o-X-E-----o--X--?-------------B--------oX---o-M?-------X-----?--X---------B-o----------BX----------XoB----X---X---o-M-----X-o----X---oX-X--------------M??---X----------------------------
?-o---|-E---B--X-Xo---X------E---X----XE--o----------X--X----------o----X-X-Xo-X-XX-B-X----XM-o----X--------------o-----B-B----XX--------M--X-?---M----X---Eo----------X-----B--E------X-X-----?-------X
--o-X-|--------X---E---o-o-M-----X-?--o--oo-M------------E-B--------E---X-M-------------EE------X---X------oXB-----------?-X------X-?X--E-X-------B-B--B----?X?---X--B---X--------o------o---X----?o---B
X-----|X----?X-B-o-M-XX----------X----------X------------o-----M------B------XXX---------XBX--o--o--B---o---------B--------?----?M-Xo-------XoX-Xo---B-----XX-XoE-----------------B----X-M-?-X----------
o-----|E--?-?-----X-----------X-XX?E----X--Xo---oo--o-X--------X-----------------B---------X-B-E-----X--XX--------o-X-?--X-X----M------B---X----BX?--XB-oX--B------X----E-E-X---?B----Xo--X--------o--Xv
--?---|-----o-MX------Xo--X-------X-o--E-X-----------E---E-o--------XX-o---o-------------oE----?---X--BX------------o--B-B---B--X---E------X----Eo-BX-M--------X-XX---------------X--?------------------
X-----|------oo-B------------X-E-----B-XX?X---o---------EEX-------T--------X--B---?---EX-------------X-o--o---M--X------M--?X-X----------XX---------XX----X-o-------EX-----X--?----------B---M-----XB---
--X---|------ooo--o--X---B-------X---------X--B-B-B--------X--o-XX|-----?------X-----------------oE-----X--o-------?--X-?---Xo----X---X--o------------o---------X------M-X-BX---o-XB--X-o---X--o--B--B-X
----E-|----------BX-----------XoBX----B-B----o-E------oo-----X----XX---B---XEX----------o-----------o-------X--------------------o--?---?-----M---ooX----o-----------oX------o--E---E----X-X-X--------XB
?X-X--|--T---------B-XX------B-----X---?-------?o-X---------o-----X-----X--X-------X-----X-X--------X--o-----BXB-X--XX------oX----XX---X--X-XE------X---X-o--oX-B----X-----------XM----o--E------X------
B-X---|-?|-X-o--X----X---B------X--------------B------M----X-M-X?-------o-E--X------BB--X-B--------XX--TEEEXMo--M--------------T---X----------B------T-X------E---E--o--BXX---EX--E----T----X---XX------
mX---B|-X|---X--X---X-o---X----X-----o-X----E---M----o--X?---M---o--E--B---X---XX-E-----o---o--X---B---|-----------XB--o-------|----X--B--X-?-oo--XE-|?------------X-----X----B-X--o---|B-----X-X-------
XXXXXXXXXXXXXXXXXXXXXXXXXXXXXXXXXXXXXXXXXXXXXXXXXXXXXXXXXXXXXXXXXXXXXXXXXXXXXXXXXXXXXXXXXXXXXXXXXXXXXXXXXXXXXXXXXXXXXXXXXXXXXXXXXXXXXXXXXXXXXXXXXXXXXXXXXXXXXXXXXXXXXXXXXXXXXXXXXXXXXXXXXXXXXXXXXXXXXXXX
