?M------M------------oB------?----o---------BB-T---o--B-E------E----------B-B--------B----X-------E--X-?---------o--o----E--------B-X-o----B--------?-o-o-----X--B----?-E-oo----X-------E----------?-M-o
---o-E|---------------B----------------B------------M---------------------?-----------------------------------?--T-------------------?-------T-------------?--------------?-------------T-------X---B-?-
----------B-------------------T-----------?-B--B----M----------------------E-------------------------E-|----------o------o---o--------?---------o-B--------------------------|--------X--?-E---E-M-X--B-
-------------B----MoB-------------o-------E---------|-----E-ETo----E----------??--o-|----o-------M---E---------------B-------------------------T----------------B-----------o--------o--X--TBo----------
-M---B-----------------------E---------------------M-----M--------------E--E-?-o------------------------X--------B----------E--------------------------------Mo--E----------?---------B-----o-----o-----
-----------?-------M-X-----o----------------o--o-----------?--X----?--------E----o-X-----|---------------oB-----------X-----X-----M-------?------E-----------ME-----------T----?-------------MM-?-------
--?-------M----o--------------MoB---?---------B----oB--T-------T--M-To--------X--------o---------o-----o-------|-----XE-----XB---------o----------------------M----T-?-o------X------o------------------
---B-E-------------B--X--E-----B----o------------------------?----o----------------E-----------------------?-------------------o-?--------------o-----------T--|o---------?--B---o-|---E------o|-------v
---Bo------|TM-M------o--------?--------B------E-----T-M-------------oB--B-----B------B-----?----------o------X---?---------B-E-o------------------B----o-----M---|?----------?-------------|--o-----?|-
-----------B--------X?X--o--E--B-------B-ME--Mo-----?------o------------?----TX-------------?---M--o--o-----------BE---?-----T---------o--------o----------T--------T---------------------|-T----E------
------------o---o--------B------T--MBXB-----------------M-?-----X----BB----------------------------o------EB------?-------X---E--o--?--T------------------E--?-----T--B-B----------------E?-------T---X-
-?--o---------XBB------X-E--X--?-----o------B--------------------o-----|--------E------o-------------|M--o--?-------------M---------------------M--M----M------o-M----------B--------?-------|-T--?-----
-T-----?---oE--------------------|----?-B---?-------------o---X---|--------------Bo---E--M-----ME-------B---o----?--o---B--E---------|-o--o------------o--?--------------X------|----B-----------?---X-o
-Bo-----------BX-------------------T-----------------------------B-E------BB-E-------?-------B--------?------EB--------?------E-o---?------o-----------M---B--M--|-----EM------o---------B--------------
m-o---------E---------------T----------o--X---------|-------------o--------------------------T-o----B--?-------X-------------------------o--M-------X-----------?-----E----B-?M------------o------------
----M------E--------------o-------------------------|-----oB--E-------E-oB---?-----------T--------o----------?------------X---B---o-------|?--------|-----------------?X---B-----EB--------M--------|--o
