---E|-------X---XB-----X---X----B------|-X?-T---o--MB----oB-----------|-----XB------o----X--------Xo-------------X-?B--------------X------XX-X---XT--------E-o-------------------------o--X---XB--B-----
-----M-EX--X---B------XX---o---X-XX----?BX--?-X----------E----XE---B----E---o-X----X------E------X--X?XE--------X--------X------------X--X--X---X--------------------|-X---------|---?M?-----X----B---X-
---X---X-------XEo--?-----X---E-------B----------B--E--------X?-X--------XXB-TX----B-B--XB--X|-?--|-X---o-o------|-----------X-X-TM------X--MBo-XE--o--XE-?-------------B-----X-X-X-----o--E--B-------B-
---BM------M-----X?--M-----|X-B------o-X-----M--X------X--X-E--------X-B--------o--X|?-EE---------o-----B-------------?-T---?E|--E----------X---MT------------X--X-X-M-M-ooX-B|BXX----------X------X-B--
-B--XoB-X------B----T----------------X--XB-----------X---?-T------XEX-B------X?E-------X--------------X--?----o-E--------B-------TX---X--X-?X--X--X-----------T?-----?---------|---?-------------X--o---
-------X-X----XB--B---------------------X---XX----X----------X-X----o-?M--X-X-B--------------X-----X-M?-----X--E-----?|-B---B-------oX-------------X?----X--------M-XX-----?-----------oX--E--E-X---E?--
XX--X---------E---E--X-X?-|X-----o----------B-----B|---B-|oB---X---|XB----o-------X----EM---o-o--X-XXE-X-o?---o----M---X----X-?BB--XM---B-E-------?---?------X---X---------B-o---------------o?-X-|o-E--
-o----X-M----?------------?-------X-------o-T--o-|--T---X--Xo----X----X-?E-------o------M-----------------?---B---o------o|X--X------------X-----X-----------Bo------TB-----------o?-B-|o-?-XX--Xo---X-v
----X?--o?---X-o-----oB-----o----BB------------EX-------o-X----?oXE--------T-----XX-----T---------X------B?-----|--|-----XM--|?E--------X|---X-----X-XX----M-X---?-B--E--ToB----------X-?---o-o--XXBX-XB
---------------oX---E----o------o-EX------o-X-------X-------------o----X---------------------o-------------o-----X-------o--------?---|E-X----X-X------?--EX--EX-X--B--X-----X-BE--B-o-X--?-X--XX-------
------------X----M--X-o-----o----o-X----------------------oB------XoBE---X--------X-E-X--X-------oM--B-----------X---MX--X-----X---|---?-----BX|-------XoX-X-----X--E-oX-T-----B-XT--X---?-B----X---o-o?
---X--------o------X----X--X------X--------XE--------XM--------------------B-----E-|---?--XT-o-X----X-----?-------X--E--------E?---XXB-----Xo--|------X-BXB----?-------X---X--X-------------X------X---o
--------o?X----------X-X-X-B-X?------X--X-----|oX-------M--X--X|--X----------o------|--------?----E----T---o----X------B------E----X---B--M------------E-X--o----X---M-o--X---------E---X-?E-----|------
-T-E-MX-XE-E---|----X--X-XX---X--o-EXo--oT-----X--X------B---E--X-X--X--------X------------X--X-----o-----o--EX---|----------X|--o-------T-----------X-E---------B---XB---X--B-?-----X-------B----------
m-oo-B------o-----XTX-M-X----X----BX--------------X--X------X----X------TE--Xo-------X--------T-------?--X--X------X-o-X-XX--Xo--X--?B----T----oE-o------X------B-o-----X------?---X-X-----X|X---B------
XXXXXXXXXXXXXXXXXXXXXXXXXXXXXXXXXXXXXXXXXXXXXXXXXXXXXXXXXXXXXXXXXXXXXXXXXXXXXXXXXXXXXXXXXXXXXXXXXXXXXXXXXXXXXXXXXXXXXXXXXXXXXXXXXXXXXXXXXXXXXXXXXXXXXXXXXXXXXXXXXXXXXXXXXXXXXXXXXXXXXXXXXXXXXXXXXXXXXXXX
