o?------E-?--------------EB-------?-?----B--E--T--M--E--E--E---B--B----T-----E--|M--B---------?--|----B------|--------E---------?-------o-----B-o---oE---B-o-B--o--?B------------------?-------o---B-M--
--E?----o-B--------------?---------T-----BB---------------?M--------o-------------------------T-|------------XB-?----|-------------------------o---B-------------------------------------------o--------
--B-------------------------M----------T---B-----?B----Bo-B----E--------X--o----B----------------------------------o------------------------T--o--o---------------T-X-B-----------------B--?------Bo---|
---?-------T----o--B--|-------------------|-E-------|--------B---X--o---------------------------o-?-------oo-Xo-----E----o?-----BB------?-MBT------------E----B---|-------o--------------------------T--
---B--oX----------B----M-B---EE-------------B-E----E--o---------T--X------E----?----o-------B-------------B--------?--E--oB------TBE-----o-X|----------?-------------?--------------------------M-|E----
-----------oB?BE--?----E----E--------X------------------oo-----oE-------------|---T--X---------------|---B--------B------------------|---------B--X-----To---------------B-X-----EB---?-----o-----------
----------T---?----------?-----X-------------B-B-o--B-|-M--XXo-----M------?---o------|---o---?--?----o?-B--X------B-o---M------B--B--------------|----B--E--------------?--B----B----------o?-----------
-----B----------------------B|-----------B-------?----|--?B-B---------o---o|--B----------E-------E---------E-------o--------------o---------E-----o---oE--B-o|----------------B-T------o----|-----T----v
-B--------E-----------------?---X--X-----Eo-------T--------B--B----------o--M----------------------M-------o?---?oX-X-Bo-B------------------------------o----------------|-----E-----?-------o?--|-o----
-X---E-------------------------B---EMB-------o---?-B--|--M-o-----M--X---|--------------------BBB----------?---o-----------------------------------------T-----?-Bo----E--B-------------o?------?--------
--M--X----------------T---|---------X-----M----M------B-E----------M-TM-----?------------o--E--M----?---o-oo-----?---------?-B------TB--------oB------------X----------X--o--------------------?------X-
----------BoT----------------E-------B--------B-------B-------------o---B-?--X--EB---M--E---E--------|---EXE----?-----------o------------MX--BB----------------------------------o--------??------------
-E------B-X-------------------M-----o---------M--------o---o-X-?----------------E--M--------------EM-?------T--------------------XT-------oo---------------M--------?----------B-?-o---------------o----
----?------------o--oEBEo-------E--|-------------Xo--o--B-----M---M--?----------------??-o----------T-----------E-----B-----o-----M--M--B-------------------------B--TE----------B----------------------
m|-?o-----E--B--|-------------B-?------------------o--E-----M?B--------------o---o-------E----|---------------------------o--------------B---------B-X-E----------------T-------?E----X-M---------------
---E----|--M-------------o----------Mo-o-?---|------o-B------B-----Bo?--------------E--o-M---B------------B---------------------B|---------------Bo----E--------M|---------B------------o-----------o---
