B-----E-o---o-------X-X-X---------E----o--o--B----EXE--X------E-------X-B-XM--------------?----o----------X-B---M--?---?---o-------BXX----B-X-?-----B-o--E-?--------X--o-----E---B-----M-----E------B---
-----XT?XX--o--X-X----X-----------B--X-X--o---?-----------------X-X--BE-o--XB----XXo----M----B--o--o------------BX-E---EE-X----oX---------X-X--XB--------X---------------oXX----X------X-X--oo--------o-
--X---|-o---X-E--X-------X-------X--B-----M-------o-------------X-----X?--o--X--o?B-------E-o--X---?---oBBo--------BE-------------E-XXXM-----------o--X?------M---------------X--o-B------X-XM-----B--o-
-X---E|--o---o---------------o----E------XX-XX-------Xo----E-----X------B---o--?-----X--------?---------------X--Eo----X------o-----------B-X---------X?----X---------X------------B----o------X--------
----XX|---oo-------X------E-----B---X-X--X-------X-E-o-------X-------X----o--------B----o--------?----o-------------o----B--------------?---o-X-----X-o---XB---X--o--------oXX-----E---M--------B-X-----
--o-M-|---B---X---XXB-X------B-----Xo--o-o--?B---------?---?---X--------X--------------M--o---X------X-----E-----X-----Xo-oo------?X-----oX--X------E---------X------------------X-----Bo---------------
--X---|-------X-M---o-X--------X---E------X--------E-?-----------?---X------B----E------o-X--------------------o-----------E-BB?------X--?X----X--Xo--------------BX--------X----------X?X-------BX--?--
------|-------EX--X--E-Xo------XE-o-X-o----------------------X---E----------X-X----o---XX-------?-XE-----o-----X-----X---M-E--o-----------------------E-----X-----Eo-------------X--------E--E-----?---v
o--X--|-M--X-----------?-o--XX--X--X-X----o-X--------X-B----E--?-X-------X----X-X--B---B---X---------??X---B--X---o------oM-XX--B----B--XX-XX-X-----------ooM-----XM---B---------o---oX---X-------------
XX--XX|--o--X----oX------X-X-----X---B-------M---ooX--------X--X---?---o-o------------X-?----X-------?-o-----o--oX-------X--B-o--X------o-----X-X--X--o--X--------Xo--E-B----X-oE--------------oX-X--o--
------|--E?X--o-o--X-X------X-----B--XX-------X-------M--X--X-------E-E----X---o----BB----?---------B--X-X-X---X---------------M-X--X--?--------------X-X-----E-B--------X-------E--X-X-----?---EE--E-B-
-X-X--|---X--X---------X-------XoE----oo?------E------X-----o--X------oX-X--o-------------E----------XX---X---Bo----XX-XX-----?----EEE-----X-X--?------X-------B-------?------X---------------------X---
-X--B-|--TXo--M---X--BB----X------X---------?-------X--BE----X--X--E-X---------X---X------E-?--M-oX--X-E-----E-oB-BX-----------X------BX-XX------o--E----------------X----B-?M---o----X------------X?--X
-----E|--|---X-----X--o-----Xo--T--o----?----B--o--TX----------ME-?--E----X-----E-X---X-----To-----E----X---B?-----X-----T--X--B--o---X--XXo-oo---X--------?X--T-----X------XM-B----XX--XX-----X-Mo-----
mX-XX-|B-|B---o---X-------------T--o---------------T----------B-----?X-?-MX--B------o-------T--X--X-----BB--M----X------X|---o------E-E-X-----|-?B-----------oXTX-oo-----X-------X--o-?-?-BXX-M------X--
XXXXXXXXXXXXXXXXXXXXXXXXXXXXXXXXXXXXXXXXXXXXXXXXXXXXXXXXXXXXXXXXXXXXXXXXXXXXXXXXXXXXXXXXXXXXXXXXXXXXXXXXXXXXXXXXXXXXXXXXXXXXXXXXXXXXXXXXXXXXXXXXXXXXXXXXXXXXXXXXXXXXXXXXXXXXXXXXXXXXXXXXXXXXXXXXXXXXXXXX
