B---X------XB----Xoo-X----E-o------?-----ooX--E----X--X--------?-X--X---B---X------B-X---?-----o--o-------X?--B-o-----------o-------X---?oo-------X--X-----------------------------M---X----B-B-o---E-X-
------T------o--------M---X---------X------oX-------X---X----X---X----E-----B----X---------XXX-E-E-----BXX---X?-------X--oX--X--o----------E----X--------E-X-X-------E--------X-X---T--X------X-EX--?---
X-----|---E--------XM--o-?--B----oX-B-----------o-----o-------------E?-o?-----------------ME-----------------E---?--o---------oXX--------BX---?B---X------?-B-X-o-X----oE---o----oo-|-MX?E-----------o-E
---oX-|-?------------------X----M?-?--o----M--o-----X-----?--B-----ME------?------|--------?--------------------o-X-------M--------Xo---X-X-----B---X----------------X----------EM--|--------X-M------B-
o-M---|X--o-------XXo---X---X------Bo-X-------?----------------o----------X---o---X---o--oX-----X---?----?--------M-o--------X--X-------E-------X-X------X-B------Xo--oo---oo-------|B-X-------B--X---o-
X-oXB-|-M-----------------X---?-----BX--B-X---?-M--------------------Xo-XB--X-E-X----------o-X--------EX----?XE--o------X-X--B-------o----X--X-B---?-o-X-o----XX----X---?B-EX-oX----|-X---X----------o--
------|M--?X-o--o-----X?---E?--------------X------M---------?---X-BX-?X--MX?-BX------B-------BX------XX----------XMX---B-o----B---o---XB-----X-oM--E--X-----o--X-E----XMX---EX---B--|------X----B----o--
------|-X--oM----XX----E--------X---E-X---------o-XX--X------X--X---X------X-----X--X----------------BXB----------|--X---B?-------oX-X---o----X------B--B-----EE-?----?-------BX--Eo|-----|---------o-Xv
B?XoX-|---------------XM-BEBo-X-----o-E?o--X---o----M------XX-X-----X---B-o---XX---------X--o--X---X--BBB---X-----X----B----o-B--X---B-----?B-------?X---B------?-o-X----------o-o--|B?---X---E------X-X
-X----|--XBX----?--XX--B-X-----X------M----B----X-B-------------B--X----X-----E-----------XX----?--------o------o---------------B---------X----X-B-------B-----o---XB-----X-B----XoX|-X--o---B--------o-
XX----|BE-------?------X----o--------B-------?-?------------EXo------o-X----------X----?--E------BB---------------X----------------------E---X--?----------X--X------X-o----------B-|-----------oX-E--X-
-XB---|------------------XX--X-X-------X----------X----o-B-------------X--X-o---------o---o-o-X-o---X-----------?--------o---X----X-X----XXXE-??------B---B-----Xo-oX---o-?----o--o-|----B-E--E-------X-
oXX---|X-X-X--Xo---------B----X-X--oM-M-X-BX--X----X---M--------------X-X--M----X----E----B----X------------?----E-X-------X---X--X----X---?-BX------Bo-----X---E---o---B-----B---Bo|-Eo--------E-X-----
ME-X-X|---X-----X-------X------B--X----------o--X-X---------X--o-|?---oE--------E----------B--------E---?BX----------X-------------M-E----X--------BXB------------o----XX------ooo--|oXX---M------------
m-----|----Bo------E-----B---X-BE-------------------------BB-MX--|-------?---------?X-------------Xoo-------o----XB---o-XX------XB|----X---X-----X-X--X-oXX--------X--oX---X-EXoBX--|o|--o-------XX---?-
XXXXXXXXXXXXXXXXXXXXXXXXXXXXXXXXXXXXXXXXXXXXXXXXXXXXXXXXXXXXXXXXXXXXXXXXXXXXXXXXXXXXXXXXXXXXXXXXXXXXXXXXXXXXXXXXXXXXXXXXXXXXXXXXXXXXXXXXXXXXXXXXXXXXXXXXXXXXXXXXXXXXXXXXXXXXXXXXXXXXXXXXXXXXXXXXXXXXXXXX
