---X-oo---B-------X----------o-?-------o----o-X-X-X-XX--------?--X------o---oE--X--------------X----------TT-----------B-------X---B--------?--X----E---X-----X-E-----BE------X-------------------------
--Xo-XT?------------X---X------------X-X--X----?------EX----TX------XX---E-----BX---E----o--XX---o----XE--------T?-----?---B-------o-X------E-X-X--B------To----------X----X----E---X--X-X--------o--M--
X---o-|---------XT---X----------X---X----?--T--X-------------------TB------E-----B--X--------oX--XM-?--X------------------------X---------o--X--X--XoE------B------X-----?-------------X----M----B------
??----|-E----?-E------X----------E-B--E------------T---T-------?-----X-----------T-----XoT----X--X--B-----o----o---M-----TX--o--X-----B-X-oXX-------o---MX-o-X-X--X-BTXE--X---X--B--------o--X-XM------?
-X-TX-|X-?X-B-X-E------------BM-----EX------X-------------------X---XX----B--BXX--T-----E----o----XX--XX------T-X--X-------XBX--T-----E-o---EBo-EXX-E---E---X-----XXX-------T--BB--------X--B--X-X--o---
--X---|X--Xo-X-o-o----?-o?TT---B-X-E-o-E---------?--------E-------X-Xo---X------X?------X---TE--------M----X------B-B-?XXX-------XXo--B-----EB---X---o--E-----BB------X-T-oX----E---oT---o-X-----X----X-
---BE-|--------oX----------T------------o-MXo----------?-E---BoXo---X--------o-----------B----X---?----M-X------------?--B---E-----T-?--EX--X------o---T--oX-------?--X---X-oM--E--o--X----X----E-o----T
--X---|-B-o---o----X--------E----?-X--X---XB-----M-BXBX-XM--B--oX--X-------------XB--X--o-----XoX--X-XX--X-o-----Boo---X-X--XXX--X---X-?----X-B-X-EB----E----X-------X--X--X-T---X------------o-o------v
------|-------X--------B----B------------TB---E-B---T--X-X--------B----------------oX--oo-X--o-----B-XE-o-------o-------X----o-TXo-----M--XE-X--E--T---oB-?---ME--X-M--------T-----o-T----------BooX-X--
------|EB-----E-X-----o-------X-----X-----o-X-B-X-----X-----------X----X-X--------XEo--X-----------oE------XXo--T------------------X--B--BEB---------B-----Xo----------o-------X--B---X------------X-X--
-X---?|---XB-X-X------------------X-----?-----o----------MB?-------o---X---T--X---------X----X---BX--X--o?--M-B---XX---------B-----BXX---oo-T--X-T-X-X----------Bo------------X-X-o--X------------B-M--X
--X---|--E-----oXE----X-X-X--XTX-----TX------M-o-E-----TE-X-Xo---o----------BoT----o-----X------X-----------o--?-?-----EXX-?-----X---X---BX---------?--E----B--------------X----X-TX-E-o----B-----X-----
X-----|X-T-?-oX-------X----B---?X---E--BE-----------Xo---?-------T-M--------X---MX----XX---?X--X--oX----B----X-------MoMX-o-BM---X-X----------T------------X---?E------B-----?-----oE---------------BE--
------|--|-XX----M--------X--X-------TX-------E-B--oX-------X-------B-----B----oT-oXX----------o--------------E-oXX--X--E---B---X----E----B------o-T------E---B----T--X---?-----M-Xo---o--X--X?X--------
m-----|E-|-X-BB-o--X--BX-E---------B-|--B-E-XX---o--BEB--X------EM-EX------o----T?------X------E?---o-X-----X-E-B--M-------------o-----B----XB-E-MET-----XX---X-X--T--o-BoB-X-E----T-?--X------------X?-
XXXXXXXXXXXXXXXXXXXXXXXXXXXXXXXXXXXXXXXXXXXXXXXXXXXXXXXXXXXXXXXXXXXXXXXXXXXXXXXXXXXXXXXXXXXXXXXXXXXXXXXXXXXXXXXXXXXXXXXXXXXXXXXXXXXXXXXXXXXXXXXXXXXXXXXXXXXXXXXXXXXXXXXXXXXXXXXXXXXXXXXXXXXXXXXXXXXXXXXX
