X-X----E--B------B--------X----------B------EM--XX-E----XB----------X---X-X-----B---------X---o-?-----------o---?-o-----oX---X------------o----o-------X-------?--XX-M-----o-X--X----M--X-o-X---B------X
-------?B-----BXX-------o------E-X-X-B------------------X--XX------X---o-X-----B?----XE-E---?-X-----oBXX------E--X----B---BX--X-o-XB-E--?--o-XXE------B--------o--X------?--B-oo--X-----XB--X--EX-----o-
--X-X---B--------?----o-------B-XoMX-----oX---B------?X-B--B--E--------oB--------B-----------o-X----B-X?--o-o-?E---X------------------X-------------o--o------Xo-X-----X----X-M-X-----o---X-X-o--X------
-oo----X--Xo--Mo-X--X------o---B--o--------X---X-X--X--------XXX--o----?-----------E----M---X--o-X-----E---X?X-----------X-----X------X-----X-----------X--------MX--o--------X---------------E--X--B-X-
--------B-------Mo-X------o------------BX-E-X--B-------E-----o-----?------------o---X-XX--o------M----X---?B-----X-----X---X----X-X-----XX----------------X----------------E-BB--------X-------E----o-X-
----------------o--------X---o-----X-----o-E---B-----o-?-M-X-E---EX---X-----Xo-------B---EX---X---XX----E-------------X?oX--E-----oMB-----XX-E--X-----------X--------o-M-M--X--X-M------X-B--?--M----B--
-------o----BX--X?oo---BX--X---X------X?B--------X-o-X---X--X--------X--o-------?---X---o-------X-----------------------X--o--X---X--------------XX--X-X-----o----o-XX--?X-----B-?-----?-X-X--oEX--XB-E-
--B-o---X---oX------o-M---X-----X----?--------o-B-------------EBB---?-?XX---oo---------o-----B----------B-M-BX----X------o-----BB-----?--------?------X-E---oX?--XXo-----X---BB---?---E-------X------o-v
?-X-X-----------?----------?EB-------XM--?-------Xo--X-----------------------X-B--o----XXE--XX--XE-----o--X-X------------B------X-----Xo-------X------o-------?--X-X-B---B----X--------------X--E-o--o--
----------?-----X---E-X--?o----XE----------X--------------X-M-X--X-B--XX--------------o----M----------XX?-X-----X-E----Xo-----------E-----------X---o--B----X-------X---B-E----o------------XXX-XE-X----
---B--------------X-X-X---B----XX-------X---o-----X----?X------X--o-B-------o-----------------B------------?---Bo----------X------------------------------X------B-B---------------------B---------EB---
-------B-----M--X-X-B-o---E-----oX----X------X-B----------Bo-B--X?--------------o----------------X---EX-B?E--BXX-?--o---ME-X-Mo-X-----E---X?----M----X---X------XX--------------------------o-----o-----
E---------?-?----EB--?--X----?o-----X-Xo---XB--X--XX-M-B--X----X---oo?--B-BXX?B----o---X-------XB?-----o-X--X----E-----------X-M---------E-o----E----E?-------B--XXB-X-X-----B------------o-X-?-X-------
X-o-E-----------XX---XX--?-XX---------X----------X--X-oo--o?---?X--------X--E-B-------XM---X-------------------X--X-----?--------XXX----o--------o---X-----X-------XX-------X---E--?--------X-----X-X---
m----E|-X--o-------X|---X--o---o-------X--BX-E?-----BX---------E--B---E-----X?--------X|-o--X--------X-----oB-B-o----o----B--?--o?----?-X-|------X------E----X----X--XXoX--------XBX|o--XXE---B-----X---
XXXXXXXXXXXXXXXXXXXXXXXXXXXXXXXXXXXXXXXXXXXXXXXXXXXXXXXXXXXXXXXXXXXXXXXXXXXXXXXXXXXXXXXXXXXXXXXXXXXXXXXXXXXXXXXXXXXXXXXXXXXXXXXXXXXXXXXXXXXXXXXXXXXXXXXXXXXXXXXXXXXXXXXXXXXXXXXXXXXXXXXXXXXXXXXXXXXXXXXX
