--------------------------------BM-----------------------------------???---------oX-------------X?--B-----XB-?MBXBX----B----------------------------------------------------BXX---BB--BBXXXB------M-XMX-
------o?BBBXBB---------------------BBBXBBBB--------EBBBBB-------XBMB----MoB---XX-MB-------X--------------------oXX-----ooB--------X-----MM--------------o-----------B-----------XMM---------------------
MBX-------B?XM-------X----------------------------------E?--------------------oB?B---o--------------X------B-B-------------B----------BX-XX------B?-XB--------------------BBX----BMX-----------?BB?-----
----??---------------?---o-----------------------?-MMX-----------oM---------B---X--B-oMB?B-------?---??B--------X-------o-------?X-BBMBXXB---XM?---------------------------------------------o------?---
---------------------------------------------------?XB-------?BB----BB----X----------------BXB-----------XXX--------X--------BBM---BBB-M?-------------MM-XBBM------------------M---------?B-------------
-------B--------BX---------MBMMM--------XB------------M---B?--------BB-------B?---------BB?BM----------------BBX------------------------------------XB?X?---------B-----B------------oXB-------B--------
------------------------XBX?X?X-BB-------------o---------------------o-------BX?--BB-----B----------B------o?---?XB----------X----------EBXX-XXMBBB----------B----X?Xo?B-BB-----B?BB-------BBX-?B?X-----
----------B--------------BM--XXB-------------------BB--E-------------------------------------------BX-------B?X---------XXBB?---E-------XXB----BB-----B?X--MB--------X-XX----------XBBB--BBB--BX-------v
XMX---------------------MX---------------MXBX-------BM----------------o---------XMB?XMB-----------XBB?-----BXB---B--X-XM---------oBX--M-----XBX-------------------XB?-o?------?------------------------f
---------------------------------?BMX?------------------XX----------BB----oXX-----BB------------B--XXB--------------MX------------------------------------oXB---MB----XMXX-XX-B-----------------E------f
------BBM------X?XBMBB----oX?--XBBBBBBB?------------------------M----X-------BMM?------------?XXB------------------------XM-----------------------XXX---o?o--------------------------------------B-----f
-----------------BBB-------------------------B---------------------------------------------B?B--XXB------------------------------B--------------MB-------X-oX---XB---B--------------oBMX----------B?---f
---------BB??-----------------------------------X---------------------B-XMBX-BBB----E-------XXBBB--------BB----B----------X--------------B?BB--------------------------------------oXBX?BBB------------f
-----XX--XBBB--MB---?B--------------------------BM----------XX-------XBXX---------------------XBB-----------oB-BBXB---------------BMBBB----------------------X------MBBBX------------MoB?B---BB?B------f
m----TB-MX------------------------------------B--oBBB----------?MM------------XXB?-----------------X-------------MM?oBM-o---------B---------------------B?B--BX-----B------------------X-?BBMBBXB----B?X
-----?------------------XXBo-?-------------?---M-------XBX-----M?BT-------MMB?BX?-----------------------------M?----------BB---EXXX---------oBBBBBBBX-----------B----------------X-------------o------EX
XX-XX-XXX-X-XXXXXXXX--XXXXX--|XXXX--XX|XXXXX-X-XX--X-X-X-XXX-XXXXXXXXXXX-XXXXXXXXX|-X-XXXX-XXXXXXXXX--XXX|-XX--XX--XXXX--X|X-XX--XXX-X-|-XXXXXXXX--XXXXXX|X-XX--XX-X|X-XXX-XXXXXX-XXXXXXX-XXXXXXX--XXXXX
