--E-X?------|-----E-----E-Bo-------------X------M----------o----------------o-----?-----E--------------------E---B----------|---------o--X--B----------T------B-----------------B?---E--B?-----E---T----
---E-------M--|-E-------B----------o--M--------B-------------?-----?--o---?------------o-------T-?---B?------o---B------------------?----EB--E-------------o-------oM-----T-------E----E----X-X--E---o--
--o----X-B---o---B--E----------X--------o---------------B--o-------o------o--------------B---E-----------M---------E----------E---E------o---------E-------E---------T-----T--T----------?-----oo------B
|-----E---B----------E---?----------T----?------BB------?-B----------------o---|--------B-----------------X-T-M------B--------B-----M---oX---E--------o-----M---------------o--------o-----------------o
-B-------------------------------------------M--------------ME----------BE-o--------BE---------------------E--?-o--------------|-----------XM------------M---?----B----B-------------------B---o----B-B-
-?---B----o-?----------------------X--?---o---X------o---E----------|------------------------o-?---------------MB?----------E-----------------T-------------------M---|-----------?----------------?----
-----------?--------------X-------oE------------------B-|o----------------X----BB----T----------?------E---o--------o-o----------?----?--o--------o----BBE------------o------------|--?------M-------M|-
------|----------o|--------o-E------|----------EB---?--------o------------o-B------|-o--B-----?-----------------------X--o-------|--------B-ME------------------------------?-------------------T---o--v
---------------B-o------------------M|----------------------E--|------------?-T--B--------B--Xo-----------E----BB-----o----|-----------------o----------TX----Bo-------------------o----------------?---
?---------?X------------o------------------------------X--?--------------oB-E-X-----B-----------------o-B---------E--M-----------------o------o------BE--o--------XXE-M-M----BBTo------------T-B--------
B------X--M------------X-----------E-B-------------X--|-------?M------?--------B-o--E?-----------------B---------o----o-----T|------o--------B-------------?-------------T---?--------?-----------o-----
---------EB--------E---T-----o------?--BEM------|---------B---o-------------------------------------X----B-------------------EoB-E----------------M-|----o-----M--------------B----|----|----------B---T
M--T-------X----------oo-To----oBo--|----|E-E------T---o------|X-|-------------------------------o---------B------To-------T----------------------------------B------B--------?---o--------B----B---E---
E--T---------------E-----------------B--o---------------------M--Mo--B---------?|----B-------------o------X--------B---o-------------o-----------------E--?M-T--|??-------|---o-o-------B--?-----oT----o
m------------------?-?---o-------X-------E-?--E-----------o--X-----M---ME|-?---------------T----T----------?---o----------B-----?-?-----M-T|-----o-B--M--TB---?-----E------------o-o--------?-----------
----?|----------?-E-----------B------B------T|--------------B------o----Eo-E-----o--------------?--T------B---B------------TE-------------|--------B----?--------------E----------------------------E---
