-----M----oX-----o-X-o--------B---------------?---E------o--E--o--------E---------?-------?----------------?---------Xo---------------------B--------B--XX----B-----X------B------B?-o--X----E----oX----
--E--------?--X-EB-BXE--------X---------X------X-----X-----X---o--oX-----B----------------oX-----E--M?-B------EX-------??-X--------------BE---------Xo---------------------X--?-Bo-----X---------X------
--X------BX--X------o---------------?-----EE----------M-o------X---------E-B---o------------------XE-EX------B----------o-o?EE---------------X----?--------E------------------------?o-o-----------M----
-----XB--------------Bo------E-o--o-----------------M-B---X--X------------------?B--o-E-o-----------------B-E-------M---BM--------------------?-Eoo-X---?---------o-o------X------oB----o-EB--?----E----
----------E----E--------XM-----------?-----X----E--M---?----o----B--------X--------------E-----E----o-----Xo----B--------X------o--X--B---E-X----------E-----B-XE-B--X--------------o-E-o-B----X--------
X---Eo-----B----------?-o----E----E--X----B-------X--o--------------o?X-----X---X---------X-X----------X--E---E----------------?-o------o------X----------B-----o?---B?-E---o----X--Mo----------------?-
----X-------o----------------------EM-----------------------X---------X-X-o--BX---------------------------X-B-E-------------E------------X---E--------X-E-----M-------E-----M-oo------------B-XX-----o-?
------XX-------------E-----------------------------B---X----o----------Xo---------------------?o----X-o-M----------o?----EE----X-----------------o------?--------X-o-----E---X----------o--------------v
o-----M--?-----------------------X-----X-------------o-o-----o-o---BXB---------------B-M-------o-----E----B---------X--X-----X-------------Xo-XB--------B-----EB----------o---------------B-M----------B
-----E-M---------------oX-------XE----B---XE--------E--------X----M---X-?----------o----------B--o-X--B--E--------X-E---o?------------E-BM----E----B---------------------E--X?---X----------XME-X-------
--E------o--X-EX--------------o---------B--M--X------MEo---------XX-B-------------E------------------------E---B--XX---EE-X?X---------------XX-M--X-----o------------o---------E--------E----E----------
-------------o----X-----------?-X-------B----?Bo--------------------------E-----------E--o------X--X-E-------X-----o-------o--X-X-MB--------B--------X---X---BE-------B--X----?-X-----------------------
BX-X--X---M-X--------X-------------T----X-------T--M-B------------X-E-----B--------?------------o?-------o---------B---------X--oB------------------------T--E----------B---X------XB-E-T-T-------BE----
--T-X-T-TE-o---o---EX------E-------|--TXT----T--|---E---------------T-T--X---T------------------TBE--Eo--E-------To---------oT--XT-T---------E---------T-X|?---XT----T-----------X----T-|T|--T-B-TT-oXo-
mE|---|-|Xo----X----E-------X----B-|o-|X|oX--|B-|-------?----------E|-|----Xo|-------o--B-------|X-------o---X?B-|--X-X------|-XB|-|------E--X---ooE---|--|E----|---o|--------B-------|?|||--|M-?||---X-
XXXXXXXXXXXXXXXXXXXXXXXXXXXXXXXXXXXXXXXXXXXXXXXXXXXXXXXXXXXXXXXXXXXXXXXXXXXXXXXXXXXXXXXXXXXXXXXXXXXXXXXXXXXXXXXXXXXXXXXXXXXXXXXXXXXXXXXXXXXXXXXXXXXXXXXXXXXXXXXXXXXXXXXXXXXXXXXXXXXXXXXXXXXXXXXXXXXXXXXX
