-----X-------X-E---?------B-?-o-X-------B---E---o---X------oX--X-----X------------X-------o------o-XBoXBX-------X?--?o--X--------E---o--?-----?X-----X-E--X------------X-----B-----X---M---------Xo-----
-M---X----X----E----B--------X--M---------------E----XX-------X--B------------X-X-XX--X-XX--------------------EX-------?-----X----oB-----X--------------X----B---------o-----??------o---X----X------BX-
------X---X-XX-----X-X----X-E-?------E--X--B----oX-----------o--?X-------X--------?X-oo-X-?E-------E-E---X-X-------B--------X-X-----X---o----?oo----oB-----EE-X?-X---E--X---?----o-----B-----------o-?XM
---X-o-o-----MB-o-------------------X-M--------o-M?----------X----------E-X---o----------X-------EE----------X-E-EM-----------X?------X---B-----------M---o--X-o---X-B-----E--------o--Eo-o----X-B-?B-oX
-X----B----X-----X--MX---XooX---X---B--X----XX--?-B--------X---XXE----?o----B---------?-X------X-----o-BX-----o---X---?------------XB-B---XE--o-X----------X------BB-o---------------B--B----B?--o-Xo-X-
o---X-X-X--X----?--X-------o-------B--------E-----------X-----------?-------B---XB-----XE--EX-Bo------Bo--------X-----X-B----X-----------B---?-X-M-----X---X---B--------------------X--o--M---X-----XEX-
-----B-------?X--X--B-E---X-?X---XXX-o----------o------o-----X--------XB---X-Eo-----oEX-X-X-XX-------EX-B---oo-EXX-M-XXXo----?--------X----?----------?----EX-----------X-o---X-----------M----EX-X-----
--X--?--X?------E---------------E?--B-----------------------------------X----------EB-----X---------------X----X---E----XB-o?-------?--X----X--XX-----B---------X--------B--XBo--------X?X-----X---Xo--v
----XX---M---------E-----o--------------X--BX--M-X----o--XXo-X-----------?-B-M-------X-E--------o?E---XX--X-?-------------X-X-X---------------------X-XX-------------Xoo-----o----o----------X---X--XB--
----o------------E---------------------X-------------X---------B----------?----------X-------------------o---E-X-o--B----EX-------o---------B--o-X------E-?----E-B--XB--------B--o-EX---------X---?---o-
--?--X-EX---E--MEX--------Xo------XX-B-------B-o--o---o---oX-o-Xo-o-----BB----XXE-XX--E------oo-----o------X----o----XX---X--------o---E--X-X---XXX----o----X--oX-----X-E?--E----X--B-o-X?----------B---
--------B-------X----X----X-------------?-----?E-o---E----X---X------X----------B-B--------o-----X---X-o--X?--X------X-----X--XX--------o--X---?X---------?-----X--X---o--X--------oX------X----BX-X----
-o--o-------B--X----X----?B--XXX---X----X-B------?-----o-E-XX-------------------X-----E--B---XX-----------?X?---M--M----B-----oX----------X-X-----o-----X--?--X-XX--X--------X-oE-X---------------------
-X--------E----M---------B--o----X--------X-?-o-B-----X--X-X----------Xo---X-----?-o-o--o---X?---X---X--o----B--------XM--M----X-----B-------X-?X----?------------B----?-------ooXBMX-----X------o----B-
m-----|--B-----X-----------E-X---?--X---------E-X-B------------o-------XX-X-------XB------X-------o--X--oX-E------------oME-----------B-oX-----------------------X|-----o----XB-XE-------EXoX-----XBo|--
XXXXXXXXXXXXXXXXXXXXXXXXXXXXXXXXXXXXXXXXXXXXXXXXXXXXXXXXXXXXXXXXXXXXXXXXXXXXXXXXXXXXXXXXXXXXXXXXXXXXXXXXXXXXXXXXXXXXXXXXXXXXXXXXXXXXXXXXXXXXXXXXXXXXXXXXXXXXXXXXXXXXXXXXXXXXXXXXXXXXXXXXXXXXXXXXXXXXXXXX
