o-o------|---?--X?-E---|-----E---X--------E?B--o------?-oXM------o-----o-B--X-B-?--o-----B---o-?o-----E--X-X--Mo-E-X-E-X-E--------X------?------X-----X------X|----X------?-----o------M---|-X----?-----
X--E--T-----E-M---X------------------X-------o-B-----X--------B-X--XXE?---X----o-------X----o-------X--X--------E-----B|---X--o-------X---oXo---------o-EX|------o-----B----XE-X----TXBX----------------
------|X----E-X---M--o-X-X-X-------M-----B-X-B?------------B-X-X---?-?Bo---?---------o---B-M?X---o---------Xo--X--------Bo|E----------------X--XE-E--X-oo---------X-------|---o--o--|BX---------?Xo-----
-E----|-----EX-------B-------X----X---M---------X--------------?|---XE----------XX--------X----?---o----XX--B----XX--X----X|-X----B-------------X-E-------B--XX-X-B-----Xoo---------|---o---------------
X--XX-|?---X-oo---------o------o-XB?--o-------o----Bo---XXX----B-X--XB--B-?X-X--X--------X----------XX-?--X---o---X-o--M----M-------M--------------X-----oo-X---Xo-X-X-----X---X---X||X---X?---B--------
------|---------E-B?o-Bo----?-E---------X---BX-M--B-------X-o-E----B---------E--XX-------------------o---------------MX--XEX-----------X----M-------------X------o-o--X---X---?E----|----B----------o---
-BE---|--X--------------XE------XX-o--X--Xo--X---B--E----------o-M---o-?-?Xo----XX------X-X-----X--X-------B------X-----X--o-M----X-X-E-XXXM-X---X--------X--XXoE---X--X-----X--MX--|--------o|---XXX-X-
o-----|----o-X--------oBX--BX---------E-----B---------|-------XEB-X---------XX----------X----B-----------?------X-XX-----MB--X-----B--E-X--M-------X?BXX--------o--X----------------|---o--|------B--B-v
------|--B---------X|-?-----?-B--B-X----?--o--X----X-----------XX--X------X-E--o--------BMXXX----BB-X----?--X-?-----o---------------XX-----BXX-X--XMX-o----o----X--XE-----X-----?-o-|-E---|--X---------X
--Xo--|----X--------X-X----------o-----BXX------M--o---BX---B-X-X---?-----X--------E-X--------------X-E?--B-----E---|---------XM-----?o-X|-X-------------?oE--?-------EMX---?----?--|M--o---------X-----
--o---|-o----------B------o--B-------------X-E---?----------E--------------B-----o--?-B-X-------E------------------------X---------o--------?---X-----X-Xo-o-E----------X-----Xo-Xoo|----------?--------
---X--|E---|---B-B--oX--X------X----M-|---X-------------B-X---X-------X-----X--X-X--XX-----EX--X----X-----X-X-----?-XX---XXE--EoX----B-------------X-XXX--|------------B-Bo----X----|-X--------X-X--XX--
-----X|X-----XB--Bo--X--X---X------Eo-X?--XX-------X-E---B--B-----o------X--X--X-o-X------B-|--E----o---------XX--X-X--o----X-----?--X-X--X-|-------M?-X----o-----o-E---------------|-----o-?---MX-----X
--oB--|o-----o-----X-B--XE--o--?------o-----?-------X------B-o-|X-------|--X--o----E----?-X---X-X---E-B--X-----X--Xo--------------X------XXXXX-B---o--------E-XB--X--X--X----?---E--||-o-----o-X--------
m-X---|o-----X--M--B-X|-X---BXXBBXo------oo---X-X--?--XXE---B------EBX---o--Mo---X--X---B-?---X--X--?XXM---B-------X-XX--M---X?------o--E----B-----X-X-X------------MX---M----o||---|--oX----B-X------X-
XXXXXXXXXXXXXXXXXXXXXXXXXXXXXXXXXXXXXXXXXXXXXXXXXXXXXXXXXXXXXXXXXXXXXXXXXXXXXXXXXXXXXXXXXXXXXXXXXXXXXXXXXXXXXXXXXXXXXXXXXXXXXXXXXXXXXXXXXXXXXXXXXXXXXXXXXXXXXXXXXXXXXXXXXXXXXXXXXXXXXXXXXXXXXXXXXXXXXXXX
