--B---?BMX----------EBB-----------X------E------------------------X--------M------M---BB-------XB-----BX?-?-------------M-----o-B---------M------------BB---B-------------------------?B------X---------
---?--E?------?MX---B------------------M-XXXB----M-------------o------?X-------------------------M------------BBBEB-------------o---??-----------BM------o-XB------B------X-----------------------------
-------XMB---------XB-----X---?-------------?B----B?---------oXBB------------------------------------------MX-------M-------------B------o--X------X-------------XXoXB---M-------XBBB-----------X-------
--B---------?BX---------------MBX---------?--X-o-------------------B-----------E-----XXXXX-B----------XB-------BB---EB-------o-----XXBXB??----------?B------------B-------------------------------------
X-------------B??B-----X-------B--B-------oX----------XM?XB-----------B-------B-X---BXB----------------o----MB---XB-----BXMX-B-B---X?B----------------??---X-----BBM---------oXXM-------X---------B---BE
--------------?MBBBXX----------------MBBB-----------------M---------------------BBBB-------------------------X?BM-----X-----??---------------------B-----------------------X-----------?B----------BBXMX
--BB---XB----X----X?-----X----------------BXX--E?oBX-------BBB-------------------B-X---XM---Mo--------o----M---oM---EBBBX----oBB--XBBB-------B--M-------MB-------X-------MBMXBX------B-BBM-------B------
-------------------X-------------------o--------?----?--?X----------------MBB-----------o---XXB--BBX----------XXB-----XB--oXB-----------------oBB??X---------------B--------------BB--------BM?XB?-----v
----------B----------------------------------------B?--------X?-----------BMX---o----------------------------??B------B-----------------------?B--------------?B---------------------XXB---------oBX---f
?-----------------------------------------------XMB?-------------?MXB---------------BMXBB----?---?MXBB?----?BMB?--BXXM--------------??B-----BB?BBMB-BX-------------BB--BBB--BBX---?-----EB--------??---f
--------------------------------------------------------B-------XX-XB--------?XXX?B------X--------MX-------BB------BE-------------X---X-XBBXB----------------?-----------------B--B------BX--------?BM-f
--------------------------M------B-----?------o------XXB---------B--------B--B------------BXB-B-------------oXX------?---------------------------o-------------------------------------X-MB----X---XEXBf
--------------------M-B----------X-B---------------------------------XXXM-------------------B--------X---------------M?----XMM-BB?-o----------------------------XXBM-------oBXXBM-----?----------------f
-----------------------------------X--------X-B--------------B-------------XB------------MBM--------M-----------------------MX---------?M----------X------XBM-XB----B-----MBBB-------MXXX?----X--------f
m--------T----------XXBX--B-----------------oB------------------------BXX---------------E------------XBT-?B--T----?--BB-------------o----B--o-----X---------------------E-----?BBB------B----------??--X
XBB?X--B?|--BX--oXX---------------------------------------------BBB-X-XBB----------X?B----------X?-?B--|-----?X-XXMXM--B---BBo--BBBXBBB?--TM???B--------------------------M--B---------BM--------------X
XX-X-X||----XXX---XXX-X||XX-XXX-XXX-X-|X|-XXXXXXXXXXXXXXX-X-X|XXXXXXXX-|X--X-XXXX--X|X---XX--X|X|-X--XXXXXXXX-XXXXX---XX-XXXXX||XXXX--X-XXXXXXX--XX-X|XXXXX-|XXX-XX-XXXXXXXX-XXXXXXXXX-XXXXXXXX-X-XXXX|X
