----------?--?--------X--M-X--X-BM----Xo---X--XX-B----------?------X---X----------o-X--X-----X---X------E--------X------B|--o-----X-----XXXXX----o-X-o------------E-----------o-------X|----o--XE-----X-
---X-BT------o----X?-XX-----||-------------Xo-?E-------------M|-------------o-B----X-M--E---------MX-X-----o--B---B--X-M---------X-----|-------|-X-----o--X---X----E---------X------T--E---?|--X?----X--
--?---|-|-------XX----X-----B--------B-?------------B---X-X--X---M-X---X--B-----X--------XX-M--?-----M-----|-X-----o-----X-------o---X-X-------------?------X----X-X---X-?------X-E-|X----X--o-------X--
------|------------BM----XX-X-o-Xo--?------X------B-X-----X-XB-X?----X--M-EX-E--X---------|------?B-----------BXX--MoX---o----o--M---------M-|------EXo-----E---X-X--X---XX-EX----B-||X--X|----M--------
X-----|-X-----X--------X-Xo-oXX----------?-BXX-----------B-------X-E|---?--?------B---X--M---B---o---X------?X--B--E--------?--B--o--oX--Eo--?-oX---o-------?-----XXB-o-X-E-?-o--B--|-----o------o--B--?
----X-|---------------B---X--o---X|-M----?---B-------B----X-----------------|------B--X---X------B-------------M-------?X-X-------------o---X-X----E-X--X--|-----o----------oB----?-|-X----------?-|X---
--X-|-|-X---o---------X-------------XB----X--------------o------?-X------------E--o----------|---E-E---?---o----X----XB------o---o--X-X------XX---------------?---?X-X-X--oX-------E|---------?-XX------
-----X|-XBB-----------M---------?---XX----oX-----X---------------BX-?---------X-|-o-XT---|-------------------B-|-B------?-o----M----X-B----?------X--X-------------------X|-----B--o|----X--oX-----M---v
?-----|------oXEX----E--X-o-o-o--B--o----X-X--X--------BX---E----M------------------?|-------XX--X-----|-oX-------X-----X---?--X----X-----X----X--Xo-?MX-Xo---------------B---------|----E-B-X-?--------
--X---|-----X--E----------?XB-------X-E-B----X---X---X-X-------?----o-----o-o-o---BX-XB--X-------X-X--------M-------------------o-o--------o-X--B----M--B-|---o--X----B--X---------o|------------------o
-X--o-|--|-------B-----------E--X-X---|-----|------------X--o-------B----o--o-----------B---E----X----EE---o?--------X--X-----X------o---XXE--------X----X-------X---B--------M-MoX-|---------XX---|X--o
-o?---|-B-E--------X-----X--B---------------------X-----?X-----X---oB------------?X---o--X---o-?-o-------X---------------X------M-------X-X----X--X--------------B|----X----Xo-X----|----B------X---X---
---oX-|-----o----XB----X-o--X--X-------o--o-------X----X----X---X----XX-o-------B--B------?EoX---XX--X----X-X----M?--?---X-E-------E---------XX------------------B-------E-----o----|X?---------------Xo
---X--|-|X-B----oo-X-----X--o----B------X--BX--X---X-----o--X----o--------------E---o--XX?-------Xo---X-X-------E---X--B---X-X--X-----?-------X-------|X----X-------?----X-----o----|-------X---X-----X-
m-----|-E---B-------o-E-E---?o-X-----XE----M-X---?----?----X-------X-----B-B---X--------------oMo----EBM---||X-X--E----?X-X----X--o-X-------BX-|----X-------B--X-B-?----------------|-------X----X-XE--|
XXXXXXXXXXXXXXXXXXXXXXXXXXXXXXXXXXXXXXXXXXXXXXXXXXXXXXXXXXXXXXXXXXXXXXXXXXXXXXXXXXXXXXXXXXXXXXXXXXXXXXXXXXXXXXXXXXXXXXXXXXXXXXXXXXXXXXXXXXXXXXXXXXXXXXXXXXXXXXXXXXXXXXXXXXXXXXXXXXXXXXXXXXXXXXXXXXXXXXXX
