----------Xo------o-EX-Eo-o-X-------B--o-oE--o-----------B-?-X------B---------Xo--------B-------oX------?--E------------X-o----------?-----X-----X----o-----o--X------------X-----X---o-X---o-M--------X
----o-TX---X---o---------------X--X--X-------X--X--X-------XX-----?-----?--M----oX--------------B-?-oEX---X--------X----------oo--o------o-------o--X------?X-----------B---M-o----Xo----XX---B---X?----
-----X|---BX-----X-X-oX-------M-----?----XB----------o---?BE-----EXB---X--o-M-?----X--o-X-------o-?--oo--M----o---X-----------------B-------E--MB----X----B----X----o-----X----------o--X-X-X--Xoo-Mo--M
-E----|X---M-------MBB--X-------X---?-------------E-----------B-----------BB-X--X-----X-----X---BX-B--?-------EB-E--------------X------B----------X---o--B-o--------XX---X------E---BX------X-o-X--X----
-----o|----B----------X?---EX----X-------o-oo----------X?-X--X------------BX------o---E----------------?-----X-----X-----------------X-B--X-X-----?----X------?----X---X------MX-----B----X-----X----B-X
E-E---|oX------BBo-o--o-o-----X-------B-X--------B----X-X----X-----X-EB-XX----o--------------------B--oBE--------------------o---XX-----X---M--?--E-?-----------------X----------o---oB-Eo--XX-M---X-o--
-----?|o--X-B---------o--M--B--------X-o----X--------------B-----------------XX-E--X------o-----------X-oB-X------X------o--X----B------X---X-EX---XX---------o--------B-?---X-X----?--E--Bo---o---X---o
------|X----BX----------X--o---X---X-X------X--E?X------------B-X-----o?X----------X-----E---X----------X-X-XXX-X--XBo---X-----XB----X----------------X---X-------------X--X-o-------X------oXX-B------v
------|---X------X-X--X-X---------X--o------X-------X--B--------X--------X---------XB--X----------X-XX--o-----M--o---o----?o?---------------X---E-X-XMX-E-oX-------BB------o-----X----Mo---XX-XM--------
X-----|--------E------B----------X?--o----X---------B-------X-----X---XX---B----?---Xo-X---oX-------------o-X--X-----------------?------X-------XX-----------X-o-XX------o------------X------?B-E--XM---
------|--o-X----o----------------X------------------o--B--B-------?-E-------------X--X--------E--X---XX--B---oEX-------------------X-XX-o--o---XX-----XX--X-o--Eo------B---------B-XX-------?-?-------o-
---X-B|X-E----E----------X--X--?--E---B--X----X----?-------BX---------XX-B---B--------o-o-X--MEo-o----o-----XoB---X---X--?o-------X---?-X---B---o--X-----------?o-----X---------X-----E---o------XE-----
MMTT--|--T--X-XE---XXX-oX-XX-------XoB---BX------EB---------------X?-X------?---B---XEX-----X------------B--X-XB----o------X-X--X-?---o--o-----oX-Xo-X------MXX-------Bo-XX-?-BX------X---X--------BB--X
?-||E-|o-|-----T-XX-B-EX---------X-B--XM--------X-?---M-?---?-----------------------E--X--BX----o-o--o---o----B-----o----------------?-?---------B--EE--?-------X-o-X-o--?B------X--E-?----B----T-X-o---
m-||--|--|-----T-----o-------oB----EX---X---X-X-X----B-B--M---?-----o--X--------BX-o--------B-XX---------X------------X----XX---------------?--o-------XX-------oo------B--o----o---X-B---------T-X-X-E-
XXXXXXXXXXXXXXXXXXXXXXXXXXXXXXXXXXXXXXXXXXXXXXXXXXXXXXXXXXXXXXXXXXXXXXXXXXXXXXXXXXXXXXXXXXXXXXXXXXXXXXXXXXXXXXXXXXXXXXXXXXXXXXXXXXXXXXXXXXXXXXXXXXXXXXXXXXXXXXXXXXXXXXXXXXXXXXXXXXXXXXXXXXXXXXXXXXXXXXXX
