--------BX?-----B--------?------------o-----B-----BBM----?-------M--?-----------------X-?MBB?---BB---------X-X-------------------B--XMX-----------------------------------------oX----X-------------o---
----------X---XBM----?BX---BBo?BB-----------------------o?X---BBBBoXXBXoBB?---------?X--------BBX--X-B-?-----------XXB-----------------------XBEXB------------?-----BBB?B-?BX----------------------XB---
---------------XBBB------------B-X-X?---------------------------X----M?BB-------oB----BB-----------BX---B--------MM--XXB-----------------------XX-----------------------------BM-X---M---------B--------
-------------------------BBB------B------o-X------E?------------X--?---XX--------M-----------------------------------B-E---EX-----------------?---------------------------?--------E?----E--------------
--------------BB----------X----------?----X------------oX-oB---B---------X-------------------------------------?----------------------X----?---------EB-----X-------------------------------------------
-----X-------------M---------------M----M?--------BE?-----------B-------BoMB--BX---------XXX-------------X---------E------B------o---------B-o--------------------E---BBX----X------X----------oB-B-X---
---?--B-----oXBBB---B-?XX--------?X--------------B--------------------------------------------B-------------------XX-----------------------------------------------------B?XXM--------o-----BB-------?--
X--------X-X-------------------X--------------------------------B-------------------------o--------o--------------------------BXBB?-----------?M?X-------M-------B------o-------B-----------oBM---o----v
----XE----------B---B----------------BB---------------------o-----oX----------oB-----------------------------oBBX-----------------X--------------M----o---EXX--E-----------------------Bo------------EMf
MX-----X?---------o?-BBB-------o---------------oXX---------BBBBBBB--?----?-----BB-BBB--XX?----BX?-------EB---BBB----M--------------BB??XB----BXX----X?----BX?XB--?B-BB-------B----------EB-------------f
-----B-X?---------B-----------------X-BB---------BX--B------------------?-----------------X-----------------E-----X---------------------B?-XBBBX--?------------M---------------MMXX-------XXXX---------f
--------X?B--------------?B---B--B----BXB------M?BB-----------XXB?--E-BXBB-BXX-M?XB--------------BB?M?-???--BB-----B-------B--XX--B--BB---BB----?BX---XB--------B-M----------M-------------------------f
-------E---------X-B-------MX---M----------------------------------?---X-X---X------X-------------------------X----?-------?-----o----------------------------MXB--X--------------oX----?---------BXBX-f
-----------------B-?M---------X--MBXBXMB----------------------------BBM--MBBB-----------------XBB-MXB-MM--X?------------?XX----?MB--EXX-XM-B----------XBBX----------?XB?BB-------BBX--------------BX---f
m--------BM-------XBT---X----XB--X--------E--------o------------------M-------------------?------------MX------B?B?X---------XXX---B---------------------B--------B-?B------XB-------------------------X
---X-------TB-------|X-?-------MX-XBX--------o----------------X------------X---------o?-------------------------------------XB---------X-----------------X------------o------BM-oX---------BX--------XXX
X-X-X-XXXXXX|XXXX-|XXXXXXXX-XXX-XXXXXXXXXX-XX-X-XX-XXXXX-XX-XXXXXX||XXXXXXXX-XXXXX|-XXXXXXXXX--|X-X-XXX-X--XXXXXXXXX|XXX|XXXXXXX|-XXXXXXXXX-XXXXXX--X|XXX-XXXXX--XXXXXXX-XXXXXX-XXXX-XXXXX|XXXXXXXXXXX-X
