--B----?-o----M---------o------E--------E---o--B------B---B--------------------o-------?-|-o-X-------------o-------------------|ToXB--B-------------X--B-----------E--------------------B-|-B--T--------
---o--------o--------------|--B---?--|------o------oX-?-Bo-----------------------E----E-------?---T---B----B----------------B----o--T-----------------o--o------B---Eo-------BE----------M--------------
----E----??--o-B-|oB--------------------------?-------E---o----E-M------E------E------------------|--?---M-------o----E-------o--M----MBoBB------?------E----|--------o--------M----B-|-B------------X--
-----------T---------------------E-------M----------?---------X-----o-----------T-E-------------------o----E----Bo---------?EB----M-----o---------X--------o--------|-------------------?-----B---------
-----------o-------------B-----------BB-----------BM--------o?--?---------oB------B--o---|----o-X--------------?----------------E---?---------------------------E------------X----X-----------B------M--
---?|------X-E-------E----T-|E-B------------B--|---------?-BE-|?---TM------------------o-M--?-------T-BXT-----o-E-----X----XM---------B-----?----?-?--T---------X--------------------------o------------
X---E-----?-o-------------|--B--------------------|-------------------TE------?o-----?-------B-M-?------E------o-----X-B-----XEo----------X------------E-------?ME---------------?--o---------M---------
-------------------o--------------T-------------|---B-o-------------o-------------------T---------o---------------M-----?----X-------------Xo------T-------|---B-B---------------B-----B----------o--|Bv
--------------o--------T--?-----------o-------------|----E--------B---T---M--------B----------X----------M----------------o----X-------------------|-----B-------X--B----?---oE------B----------E--B--B-
-------------------E-----E-M-?-----o--o------------------------------E----?-------?----------------oB|T-----------B---|--E--T----B---o--------------XT---|------EoMX-----o-----E--XT--M-------|-----o-E-
--------------------------------------o-------------o--o|--X----B----X--X---M------------o--B---T-EB-B-?--?-------------o-?----------B-----------------B-------------?---------------X---B----------T---
------B-EEB--------E-----------o--M----B-------BE------B-E-|----------------E-----------------------?-----------------------|o--------------------------|--o---X---T----T---------o----------M-B-------B
--XB----|--B------o------?---E---B----?-------------?---------------X-X--T---------------------T-----------------T---T-------------------------T-----------------|-----------B-------------------o------
T--------M----------------E-?o----B--------B----o-----------------------------------B---------o----M-|----?----------Eo---?-------M------------------------------X-X-------B------E---------------BoM---
m----------E-------|--------TB-T---------------------?-----?------------o----B--------B------M|---T-------------?-?----XE------o----|-------------M--------------Bo-----B-------B--B------------o-oo----
--------|--o----XX-------------Bo-BM-----------o---T---------------o------|B----------------------B--?---B----B-B-------------------------------B------------?-------------------------?---------M---?--
