---E----------X---o--X-X--?----o--o----o-X----XB---?X--o-----X-X------X------X-?-----B---o--X---------?------BXMo--------E----oX--B----------------X-------M--X------o---X?X------------XX-------B--EX--
o-E---T----X--B---X---B------X------X---XX---X--E------------------X-----X-EB--------------X-M-X-B------------X------------?---E---X------------B--------E-------XX--MBX--------E--X--B---o----BXB---EX-
--XXM-T------------X---X--EX---X--------X-X------Xo-oo--EB-----X-o--X---M--------B----X--o-?--E---B-X-?-E-X---o------?--------X---------?------------o--?BoX-BX?-----B--E--X--X----X---B--X-B----X-B--X-
o--o--TX-X--M-----E---E-o--E--------X---X------X?E-?---X---X------------B-----XB---B--------X---o-----X-X-------X----B---E---X--------B---EB--o-o---B----B---B----X-X-----XX-----X----E---o----------BX-
---?--T---B------X-B----------?o---B--X--EX?XX----X-------X--E--------X--X---Eo--B---Mo---E-EoE---o--B-------X--X-o---XX---X-B------X------------X-------B?M---X--X?-----o-------------X---o---oBX------
--X---T----------X--X--------X-----------oXX----B-----o--------B--------------X-M-Xo-o-?----X---B--X--------X--E------o-E--X---------X--------XX-X--X----X------------E-------------B-o--------B-----X--
--XX--TX-X----oE----E-B------X-------------------------Bo-o?------XM-B----X--M--X---o--oX------------EX-----o----B----X--------------X-M-XXo--?-----X---o-XoM------------------X-----o---XX------XX-X---
X---X-T-EX--?X---------XX-XX-X--XE---B-----M-o--X--------X---X--------?-----X-?X---BX-----X-------------X-?o--?-B-E------o-MX-B-X--?--o----X--BX-------------------o--E-------XXXX--B---X----o----X----v
-----oT--------X--EX---M-------?B------------o-X-?----X---XX----X------o---X-o-MX-?----o--o-X-------------X--------E-----?Xo---------E---------X----------------------oo---M-X-----X-------M-E-------X--
---X-MT-XXoB----X--X-X-X--?-----XX-------B---B-X-----------X---------E-------XX---X----------------X-------E-----E--------------X---X----X----?------------XX---------X--E---X---X----o----o--o---XE--o-
--o-M-T---E-----XX--oE---E--X------B?---o-----------------X-----X---Xo-E?E-BE----------------?--------X-o-?-----------o-----XX------X-XX---oXX-B------------XX-----X--oX--M---------??-o-E---------BXoo-
M-----T---o-XX-------X-----X------------B------?o-------Bo-EB-Mo----B----oB?----MX--o-X----X-B---XM-XXo----------------B-X---Xo--?o--o---o----o----?---X---o--B-----X------X---o----B--X--o----XX----?--
-X-Xo-T----X-------X----B-XB----XoBX----------XM-o-X---------------?---o------?X-X-------o-M--------------X-------?---X-------XXo---BMX-X--B-----E------X-X-o----X------X--------?-?--MB------?X--------
-X----T-E-X---o-?-X---------------o--------BB??-?------XXM------o---o--X-o--------?X?-------------E-------------BXXX-X--E----XX------?------B-------X---X---?---X-o---X-X-oXE----B-----B---X-X---------E
m-o---|-?--?--------X---X------EX----o-o--T------------XX--------X---oE--o-E---??-----X-------X-X-o----oX--X----?---XX-X--X-o-------B-----------E----o--XX-----T-B------?-X-o--X---?o-MXTX---X--X-------
XXXXXXXXXXXXXXXXXXXXXXXXXXXXXXXXXXXXXXXXXXXXXXXXXXXXXXXXXXXXXXXXXXXXXXXXXXXXXXXXXXXXXXXXXXXXXXXXXXXXXXXXXXXXXXXXXXXXXXXXXXXXXXXXXXXXXXXXXXXXXXXXXXXXXXXXXXXXXXXXXXXXXXXXXXXXXXXXXXXXXXXXXXXXXXXXXXXXXXXX
