----------M-X--------------------o----------------------E---X-----BB---X--E------E-------------B-X-B----X----------------------------------B---B--?BB-------XB-----------o---------------M--oX----------
----------B?o----M---B---------M---------------B---X----------?----X?-----X---o--------------?---------------?-------------XE-----?------o---Xo--------------------------------------------------o------
----o--XM-------B--------------------o------oBX-----X-----------E-----------o----------------------------------------------------------E----------------oo-------------------X---?-------o----------o---
o--------------------------X-----------------Bo-----o---------oB-o---------o-----------------------?-----------X------------X------?----?--------------------------------?----X-----E----X------------o-
--o---------------X------------X---B-----------------B--------------------------------B---B------------oB-----------------X-X-----------B--?------B--------B-----oE-----------X-------------------------
-----------B------------o----EMo-------------------E------o----------------------MX-----------o---------------------X---------------o-----------------------------B------------E--XB--??----------------
--X--XMBX---------------------X---------B-XB---B----------------------------------------B--o-E---------B--------------?--------X------B--------B---oX-o------------oBB-B--BB--EXMX---------B-o---------B
------------------M----------Xo------X?B-------BM--B-------B--E-----o---X-------------------------o----?B------------------------------o--------X-------X-----XB-------------------oX--------B---------v
-----------M------------------------------B----------------------------------M-X------o--------------------M-------------------?o--------o--X---X-?--------o-------------------------------------------f
-----------?--M---------------B---------o---Mo----------?X--------------------X---XX------X?--------------?--------------XB-----------------X------------------------------MB---?------------o-------o-f
-------------------XBX------------X------EE--M----M-------BX-------------oB---------o---------------------M-----M-------------BB--------------------------B------------B-------------B-XBBM------------f
------------M---B----------o----X--------X-M------?------------B---M---------X----------oX---o-X-o-------------?-------XX-----------------M----------X------------------B---------------B-------------Xf
-------------------------------X--------X------------o-------------------------------o-----------M-E--------------------------------------------------------------M-o---oX---------X----X-o-o--M-------f
-----E------Xo--XM-----B----B-------B-----------BX-----?M--X-------------------B-----------?-----X------X----------BoX?------oB--o-----------o----B--X-----------o----oM--------B-E--------B-----------f
m---------------E-------------------------E---------------------o-----------------?---oB-o--?XBX---------o------B?---------------M-X-X----B--------E-------------------M--------B----------------------X
------------------B-o------X-------------------E------------M----T-----oM-X-------------------------B------B--------o--------X-----?--T-------?------o------E------------B----------------oB-M-------X-X
XX-X|XXXXX-XXXXX-XX-XXXXX|XXX-XXXXX-XXXXXXXXXX-XXX-X-X--XXXX-X-XXXX-XXXX---XXXXXX-|XXXXXXXXXXXX-XX-XX-X-X|X-X-XXXXXX-X-XX--X-X----XXXX--XX-XXXXX-XXXXXXX-X-XXXXX-XXXXXXXX-X-XXXXXXXXXXXXXXXXXXXX|XXX--X-
