X---------X---o--o-B-M----T---o---E----B---EX-X-------?-X--------X---?-X--?E------------B--XM-----X-?X----X----Xo?---E--EX?-E----B--------oX-T-o--BoX----------o-|--o----------------XXE-oo--------EE--E
---X--T---X----M--E-X----T------?--B----EXX|o--X--X-----X--B----o-X-M----Xo|-E-------Bo---------?--X-X--|--XM------X--------X-o----X-X------oo----XXB-X----X-X---------B-?-X---o----X-M----E--------B---
-----X|X--X-X--B--X?---------XB---------|--X----XX---B-?|------E-----E---??XX-------------X------XXo--B-oXB---o--B-T------------XB---?-X---M------?-------B-------X------X---T----oX-X--T--Xo----o-----B
---Bo-|---E-EM--------------?------------TX------------o--T---------T-X--XX-------XX---E----?---------X------------X--X---------XB---o-o-------?---?o---------X-----Xo--XM--X---XX------------X------XX-
oB----|-------------X?--E--o---X-----------------B-------X--------|------E------------------B-??E--X|----------------oo-X-o-X|--X---E----XX----B-E--E--------XEXXX---?X---XBX-X-------?-----B----?ET---o
------|--o-X?-X-----------o-----?----E----X---|------o-----X------------o-X-----B----XX----X-B-----XX-X-----o----X------------?--oX---X----X--------B----EoX---M-oX-XX-X--------B------XTE-EE--M|-M-----
X--?-o|-----------M-----B-----o--X--X?----BM--o--MM-X-oX--??--------B---o-XE--------E---X-?-T--o---------X--o-?--------X---X----??-------o-----X--|--------------X--X---o|--M-------XB--?X|-----?-E?----
-E----|B-E-X---X-X----?X----X------E------XXX-----oX--E--|-----B---XX---E----o---?---XX-------E-E---X---X--------M---X-----o----------X-------o?----X--------ooX---XEoX-X?-X---X-E?B----E------o---X--Xv
-o----|XX-|oB-----X---Bo-B----X--|X-------------E----X--|--X------XX-----Xo-X-B----B-------E---X------o-----B-B-----o---------X--------TT--B--------------------B---B---T|------X--B---------X----------
-----X|-E---XTT--------oB------------X-X------o----X----?-------B-o-------o-------X------o--?X-----B----------o-------B----X------|---X---?E--|-------------------X----X-E--o--B--XX-X--o--XX-------X---
X-X--X|o?-E---oX---X-X------?---------X-E--MB-E-----X--E-X--X--|X---XoX----oME----oo-------M--?--X---------------o--E------X-T-----E---o|-X--EE-------------------------X----T------B---E-X---X--X-X--E-
XXo-X-|-----B---XEo-o--X--------X---XX-X-X----o--------------------?M-------oX-X--X--------E-----|-X---Xo-B-----XX--------?---------X-------E-M------|-------B-B-----X---X------------B----X--E---------
---?--|o-M---|--o----?E----B----B----E-----B-----------------B--------o--------X----B--?------B-------X--------------------E-X----X--------?-XX---X--X--B---X------------M---X------------E------XX---|X
X-----|-?|--B-------X-----X---E----o----oooE--X--X---XE-----X----?o-----X-X---XX-XE---M---EX-oB----X-X---BT?--X----X------|--MX-------------oo?-E---X-----X-------X-------X-X------XB------E------------
mX-XX-|--|M--o-X-M-X--------XE---XBX---------B----B----X--XE-----X-E----M----B?-------B---M|-?--X--------X-------X------B------X-oB-X----?--M---X--TM---E--X--?X-----o------X------B----B---B--o----|-B-
XXXXXXXXXXXXXXXXXXXXXXXXXXXXXXXXXXXXXXXXXXXXXXXXXXXXXXXXXXXXXXXXXXXXXXXXXXXXXXXXXXXXXXXXXXXXXXXXXXXXXXXXXXXXXXXXXXXXXXXXXXXXXXXXXXXXXXXXXXXXXXXXXXXXXXXXXXXXXXXXXXXXXXXXXXXXXXXXXXXXXXXXXXXXXXXXXXXXXXXX
