--------------------------------------------oX-------X--------B-o--------------BBBXX?X---B?--?-------?BBM?-----B-------------BBoX--------------MB-----BMBBBBB--------------------XB---------------------
--BBXXX----EB---------------------M??BM----------------oB-------XB-oX?-EMX----E-B---BB--------XBBXX------X??-----X---XX-------------------BBM-----X?B--BBBX---MB-X-----------------?XM---??X------BBXBB-
--------oBX----BXX--BMX----------BX--------------------X-------o??X-BXX--------------X--------X-------------X--------BMBXBB------??XX----M------------B------E---------------B--BX?--------XX-----------
---------XB----X-------B----------MXX-------XBB---------------B--X--E------------?------------X----------------------------------------------BB----------------BBBBB---------X----M?X--XBB--------------
-X?--?BB---------------------------------XBB--------XX-----M-----------?-----------------------------X---BB----XB------oX?---BBB-----------XX-----------------XBX--------?MB----------------oXB---------
-------BX-----B?B---------------B-------X----------BMB----------------BB---o------------oB------------------------BB----E-------?B----------------o-----?MB---B----------oBBX---------------------BB----
--BB?BBB---------------------------XX----oMXX-------BBB---BBoB-------------X------X?BB-BX-------BBX---XXBB----BXBX?---B?--------------------------XBMBXX---------------------------XXXX-----------------
---B--------------------XB-----?B--BX---B?M------------BX--BXB-----------XB-----------B----BM---BBB?---------XXX---------------------oBBX-------------?XM-?-------BX-----------------------------------v
--B--------BB---------BX------------X-----------??B--------------E?XX------------?oXX---------MX?--oX-----------o-BBBBB--------------XX-----------?------o-----------BB-----?----XBXBBX----------------f
oMB---MX?---------------BB----B------?-----M?----o--------------BB--------------------------------BB----BB---------oX----------------------------------------------------------XX--o-------------XXX---f
----XXBBXB?BX?BX?M-X--o------------------X-------oB-------?----o----------BBX---------------Xo------------------------XXM--XX----E-------B--?----------XX------XBB?-----M---B-----BBBBBB---------------f
-E---------------BX?BB-----------XXM------------oB----BX---oB----------------------------XB---------------------------------------------E-----X-----------------------------------------------------B?-f
-----------XMBM--------BX-------------------------------XXX---?X---?X-B??B---------M----------------------B---?MX--------------------X----??XB------------------------B?XB?M----------XMBB--------oBB-?f
-------------o?XX----XBBB----------------?X-TBXX----------XXX--EB?------T?--------------?-----------XX--------------------------------------------------?-------------------BBX--XB?XB----BXX-XXX------f
m----XXBXBB--------XB-------TX?-TMBXXX------X?BB---T----X--XX??X------EXX---------T------XT---XB?---oT?------XB-XX?BXMB------X------XB---?--T-?XB--XBB-----TXXXBT--M------------T-BBBB-----BB--TBB---MBX
X-MB?BBBXXXXX--XXXBMXXXXBXX-BXXX|XXXB-XXXXXXXXXXBX-BBXXXXXXXX-BXXXXXXXBBXXXXXXXXXXM-MBXXXBXXXXMBXXXXXXXXX----BXXBMBXXXX?XXXBXXXXXXXXXXXXXXXX|BXBXXX?XXXXXXX?XXXXXX-BXX--XXXXXXXX|M?-XXXXXXXMXXXBBXXMBXXX
