--------------------------------XB-----------------------------------??----------oB-------------X---BX----MBBXMBX--------EX------------------------o------B--------------------M------o-------------M?--
------oBBBBBBX---------------------XBB-XXBB--------MBB----------XBMBB---?oM---XXBBBX------M--------------------oMX-----ooB--------X-----MM---------BB------BB-?--BBB------------X---o-------------------
MBX-------BXX--------E----------------------------------E---------------------oX-----o--------------X---------X-----------------o-XBB-o----M-BB--X--?B----o---------------------------------------------
----??B--------------?---X?----------------------o-B?X-----------oM---------B---X--?-oMBBB-------?---?XXX-------XB------oX------BX-BMMBX-----BM?-------------------------------o--------?--XX-----------
---------------------------------------------------?X--------BBB----BBB---B---------------------B--BEBB-X??----------------------BX--B-------XX--???------XX----------oBX--B------------------B---------
-------B--------?X---------MBBMM--------XBM-----------B---B?--------BB-------BM---------XXXB-----------------?XX------------------------------------oM?B----------B-----B----BB------------------XXX?---
------------------------XBXXX?--?B-------------M---------------------XB------BX?--BB-----B----------X?-----o?---X-BB---------X----------E?X--XXMBBB----------X----??XB?B-BB-----BXB----B----------------
----------M--------------XM--XX--------------------?X-------------?B-----M-------XE--M-------------------------------------?----?--?------M----XBB-?-----------oBBB---------?----B----------X----------v
XX----------------------oX?X----------------X?-----E------------------o-----------------------------------X?-----XE----XX?XXXB--XX-?--oXBX-XBX----------XB-------XBBB------------------------------o---f
---------------------------------?BoX?------------------XBMM--------?B----o-------o-------------BBBXMB--------------XX-----------------------------B----X-----------B?-----------------B-Xo-o-----B--?-f
------??XB-----X?XBMBB----XX?--oBBBBBBB?------------------------X----X-------BMMB------------?BBo------------------------X------------------------XXX---o?o------------------------BoB-----------XM----f
-----------------BBBX------------------------o---------------------------------------------B?B--XXB------------------------------B--------------MB-------X-B----XB---BX----------o----------------o----f
---------BB??-----------------------------o-------------------o-BBX-----------oX-------B------------------X-----------------------B--XoB-X------------------?X--?B-------?---------XBX-------?--X?-----f
-----E---X--B--M?X--?XX-------------------------?X----------------------------o------------------?----------oXBB-B-------------oX-----------X----------B------ooX--------------------------X-------o---f
m----BB-M?------------------------------------B--oBBB----------?MM------------X--------------------X-------------MB?oBM?o---------XM----------------?--oM------B?B-----------o--X?X----------B---------X
-----B------------------BX-o-B-------------B-B-----------------------------------X--X------?XB---------------XX--X-oB-------------------E--E-----TXXX---------------------------M------------T-X-------X
XX-XX-XXX-X-XXXXXXXX--XXXXX--|XXXX--XX|XXXXX-X-XX--X-X-X-XXX-XXXXXXXXXXX-XXXXXXXXX|-X-XXXX-XXXXXXXXX--XXX|-XX--XX--XXXX--X|X-XX--XXX-X-|-XXXXXXXX--XXXXXX|X-XX--XX-X|X-XXX-XXXXXX-XXXXXXX-XXXXXXX--XXXXX
