--E---E-X---E--------X---------------XT-XT-o---X--------?-------??--?-T--T--------X------o-----TTo-E----TX--?--X------T-E-X--X----X?o--?----------?Xo-B----X-----o----ME--------X----------X-----X---MX-
---X--TEX--X-T----B?----------?-------X--|-T-----o-BX-X---X---XXT---|oT-B----XXo---X-oTo----BX--|X-X----|TX------------X--Xo-X------?-o----X-T-T---T---o--X-X?-XB--------oX--X-?--o-o---X---X----X---Xo-
--Xo--|T----X|----------?---?oM-o?-X-------T----o-o-B-T-o---o---|-----XX------X----X-XT--------B------X-XXo-----?----EX------o-X---X-----X-?B|XT--?|--X-----E---X-EE-X-----X---X-------X--Xo--M------B--
?oX---||--?-------??XX--E-E----X---?-------B---oX---?-T------X-X-o--X--X---T-X?X---X-o---------X---?-X-Xo-X---o--X-T--T-------X--T----X----TE-----B-E--X-------E---X--X-??-----X---oX---X----X--------X-
-----X|X---o---------o-------B-o--M-----X-o??--X-------B----------XXE-E---o|B--B--X-X----E---X--o-o--o-T--------B--TM-|-----o-X--T-X---Eo--T----------------------B-o-XM--X-X---B-BX--o--------B-X-----X
------|-----------X-Bo---XM-XE-----E-T----T-----o----------E-XX-------o-----T-X--o---B----?X--X--XE----|--X-X---------B------------M---o---TBo-B----B----T-XoM-------X----B-------------X----M---X------
---X--|-------------------B-X------|-TX-X-oo-----X-o--X------M--o--X-X------T---oX---XX-X----M----M-BX---X--X---X--B-----X---X-B-----MB--o-|--?X---X-----TT-?--T--X-------|---T--T----?----?M-----------
-X---X|---o-----o---X?M---?-----------T-X--TB--E--XT---o----o--X----------------X-X-----X---X-o-------------X-----B---------X-X-o-X----------XX-oB-X------|-Bo-|--T-X--X-B--X-|--|B--------------ME--B-v
------|---oo---T--o-------X---X------XT--X-ToX--------o-----------------XT----E----X--X------TT--M----oT--X-------X------BB--X?E--o---T-B-E-----TXXX------o--X----T-MXB---X------B--o---------------X---
------|oE------|---?-------B-X-------X--------o?----E-BB------X-----TX--X|--B-------X---M---XT|-B---X--TXoB--------------X--B--M-?----T---------|?o-o----T----------X---------?-----X--------X---X-B---E
------|--oX---X-----o------Xo--B------E-EBB----?-----EX--------E----|----------------------------------B-Xo----------X------X-------E--X--o-X------E-----|----X---E------Xo-------------o--X----X-BX--X?
-----X|--oX-E-----------X---T--M-XE-M-o-------B------oE-oX-X------X----o---------X-B--?XX-E---T----B--X----X----XBXX-----B----o-X---BE--------ET-----o----o---XX---o----X-X------?-----B-----XEo---|---B
X--X--|X-T-XB-T---B------B--T----o----XB---BX----o--M------?-T--oo-X--X---X-------------B-----|X--X-B-------------?|-----XE----?---------T---?-|-?---X--XX--X---B-B----o---X---X-o--X------------------M
-B?---|-X|---oT-M-T--?-o--E-TB-o---X-------------X----B-Xo---|---X---B--oX-oT--?--E-X--o--X--?-|---X----E----M----X-X----------------?---|----------o---B----X-M----B----X------X-XX---------X---B---M--
m-----|--|--X-----|----B-X------oX-?----Xo--------------XX----X-----------XX|--B----X----?----------oX-----------X--X?----X-----oB----o-oo---------?-X--B-o---B-B-----X----XoX--------??---BEo---E-X---X
XXXXXXXXXXXXXXXXXXXXXXXXXXXXXXXXXXXXXXXXXXXXXXXXXXXXXXXXXXXXXXXXXXXXXXXXXXXXXXXXXXXXXXXXXXXXXXXXXXXXXXXXXXXXXXXXXXXXXXXXXXXXXXXXXXXXXXXXXXXXXXXXXXXXXXXXXXXXXXXXXXXXXXXXXXXXXXXXXXXXXXXXXXXXXXXXXXXXXXXX
