-------X-XX-----X---X----?--------?B---o----X--X--o-?-----B------B-X--------B------?--E--XX--o----X-X-X--?----------XX---MX--XB-B-o------X-----X----XoX--B---------X-B------------MX--M?---X------E-----
o----------XX---XX-----M-X-----------EBo----------XX-o-B----?--Xo----E----?--X-X-----B------M-?---------o-Bo------------B----o----X--o----B--o---X----------X--X?oB??---X-X---E-------XE--------X-X-BB--
--X-XMXX---E---M--oEo-----X------o---X------X---X--X-?-----B--oX-------X-----X----XBB--Bo-X---XXB-X-------X--B-X----?--MX------------X----E--------?-----o-------?--X-------?--Xo----Xo-B-----------X--o
o---B---X-Xo----X---------X?-------X-B--X---B--X-X-BXX-B-B--o--X-X--Xo-------E--X-B----X----X-E-o----X-------------------o--------?------BME---?X-o--oEX------------------X-----oB---o----XE-----X-----X
--E---------------X------E---E-B-?------X------X-X-?-------------Xo-----BB?---oEX---?X--?-?o----------X---------------X----oB-----B---Eo-----X--X?--B---?o-X---------X-----X---o--X---------B--EB--Bo---
---------------X-----------------o--o---X-o------------M-E----M---------------o-------XM-------?-----B-----------B----B-X----B-----B----o-----X--o----o---o-------X-----X--o--o-------------X---------?-
X?B-----X----o-BB--o-X---?E----E-----------B------M-XX-----X--X--E-o-----Xo--------B---E-M-----X-X--oo-X----X-X---X-oX----------------------X-X-----------E--------E----XE--B-------------E--X-------X-?
X--------------?--MX----B-------------------X----B----XX------?X----B--X-------o---------o-X----X--?---BM-----X---o--X------X--------Xo------XX---X-oX-o--------E------X--?E---BX-XB-o-E------XXX----XMv
--?-X-X----BXX----o-X-------X-------o-----------o-----B---------------?-E--?---E----B---X----X------X-B--B------oE-B-------X-?X-X----o-----EE?-------------------------------X-----o----?-M-----E-------
-------?--XM--------X-------oX--------o--EBM--XX-------------XX-------B----?-X-o?-o-EoX--B-----EX-----------X-B-EMo--o--------------------X?--X---X--XX-------XX-o--?-X---X--X-o-----X---B---X-----XX-oX
X?--oX-M-------------XB-----------X----X------X----X-------------E---------XX-----X---E------------E-X-X-oo-------o-B------B-----B------XEo--------X--X-X--??---?--------?-----X--XBX-X---B--M----------
X-X-EX------------M-------?BX-?------o-X---X---B--X-----B-------?-X---B--o---X-------------E---B--X--------XX---------X--------BXX----------X------B-----B------X-------?------------XX---XX-----X----XX
------XXX----XXo--------X-X-MEo-o-----oB-B----------MX-?--?-oX----EX-------------B-X-X----oB-----E------Xo-X--Xo-------XX-B---X------E----oB-------o---B----?---X------------ooXX--X--?-B---------X--X--
------oX----X-------X--o-X-----------XX-------------o-XX-X-------oX-B----o----X-B-----E-M---B-X?o--o-----X-X--------X-X------?------------o--------------E-o--Xo---M-X------oE----X-----M--X-BX--X---X-X
m-o-X------------X------XXEo-Xo-----M-B--|o--B---------Xo-------o-X---o--E--M---?B--X----X-----X-o---?-----X-XX----Xo----X-----------X------X-----X----T--------??-B-E-o--X--------XX-o----X-----X----o-
XXXXXXXXXXXXXXXXXXXXXXXXXXXXXXXXXXXXXXXXXXXXXXXXXXXXXXXXXXXXXXXXXXXXXXXXXXXXXXXXXXXXXXXXXXXXXXXXXXXXXXXXXXXXXXXXXXXXXXXXXXXXXXXXXXXXXXXXXXXXXXXXXXXXXXXXXXXXXXXXXXXXXXXXXXXXXXXXXXXXXXXXXXXXXXXXXXXXXXXX
