-------------------M------------?-B---------o----BX-?X--X--------------B-----M-----o----------------------------o-?-BBX---------o-------M---------X-E----------------------B--MB-E-----MB--XXM?-----X--M
-----------------X?-E----X--BE---------B----------Bo-----X-----------------------o-------oo--B--X-----B-------------o------------------B-------B--?X------B---------?------------------oB---o-M---------
-------M----------?BB-------E------E--------B----------------M---B----B-----------------------------------B---------oX------B---------------------------BoB---------X-B-B--------X---E---------M-XB-----
---------------------o----------------------------------?-?------------o-----E---o---------------o--------------------------------?-------------?-----?----------X--------------X-----------------------
---XX-----M-------M-X-----------------------oBo------o----------X--E---------------E-B------E-----o-B------E----------X----------------oXX-------M------X------------X--X-----------------o-------XB----
----------------------------o--------------------------------------------------------X-----?---o----o-----------o---X-----E------------X---o--------o----------------Eo----MB--------E---?-------o?-----
-----o?B--------------------------B---------X--------BXB?---------------------MXBB---------XX-------------B--------------?-B-----------------o---------?------?M------??BB------------------------------
-----------------------------------M-----------oo----X----------o-----------B--X-------?------o--------------------oX----------X-X-----?---E----------B-------------------------M-------B-----------X--v
-----M---------X-----X--------B-----XB------BX-MX--------E-o---BX---Bo-----?---E---------------BM-----------X------------------o-----oB-X--------B----------B---------o-BBB---o---------?----o-----??-of
----------o?-------------------------------------------------oB-----------------X------BB?X----------------X-----o-------------M---------BX------------BB------X-M-------------X-----------B----------Xf
---------------------------------------?---B---------------------------B-MB---------------------------X--------X------------XM---X-------X--------------------X-------B-E----------MX--X---o--------?--f
----------------B------E------oMM-XBo---oX------X------------BX------X-----------?---XB-----------?X------------------BB-?B-------?----------------------M----X-----------------------?X----MMX---XX---f
-------B-B---M------MB---BM----------B-------?----------?B--------------------XB-----?----------------------B-------------?----B-XMX?o--------o---?-B-----------MX-----X---B-------EX--X--?----------oMf
-----------?----Xo--------------------------B---E------X---oMTBBB-o--X-?----X------o-------------XMX-----X?--B------------M-?-----B----------B-----------------------E-----X------BB--------B----BX---Xf
m-------X----X--o---X--------------------E------X-----?-----M|------X--T-T------o--X----------------------o-----------o---------E----MoT----------------------------o----------o---o--B---X-X----------X
-Bo--XM--XM-M-----M--X--T-------------XB--------o------T-X--oXX--XB----|-|B------T--------B-------B---------BB----o-X--------o----X----|--B--X----------------------------------------?----TX---E------X
--XXXXX-XXXXXX-XXXX-XXXXXXXXXXXXX--XXX--XXXXXXXX-XXXXXX--XX-|X|X-X-X--XX---XXXXXXXXXXXX---XX-XXXXX-XX-XXXXX-XXXXXXXX-X--XXX---|XXXXXXXXXX-X-XX-XX-X-XXXXXXXX-X-XX|XXX-XXX|XX-XXXXXXXX-XXXXX|XX|XXX--XX--
