---X?--X-X----X--X------E----X-X-XX---X-o--------?--B-oB--oB-----------X-------X-X-X----------X-B-E--------?--X---------X----X-oXX-o--X-X---------X--o--B-----X-----------X-----------------------------
------T-X---XE-?---------X?----X------------o-X-o--o----?-----B-M-X------X----------E------X-X------------XX--oXX-----------X---------X-X-------------BM----------B-X-B-XMo---o----B-o------------X---BM
------|----E-B---?----o------------X-X--oo--X--XX-------B-----------XX---------o----X--E--X------o-----------X-------X--E---X-----B----X-----X---o------------o-o-----X---------X-o-X---X?------X----?--
B----B|XB------------X--------B--------XE-o-----E-o-o------MoX---?B---------o---------X----X---------E-X--X-o--X-------o---oX--------------XX-----?E--------?----?--o-?--?---?X---XBXo--X?-------X------
------|EB---M-----------ooX-------------------------------oE-E----------B-?X---X----------XX-------------E------------------o-------?-o--X--?------o----X--X----E----o-------------o-X----E-X-E--oXE--XX
XMX--M|-------X---E----------BXo---X--X---?-----------X-------?-----------------?XX--------M-----X?MB---XB-o--o---B---EXX-o--X---------BMX-----BB---?---E----X----XE----X---X--------------X----X?---oX-
------|X---B-X?----E-X-E------E-oX--EX-B--Bo------o---X--BX-X---------------?-----------X----XX------?---X--------XX-XM----B-----X--?-o-oB-X-?---X---o-o---X----B---o------------X--B--X--M-----E--X----
-----X|X-X------o------X---B-Mo------o------XB---?o-----?-o----BB--X----o-E-------E---------B-------X-o-------E--o--------?X-------X-----X----X----?-----------------o----------B---------X------XX----v
-----?|---------T-E-X--?-------XX?X----B--X----------X----------------o----------o--X-M--X-XX-----E--?--o---o--o------B---------X----Eo---------X-X------E---Xo-XB----o------XX-BoX------X----o-X-X--XB?
--X---|--X---E--XX?-XXX----E--B------M-----XX--------?o---X--X----o---XE---X-------X-E--------B---------X----X-X---?XX-------XB---X-X-E------X--------?---------X--------XXM--X-EX----X-X------------X-o
X-----|-------X------M--B------o---------X--o--------o-----M-----X-X----------B-------------X-B-------X-X------X--X--E-----E---o-X-?----M---o---XX------o---X-X----------o---X-oX-----X-----------X-----
------|--B------?--o-M-----XM---------o----------------X--M---X--------X-----X-------oo-----EX---oo---o---M-B-----o-?---X--B-oX--oX--E------------B--B---------o-----X-------X------X--X-oM---B-E-X-X---
-----X|--T-----XMX--X-X----------o-------XXo---B----B-o--------------X--------X----?-B----oB-X---o--X---MX-X----B------X-X------BB-X--M---X--E?---?-----B----o-----o-------?-o-?o----------E-X----o----X
-E-o--|-X|o----------X---X-MX-B-----T-XE----o-----o---o--E--?---------------------o-----Xo------------E-------XX-----X---?-----------o-----X---?--B--X----X------X---X-E--X-M-?--BXE-------MoX--X-----E-
mX-T--|--|X--X----XBE--BM-E-o------o|?-?--B------E-?--------o-X-TXE-X-XB------XoXX---------oE---------X-o-B----?-E---X----EB----B-o---oo-BE--X-TB-------o--XXE-o-oX-X-X-------B--o----X---B--X---XX-o-B-
XXXXXXXXXXXXXXXXXXXXXXXXXXXXXXXXXXXXXXXXXXXXXXXXXXXXXXXXXXXXXXXXXXXXXXXXXXXXXXXXXXXXXXXXXXXXXXXXXXXXXXXXXXXXXXXXXXXXXXXXXXXXXXXXXXXXXXXXXXXXXXXXXXXXXXXXXXXXXXXXXXXXXXXXXXXXXXXXXXXXXXXXXXXXXXXXXXXXXXXX
