--X-oXoE---?----X---X-B---M----E-X----------X-------B--X----EX-----------Xo--------X-------X---X---------oE-X---MEM------X-E-o---oX--XB---?-E-------------X-T-XX---------B-o--?X--o----oBBBX----X-------
------To----o-B-o--XXT---X-----X---o-M-o--?EX-TTMBoo---E------o-X-XMX-------B-------X-T-o------X-----M?--E------XX-M----o-----XE-----X---------------------XT----------------E-XTX-----BEo--------X-Xo--
o----X|--------B-X--?----B------?----M---X---o------o-X---------XX-M--B-----X---X--X---X--X-B-X---BX----X-o-X-M-B-----B--------o-o---?X---o---X-------------XX----?--X--T------?-------X-XB---Bo-----oXX
--B--X|-------------o----X---B----M---TB----MX--o-----------X-------B-X-?-o------------T---XX--T-X--------B-------o-X--------------X--------E-Xo-------T---X---X--oX---o-------B-o------o---?----X-B----
B-oE--|----------B--X-----X--X----o-------B--TX-MXX-o--oBB---------EB---------------XT-----Xo----------E-------X-E------o-T-?-o---X-----TX----T----TX-----B----X-X--?---X--------o---?----------?-------
?-XB--|------?M----T---X-----X--T-M-XX---?-o?-BT-------X---?--X--XX-----T-----------------o----XE--?--X------X--?---?---X---X?--Xoo-------------X-------XX----X-----X----?-M--T-?--X--X--T--------XE----
-----X|--M-----------XB----?-oX---------------E--X---X---E-XX--X-----Xo-----T?---X-----E-----------------XX--o--M----BE--XB------o--B-?----------E--X---B-----------------------X-Xo---X----?------X----
X-----|-?X------X----?------X-------X----TX--X-X-B-X----------------XX---------X---------T-----B--XB--o---o-----------X-------E----o-------B---B--T--------o-o--T-----------X--------o-XX--------------v
---X--|---B-?E-TXB----------TBo----?-T-----------X?----T--o----X--Bo---X----------------X-B-B----XB--------T---E----EB?XX-o--T------X--B---B-------X-------?-X-B-Eo-o?-----XXX---o-----ToB---X--oME--o-B
Xo----|-----Xo-----?---o-X-------------------o---T----------------o----------o----o-E------X---o--?--To---B-----Bo---XX-X------?---BBE-?--X---o-----MM-X---------------o---X-X-TX-X--?o-?----X-B-----XM-
------|--XE---X--------o------E--o-----B-----XX------E-o--BX--------?-----o--X-----------BE----X----------M-MM---X----------o---X--XX-E-?-------M--------Bo-oE--oX----oT--------T-X---X-?---B---------T-
------|-B-X-M--o-------o----E-----X--?B-B---------T-------------X----------------X---o--X--oXXEX-B---oE---E-----EB?-------XB---B-------BM?-------T--X--o--X-E-oX--X------X-o-----B-----X---X------B-?---
------|--T---X-----T--o?-----XT---?--X----MoMX----------X-X---o-X---------B-----------XX-----B-Xo-----------o--X?----?o-o--MBX----X--B--------o------X-------E-----XX----------X-----X--?------X-o?---X-
----?-|X-|---------------M------X--------X------EB-------------M---X--T---EX--X-X-X----XX-o---TE---------X-?----B-X--B-----BX--X?--X----X--o----Xo-X----------B----o-------X---XX---E-X-----oo---?--X--X
m---T-|-?|--o---XB----------B-o-X-X------X------o-------X-X----BE--|B-|-o-o--------o--X-X--o--T------X----X-----X-------XE-X--------X--X--------------X----X-M---------------------X--?---X-o-ooX---|?-B
XXXXXXXXXXXXXXXXXXXXXXXXXXXXXXXXXXXXXXXXXXXXXXXXXXXXXXXXXXXXXXXXXXXXXXXXXXXXXXXXXXXXXXXXXXXXXXXXXXXXXXXXXXXXXXXXXXXXXXXXXXXXXXXXXXXXXXXXXXXXXXXXXXXXXXXXXXXXXXXXXXXXXXXXXXXXXXXXXXXXXXXXXXXXXXXXXXXXXXXX
