-------------E-------?--------------?-?-EXX-B-X----TX-ooEo--M-E--E?--X-E-M-|XBX-------X-M---XB----T-----------------|B-E-X-----------------M---------BX-----X-------|-|---X?-----E--EX--XXX-----X------o
X---B-TE-------X------X----?---------?-----X-----------o---T-B-----------X?--?-X--B------------X-------------TB-------------XX---------o------------X-?--X---T---oB----|--X--?---X--------X----------o--
X--?--|o-X------------------------XX----E-------?------M--X|-E-------o----X--o-oX--?E-----?B-XM-------X------T-X-B------T-----X-------X--BX?-o------X-----X--T------XX----------BX---TXET------B--X-B---
--Bo--|-----XE--------X--o----B-X--M---B--------------------X-----X----M---X-o-oXX-o-oX----------X------?-X-----X--E----T----T-----M--o---M--X--M-B--------X---E--------X--X---------|-B|---------B---E-
-?-T--|-----------X---o---T----X---oX-?--------X-oo-T--?-E----X---XX---T--o--X-XX----X----o--------B---E---X-T-----TB--------T--X--X-----------B--TX-T--o--o-----Xo--------X-X--?----------B-X--XX-X-X-?
----XE|-------Xo-------oo-|XEXXX-X--X--M--X---------T----o-X-M----X----|-M-X-----X----o----XX---------Xo---o-T-----TM------X-----X--BB--o-X---E---T--|-X-X-X---XX----X--oX----------X--XX---E-------o---
o--MX-|-o------M?XX----Xo---------T-oX-X--B-X---B-?---X-----X-------o-----B-o-o---XX--X--X--o---XBXX-------X----------XX-------EX--?X---T-o--------X-------B-?-E-X------E--X------o-T-X--M--X-B-B---o---
---M--|-X-------E----X-----X-X----|-----X--------o---o-XX--X-----X--------E--E--o-------o-?-----EX----X---------X--X--o-B--------T------T------X-X--?-----o-------X---------------o?|-X-o----------B---v
X--o--|Eo-X-------EX--X-----------------M-?----X--------o----B----B-----------------X-X---o--X-----o-------T--------TX---M-----X-|------o---T--B-X-oB-------------X--o-------BT--------------o-?oo------
--o--X|X--oX-E----------B-oX----?--------T-------------X-X--ToT---X------Xo--X------------B---------oXo----|------B-T---------BB-X--X--Mo---T-X----MoX-o?----E---?E---X----X--TX----------------o-----o?
------|--T-?-T--?X---X-----------X--XM?-ET----M--TX-B-X---B-|-T-----------?--X-X---X---X---X--B-----B---X------?-M-----X--BoXBX--?---E----TB--B----X---X-o------E---oo-----o-X--X--XXX------o-?XX-X-X---
--?X-X|--T-------oM----B--B?-X-----o--ME-?--XB?-o|-M--Xo-XX-----o-B-oT------------E-------oX-------?--E--------T-o-------------?----X---B-TE------?---X?----o------X-T-o------T---o----BB-----T|--------
--Eo--|--X--EXX----X----------B-XE--X----o-?TX--E---E-----X-?-?-X-o-BT--X-EX-------E-----B------------X--------T--?-----------B-------oX-TE-?-o---B------X-MT-----o-XT-----XB-T-X-oX--X----EX-M---------
-----M|To|-?-E--X--X--o---XX-----------X-o---XX?--oX------M-B-?---------X---B----X--X-o-X-o---------------------EBXE------B----?-X----X--T---XT---B------M-XT-----T-XE--M-M-----Xo-BB------TT---o---o??-
m-E---||o|XE----T--o---------X-XX-X--X---X---X---?-----B----?-|------X-M---X---------oX---X----o----o------B--------?--------B-------B--------T-------X---?-XE----|--B-X---o--BX----M-BX----|o--M---|---
XXXXXXXXXXXXXXXXXXXXXXXXXXXXXXXXXXXXXXXXXXXXXXXXXXXXXXXXXXXXXXXXXXXXXXXXXXXXXXXXXXXXXXXXXXXXXXXXXXXXXXXXXXXXXXXXXXXXXXXXXXXXXXXXXXXXXXXXXXXXXXXXXXXXXXXXXXXXXXXXXXXXXXXXXXXXXXXXXXXXXXXXXXXXXXXXXXXXXXXX
