-------MX-------------?BB?---------------XXB--------o-------?B------X?B----o-------BXXBB----------------XXBX-------------------------X-----------X---------------------------XB?-BM---B?B?--------------
XX-----?---BB-----------------?B--E-------------------EX----?-------------oX----------------oBXBBB-------------B-------BXB----------------XX-------------oX------------------------EXX------------------
ooB----------------------BBBXX?-------------X-------M------BX-------XMXB-----------XB?X?---------BX-------BBBXB---BB---------------------MB-BBB----------------XBXB---------------------------------?B?-
-------------------------BX??XBB?X-----------------X?----------XXM-------o?-------------B--------------------------?BBB---------B--?---XX-------------X?XX?-MX-------------E?XX--------?----------------
---o?M?---?B---------B------------BXB?-----XX??BMB----XM---B--E---------?X---------------------?XX---------------B------BB------------------?MX--------XXX-B----------o?-------------------------X--?B--
-----------MBBB--------------BBB-XB-BB--------B------XXB---B-----?XXBXXB-----------------------X-------BM---------------BX--BXX------------XXBB-------MXXBBB------------------------------------------BM
-M-------?XMBBB--XXMM-X---------------X------------X--MXX-BBB?X------------------BXMB--------MBB??X----------------X?BBB---------?-B---BB----o-------------BBX--------BBBB-----------------EX?B?--------
-----------------X---------BBBXBB--X--------------------BMM-----oX----------------B?XX-----BBB--------X-------------B--------XM------Xo------------------------------XMB-------------BBB-oMB---oX?XB---v
--------MXB--BB-------BBM----------??-o?X?X----------------------MBE?---?BB--------------BXXX---XB?BXB-----------------------------?X-----------------------------XX-?XX----------XM------------X----XMf
------------------------------------BB--------------BB----B----------------Bo?-?----?M------??XXX---------?o?-------------------------M----------------?X-----------??B---------XM?BXB-X?XM---X?X---?--f
----------B??BBB?-----------------------------o?-------------E----------------------?BXB----B---------------------BB-----o?----------------o??------------?M-----B-BB-------?--XX--M--?--X--X?---------f
------------XMBBX---------------------XBB------oBM----------------------------------o------MM----------------------M----XBX?------BXB-------BoB------------BB-BBBBM------------------BB-------BoBB-MMB-f
--------XB----------MB?MB---?XX??-----------------?MB-------??-------------------------M-E??M---------------B?X-----oB----------M?------BXBBX-------------BB------EBX--------------??MXBB-BBX-X--------f
----------------XB?XB------XEBXX?XXB--------BXBX----------B?X---BB--o----MX--------------BBB-------------------------X--MX?----------?--------BXBM------?B---XB?-----------------------BBB-o-----?-----f
m---------------------------?XXM?MX-------BBBX-------------------EB------------------------------oXXBBB-?--?BBBMB------?XXX-----------------M?B-----------BX--------B----------XXB----------BBBBBX-X---X
XXB-?X?------------XBMBBB------------------------------?---------------------XB-------B-XBXB--BX?-X-??B--------------BX?M------------XBB------------BBXXX--?B?-B-------BMB--M?XoB---------------XE-----X
XXXXXXXXXXXX-XXX-XXXXXXX|XXXX--XXXX|||XX-XX-XX-|X|XXXXXX-XXX-|XXXXX|XXX-X-XX|XX-X-XXXX-X-XXXX-XXX-X-X|X|XX-|-XX-XX-XX|-|X-X-XXXX-XXX|-X--XX-XX-|XXXX|XXXXX-|XXX-X-XX-|--XXXX-X-XXXXXX--XXX--XXXXX-XXX--X
