--------------T-|-----?---E?--B--B-TE----------M--M---------oo----B------BT--|-----ET-o|E-B-----------------------E-BB------------------------|-BB----------E-----------E---o---B-----E---o----TB--E----
o?--B-------o-----T-E----B-----B--?-o-B-X-B-----------------o---------|?--------o-X-----------o------------------------oB--oM-?---o--|--o------------B-------------E--E-----------?o--o------?-------o--
-----|-----M------?B--o----------??---o-----|?-E-------o-X-------o------------------?---?------E--------o--M----------o---------X--------------?o----------?------------B--------------B---------EBoX---
------------------B------E-o-o---------T----------BMo--o-X-------E-TEE-------X-----M---------------XE-|-----------?---------------|E-oo---T-B-----------------X-----------o---o-o-B---------------------
--?----E--o---------------|----B---TX---|-E--------B--o----------E----|-----------?-----o---------o----?E----------TX----B--------E-------|------B---------------------M--B-Bo--X-------?-----------B---
|----------o-------------B--X-------------E--X------o-------X-------------------------?---------B-------------o------------?--o-B-------------?BM-B-?---------------------M-B---T---------------o-------
------?--T-Bo----X---B-B----------BX-------?-T--E----E------T-?---------------------------o----------------oX-------E-M-o--T-------?----------B-o-----------------|--oB-o-o------T------------o---------
-----------|-----------o-M--B--o-B----?------------------E--M---------------o--------B---E-----------o----BX---E-o-B-B-----------E----B---T---------X--E---------E?-------B---o-----?---T--------------v
---B---B---------o----------o---------------------?-E---B--------------M------------E--o------------BT----oo-----B------------------------M--------------B?-------E----B------X--XE-|X------------------
-B-------------------o--------------------------MM-X---B-E-----M----M-B----X-----B-E-----E-o-M---------X---M---o--|----B--o--|------------o---EM------------TB---T----?----------------------------X----
---------o----------------o---------|-?-o--|--------E-------|o-oo----------Mo---------------------o----------------B----------?--o-----|-----??--------------M--?----------------?-|B-X--B---EE--o------
---E--?----B--o--E----T-M-------o-----?-----oT-o--BM--------X------E---------------B-o?------------?--------Bo-----o-----T-----------------BoE----M--oE------------------o-------T--B--o----------------
----MT-----?-T----------------Eo?-------------------------------oE--------------B-----E--T|--------------------o---------------------TT--------|-B---------E-------?B------------B----------|----M---EEo
-----XT-----B-o--B----------B------------------------B------------B--X--E--------------o----------------B---T------------------E-------------------------B------B---------------B---E------------|-o----
m---------|E----------|-----------B---B-----o?----B-BX------X-----B---X-----o--B--------B--oBM-o---XE-------o----?---B----B----------?-------------B-------E-----------oB-------------|M----------------
-------------------?-------?---|-----o-----------|---E-----B-----X-----o-------------------o---------B----M-----------TB------M---------M-------|----------o--------------------------o--oM------M---o--
