----------??--------------------------BBXMX------MB--------------MMMX?-----------------------B?-------------------------------------------------E------EX--------------------------E--------------o-----
---------------------------oM-----BM----------------------EX----------------------------------------oBB--BB-----MX----------------------------------X---X------?X------?------X--X----------------------
-------BB-------------XXBBBM-?BX--------XBB------MBBB----------------------??-----------XB-------------?BX------------??XX-------------------MM----B?------------MMXX--------------B---------?----------
---------------BBXooXX--------B-------------B---X--?MXXMMX?----oMBX--?-----------------------o------------X-----------------??B----------------------MB?------XXoB------?-X-----B------?MX---?B-o-?-BB--
------?----B-B-----------XBB------B?B-----------------------BB-BB?X----X--XB----B------MB----B---------X----BX---------BBB?MXB-B----------B-----------o?BB----------B?-----XM---B-XXoB----X?--M?B-----M-
-----------------XXM??----------------------B-------------------B-------------------------BXX---------------X--BM------------X----M??---B-BB------o------------X?--------------------?-----M---XB-----B-
----------------------?---------MBB--BB-------------?-----------------------------------------------?B--B?BBM?-----------BBXB------------BB------------------------B--------Mo---E--------------o-------
Bo-------X-----BXoBX-XBMBB-----------------------?o?--MB------BXXBMM----XX--------------XMX--------B?B------XBB-BB-----?---BBB?----------------------B---B--?B---------o??--------?B?X-------------B---v
-----XB-------BBB------X------------M----?X--BX-----XMX---------BX-XMX-----XXB?-------------------BBB---------BM--------------------------------?----oM---------X------------------?BX------B?B------B?f
----------------X----X-------------------------------------------------------BoB------BBBo----?---BB?--?----B?XM-M--------??----oMB?X------B----------------------B?B-----B--B??X----XX----------------f
--------------------------X---------?B-----?-BBM----------BBBo---------B---------B----------------------BB?----XBB?----------XXX-----XX--X-M-----------BBB----?----------XBM--------------------------Ef
-----X----BXB----X----------oX------------------------------------XXMXBXX???X--------B-------?XBBX----oB------E-------B--BX?----X-------------------------?--------------M---------o---------------MM--f
------------------oBBBM?-----BBXBXB?X---------------M--------------------B-------EBM-----------XB-X-?-----B?M----X---------------------------oX---------B---------BB--BBX------------BBB-------------XXf
--------MXBX-BBB-------------?B-X------?----BX-------------------------------------------------------------BBB--------------XBX-------------B------BXBB-?M?-BB-??B--BBMXX-------------------?XXX-oX----f
m------------------BXX--?--------------------X-----------oB---oB------------oB---------------------o--XB--------ooB----------T--------------XBX-X?----X---XB-----XX-------------XXB----------BBM-----BBX
X?---?B----MMB-----X--------BBBB-----------------------------BXB---------BMM?---------BB----?------------------XM----------MBB----------XMXB------XB--------------B-X?M----------------------X------B?-X
XX|XXXX-XXXXXXXXXXXXXXX|XX-XX-XXXX-X-XXXXX|XXXX|X|XX-XXXX--XXXX|XXXXXXXX|XXXX-XXXX-XXXXX|X---XXXXX-XX--XXXXXXXXXXXX-XX-XXXXXXXX-XXX|-XX--XXXXX||-X-X-|XX-XXXXX-XXXX|X-X-XXX|X|XX|XXXX-XXX|-XXXX-XXXXXX|-
