--------X-----------T----|---|---Eo-E------------E------------------M--B?--B------X-E--T---------------XT--------------o---B----M---o---B?--B---B--T-----?-E-----?T-?---o-B-E-----B-M------------------o
---o--B------------B---------?--|--X--------XX---------B-----------------------oo-----?T--------o----?-------------------B----------------------X-o---B--------------B----E-----------------B?B---------
---o-B-M---------o-------T--B----------M----------o----------------M------?----M---M----?--?--?---------X-----------o-------B----E----------------------TB---B--|------------E--BTB----oo-------?---B?--
|--------------------------------E-?--o------o-------E--------------------E----o?B---------------------------------------------o---------M--E----------------------B---B------E---------E-----------||--
----------------------------------E---------B--------|---E------------oX-B---------------------------------------T-X?-------------------oo--M------E------------------X--?-?o----------B-E---M----E-B---
T-----BX---------B------T---o------------o-------E---T--o-X-B------B--|----M-------------BB--|-----E-----B-o-|M--?------MB----o-----?----o--X------T----------BM-T------------B----?o-XB---o------------
--------?--o--T----?-------|-------?--o--E--XB-o|------------E--B--?---------E----?------------------E--T-----B--o-M--o--------E----E-------B----|--M-?--?---E--X---------------B?-----------?---------o
--------E---o---------------T-------|B-oB----------E-M-B|----------------------oTo-X--------E--------------------------?-----------oM-E-o----o--o----?E----B-E-B-----T-BT--------------X?-------------?v
-------------o----|--?----X-|----------------M-?--o----T--B------------------------------|----Eo---------o---o-------|?-TB-oE?-B-E--oB---M-----o--------------------------------E-------oB----o-------B-
--|--|-----o-B-------o--------?-----B-----E-----B----B-E----------------------oo----o------?---E-----B--EB-E-B-------o-E-----?o--??----|--------M-o----------------B--o------------------E--M-B-----o---
--?B----B--------------T?------------------B---T--------------------------------?-----M-o------o------------M----------X-?------------------------------B---o--------TB---------------B----------o?-----
-----|--------B----?B-----------?---o------------T---------------o-------B----------------?o---E---B-----------------------------------o----------?B------o--B--o---------------------------------------
?------------------?---E---B-B--E-T--B--X-T---?-------------------T-----o------B------------B-?B-------------M----------B-Xo--?B----------E-----------------o---------o----------?|o------T-----X--Xo---
-----B-----B-----B-----------?----?---E---o-|-------M---X-o--X----?---?----------------E----?E-----E----------|-B-----------|EE-o----M-------?------X-----------------o-o--T---------M--oB-M-B-------B--
m-----------E-------o-----M---E-|-o-------T-----------------??---------------XE------B----E------------E------o----------------T-----T-----------|-X------|-B-B-------------E---------o-----------M---B-
XXXXXXXXXXXXXXXXXXXXXXXXXXXXXXXXXXXXXXXXXXXXXXXXXXXXXXXXXXXXXXXXXXXXXXXXXXXXXXXXXXXXXXXXXXXXXXXXXXXXXXXXXXXXXXXXXXXXXXXXXXXXXXXXXXXXXXXXXXXXXXXXXXXXXXXXXXXXXXXXXXXXXXXXXXXXXXXXXXXXXXXXXXXXXXXXXXXXXXXX
