-X--------o-B----o-----oX-Xo--X--M-------X---MB--------B---X--X--XX?------X---B----------BEB-------E?-BX-X-E--E-B------B-----?----------E-o-------o----X------M----o----------X-X-----o----X-----ooX-M--
------T--o-------X-X---X-----M--X-B-o----XX-B--B-o--------?---X--------------------o--E----X---------o----XB---X---E-o-o----B----E---Bo-----------------X------?--------X----X-------?-o-E-o-oX---------
---o--|-E---M-----T-------B------o---M-B------?---------?--E-M-----E--------?B-----X-------------XXXX-X-----oX-o---------?----B--X---o---X-----B-o?----X------E---o-----M-X?--X--X------B---?--oX-------
-----X|BE---o-----T-----BoX---?----X-----------XX--o-oX-X--X--M--X---------o---X----X---?-B--E----?---?-------------------o-------E-o---------B--o---------o-?X------o--------X------o--X---?---X--?----
---X--|X-----E--M-XX----E-?--------?------------o---X-----E--B-X?o-----X---XX-M-------B------o----X---B--X----X---X---o---E---------E--X-------B-----X--E--------?-B-----XX-o---EB----------------X--X--
X-----|-B-o---X---B--EX----XX--X--o-B-----E-BX----X---X----o----X------?o-------X----X-EE--o------X--------------X----X-----BE-X----X-------X-X-------X------------X-------------X----X-X--o-B-----X--oX
----X-|---o----------X-??XX----X--------X-o------B-XX---X--o-X--?----X------X----oX---------E-XoX-----------XoX------o-------------------X---o--B---X-?-------------X--------X-------------X---X--XM--?-
------|---X-----X-o?---XBBE-------o------------E---E----X--X--o-X-B---------o-----?-E---------X?-BB----BXB-------------B----------o---------E----------X----oXX----o-X--?-B--X------------X--E--XX--X-Xv
---X--|-------?B----?X------X-?---X-X------------E---XB-------------Xo---X---E----XB----MX----X-XBX-----X-------X---X------X----XoM-E------B--BBX----X---oX------------------B-X-X-------X----X-----X--?
----M-|-X-------X--X-----?-X---------X--o-----------X?-------XX-?-oXXo---------X-----------o-----oX-------------E-B-----------X------------X-B?|X-X---------------X-X-oX------?--X--E-X?X--X------------
X-----|-----X?---X-----X-X-----B-------o--XX-o---------X---------o--------o-------------oX----X-o-X----X-??o---X----??-------------o----X------XXE-------Bo---M--X---X--------------X-----M-X-B-B-M---X-
B--X--|E-X---E----X--X--------oB-----X----------------------------------XB------XX---X-ET--E---o----o---MX-----------?-----X----X-------o--B---X--?o------------?E---------o-o-o-oo-XB--------B-X---?---
------|--TB---X-B-X-----------?----o-BX---------X--X--X--X------X--o------------?--X----XX--M-----X---?BXoBX-oo-----E-X--E-?-----oB---------------------------E----------------o-B--B-----M-X-XM-o--E---
-X----|?X|X-----o------------------X---X--T---X-----X---------Xo---BXT--X--------X---?----------oE-X-------------X--o--XX-----Xo--?---X--X--?----X--X--------------BE-----X---B--------XT-X---o---B--B--
m-----|--|---X--XX----o--X----------------TB----B-X-------------M----|-----B---X-EBX-|-----X------oM------oE-----B-B-----------o-X-----------X---------------X--EB---E---oo------E--X---|----?-X?--X----
XXXXXXXXXXXXXXXXXXXXXXXXXXXXXXXXXXXXXXXXXXXXXXXXXXXXXXXXXXXXXXXXXXXXXXXXXXXXXXXXXXXXXXXXXXXXXXXXXXXXXXXXXXXXXXXXXXXXXXXXXXXXXXXXXXXXXXXXXXXXXXXXXXXXXXXXXXXXXXXXXXXXXXXXXXXXXXXXXXXXXXXXXXXXXXXXXXXXXXXX
