----------------B-----------B-----o-------XBXBX-----X-----B----------E-MXoX----------|-XXM----XT?-TB-------B---X---?-----------------------------M-Mo?X---B-------------------------------------XB--?---
-----------------?X-------T------------XXX---BB----?--------------------X--BMoBoBMX---B--------|MM|---XB----------------------------XXB-EX?------M-----?---------o-----oB?------B--------------B--------
-----X-M?BB------X?-------B-X-------------------B-----------X----------------BBM----MB-----B--------------X-------------------T-X-XXBX-------X-----------BBTX-BB-----TBB-B------------------M----B----?-
---------------------M-X-T-?-------MXBB------BMBBB??-----------B----BXBBM-----------M---------X------------------BM-----------BB---------------BB---o-------------M-------------------o-X---------------
--oX-----BX----?MM-----BX|X--X-B-B------XB-----------------------------X-------?--XM-----XMB--?--B--E------------EB--------To--T---------------------------XBM----------M--------------B---------BM-----
X---B------------oX--------o----BB----B---o?------------------?--X-XBX---------?B?B----------------------------?T-------------XM------M-B------B-TX--B----BX---T-------------M------------E----XB?BBBB--
-----------M--???-----------T----------------XTXBM?---BBB----------------X------------XX----T--------B----------|----oT-----X---T-----------?--------X------------------------------------X----------o--
-----------------TX-------T-----------MX----o--------------------BX--------XXX-B------------?-----------------------------XX----------?-----------M--X-----------------T--o-------------B----o--M--BBX-v
-----------------M?B------|XXBBB--BB-------------------M------------B-XX--BB--TBXX-----------------X-----?--E----------------------?X-------------?X-?MX--------------M|?------M-----T------B----------f
-XBoX------BX-BX----------------MMM-------E--?------------------X--X---------oB----B---B----XM-------------------------E-BB----T---------o--------------------------T?------o--T--------------TB------Mf
----------------BB?MTX-----------B?-----------BX----M-XB-------XXB-------M--------------o-------------MBB-----?--M?------TB----|?--------XMBM---XX----T--?-----------BM----MBB-|E?-BXT-----?--------X--f
------BM?----?--B---M?-----MB?oo----------XX------------------XB---------o--------oMXB?B---B---BB-------------B-XX-MM----------------X-------------EBB|-----------------?X-----------B-------------ooT-f
------------B-------XBXB?BM----X-------------X------------------MXM---XoB-XX---B-B?XBMo-----M------T--BXT--------oTB-----XoX---------MM---------X-----T----------------BBB-----T-M--?---XB----T-o---B?Xf
---------B----BB-------BX-----oMXBB--BXB-B------------o------M-----------------EBBBBB--------------|??--|------X---X-----------X------------------?---BM-----EB-oB--TM-E-------|--------Xo----|XB---o--f
m--------X-TBX--T----B---------oB--XXBB-------BXM----EB--?B--BB??------B---B-XXM--------------------B-B--?-M---o----------BM-B--BX----------XX?-----X----XX---------|X-------XB-------BX---------E----TX
--------------------------------?X---------B--------------------BXB---B---------------BM---BB-----XB--------------BX----------XX--------??XBBMBBX?X---X---------B---------BX---------------------X-----X
XXXXX-|X--XX-XX-XX-XX-X-|X-XXX--XXXXXXXXXXX-|XXXXXXX-XXXXXXXXXXX|XXXX-XXXXX--XXX-XXXX|-XXXX--XX-XXXXXX-XXXXXXXX--XXXXX-XXXXX--X--XXXXX-XXXXXXX|XXXXXXXXXXXXXXX-XXXXXX-XXX-X-X-----X-|XXX-|XXX|XXXXXX---X
