-------------------------------------XM?-----------EE-------XB--X----------------B-B--?--------BXX-------B?B-------------------------BBBBMBX-?BX----------XX------X-------------------------------------
-------------XB-X?X?XX-------------------?BoB------------BB---------XXX---BBBX-----BMBB-M--o?B-------BXB-----------------------------------------------------oB---------------M------B------o------BB---
------------------------------XBXX------XXMB------------------X--BXBXXX-------?X?-------------------------XB-------------X------MX-------------oB---------------BB--oBBBBBXXB-?------?----X-----------B-
-BX?--------------------------BBB-----------------BB-------?B-------------BBB-------------------------------------?M----------------------B----------------B--------------------XX----------------------
BBX----------BBXM--BMX--------------------??BB----------X?X-------------EBX-XX--------------XB-----?-------------------------------------------B----------------BB----MX-------B--XBXoBBBB?--------?BB?X
------------XM-B?--------------BX?M------------------BM---------M?---XXBBB--B?X---------X?--MB--XMX-?--------BB----------X--------------XB---XXB-----M--BXBXXXB-XX--BMMBBBMBX?B?B-----------------------
------------BX-----oXBBX-XXB-?-----BX?XB------MBM------------------?BXB--------XoBB----------------------------?MB---------------------------X?--------------------BB---------------------o-X?---B------
------?----?oBBMB-BB--BXM?--BMX--------------BBBX?--------?-------------------------------?BM------------------------------------------??X----------X?BB------BBB----------X-------------------------M-v
--------------?--------?M----EX-------XBM---------B?------------------------?--------------?X----------------------------------------------------o---------------??------------------?MMXB------?------f
X-------X-------------B-------------M-BBM-XB---BMBX--B-X---BM?XBXX--------B----------BB----B--------------------------------X?M---------BB------XXB--------------------oB-X---------------XXBBM--------f
-------------------??X??---oXBM--?B-BM-XMX-----------oB-------MB------------------------EB--B-----BBB------XB-----o-------?B--BXM------------BXBM---XX-------------?X---M-BM----------------oXBB----?X-f
----------------B-oB--------X-?------------------------BBM--BXBX---?B----XXB----XBB------BBXX?--XBB?-MX-------------XBX------------XXBB-------------B-------------------------XXB-BBXX-----------B?M---f
---------------MX--XB---X?-----------o-----------XBMB--------------------X?------MB-------------------B?---?XXBBBB------------X-----------?BB----B-------------------BBB----BB--------------X----------f
-------BB---------X---M?MB---------------------ooBMB--B?M------------------------------------XBBBX---BX-----------------------------B------------XM----?B?X---BXX?BB-------------X?B--X-XM----o--------f
m---------XXB---TXXXX?B?---XoB?--------------------?BBXB---------?MX--------BBB---------------XXB---------XX--------------------------oXXX----------X---oXX----o---X---------X----TB-----X---------T---X
XBX-------------BXBBB---BMXBM--TXXXXBBBB----MX--BXXBBBMB?B--------------?XXXBB----BMX--?----?X-BBBB----------------------XX??XXB--------o--oBX-------------?BBB--------MM----o----|MXBEBB?----?BBX-?BBBX
X--XXXXXXX-XXX--XXXXXX|XXXXX-XXXXX-XX-XXXXXX-XXXXXXXX-XXX-|XX---XXXXX-XX-XXX-XXXXXXXXXXX--X-X-XX-X-XXX|XXX-XX-XX-XXXXXXXXXXXXXXXX|-X-XX-XXXX|X||XX-XXXXXXXX-|XXXXXX-XXXXX-XXXXX-|XXXXXX-X-X-X-X-XXXXXXX-
