o------------B?--BM-XXXMBX--XBB----------------XBB--------------------------------------------B---------------------------------o-------------------------BX-----------B--------?BB---------------B?X--o
----XXB----BM?---?B-----------BX-----BoB-----XX-----BB---------B?--MXMMB------B?-----------------?-BMB?----------BX-----------BBBMBMB--------------------------------X-----------BB---------BX---MBBXM?-
------------------------------------------o-----X??-----------M------------------------------?-B-?B-B-----------------X---------B---XB-------------?B------B-B-----------X---B-----B--------------------
-X--------o-------X----------------------------X------------E----?--------------B--------------B-EMoE---------X---------------BB?X-----------BB-B--------BM-----------------------M-X?M-X------X-M-----o
-BBBB-------------------X----------XXBBBB--------BM---------BB-XMM-------------M------B-------BB-----------o?-----------?-XBX----------------------------------------EXB---BXoB-----X?XB-B-B-----BB-----
--------------------E--M--------BEM----------------M-----X---------------------X---------oB---X--XX---------M---------ooo------M---X--o-XB--------------------------B-------------------------o--------M
--?X?------B-?-?----------XX-EB-------------------------------------------------o------?----B-XB-ooBX?X??-----------------o---?-----??B-------------------o--------B?--oM-M------XM----B----------------
B--------------------o??EB-B---------------X-----o-------o---------------oB--------------MB------M---B----X--?---B-----?oBB-----?-----------------------------------------XB----------oBX--BB-o----XXB-v
--------X-o----------M-----EB---B-------------o--E-X-------------EB---BX-XXo--B-------------------XB-------X----------E----o---?M-----------------------X----o----X--------M---------------------------f
oo--------B-------B-------------------X-------------BX?-B-------X---?-X------X------XXMMMEB-------------------X--XXBB------------------------BB--------XB------------------X----------------???B-------f
-------X------B-B----------------o--MBBBM------B-------------XB---------------XXB------?------X---------BB-----------XX--------MX-------XX?-X-----o------B-----------------?----B---------------B----B-f
------------------B-XX-------BXX-X--------BB-B----------B---MX-----------------------------------------------B--?o-------------------oM----------??------X-?-B--B-----------------MB------X?---BBMBB-B-f
---------?M---------EXM-------BM?M---------o------------XB---------B-----------B------oB----XBBX--------------------X-----?XMX-------------------------------X-BB?B--------X-------BB------------------f
----------BM-----MBB--------o------------------M---------------------?---------------------o-B-?X?-----------------------------MX------XB-?-------B---------------E-B---o-----X-X-----------------?-?--f
m------------B---B------M----------X----------------E------------XX----------BXX-----X-------B---------------X-----------------M------M--?-------BX-------X------o-------M-X----o----o---X-------------X
X-------XX-------BB------B----?XB--------------?-BB--MB-BB-----XBBBBBB---?B----------XBXBMBBTMX----XX---?--X----XB-XBXX-??-Xo---?X------?-BXX---XB-----B-XXBT--------M--------------------------B---BMMX
X|XXXXXX|XXX|X-XXXXX-XX---XXXX-XXXXXXXX|XX-XXX-XXXXXXXXX--XX-XXX-XXXXXX--|-XXXXXX|XX|XX|X|-XXXX-|XX-XXXXX-XXXX-XXXXXXXX-XXXXX-X-X-XXX-X-XXXX-XX-XXXX-XXXXXXX|-XX-XXX-XXXX-XX----|-XXX-XXX-XXXXXX-XXXXXXX
