-B------B-T-------?---------B--------------E----------------------X-------E--M|-------------E--------M-------o--------T-B-----------oT----o--E---E--T-B-------o--X-------------------o-X------------?---
B--o-----|BX--?-o--------------------B----oo---------o?----------------o---------------------------------B-----o-?|-B--------?--o-----------E--------------X-----------?-------------E-?------X--------B
--------o--B---T----B-BB---------------------------?M?----------X-?-------------------B--------B?---o-E---------------------------------B-M-----------------------------------E-------?----------B-ET---
---o-------B---------------------?-?-T---?-------oX------E-T----M-BB------------B---M-----------E--B----B-T----?--------------------|--?---------T---------------B---------------------E--?--M------?---
-------X--T----------------------o-----------------------?--EB--?----------o------------o-o--X-E-E----------B---B----o--------oT-----------------M----B-----o----Xo-----B--E-------|--------------------
--X-------------------E--B-------B--------?B-----------------B----B---?--EX-|-----------B-?--B-------E----------B---|------TX---?---------E--?-BB----o--E---T|---------B--------------------Eo---T-----T
-----------------------B-------?--?----B-?---E--M-B----------------------------------|---X---------BBM-?-B-B--E-B---------------------E--E-----o-B---E----B-o---------?-----E---|------o--E-----T-------
-------------B-o-----?----------|E-----B----------o-----?------------------o---o---?-------------BoB-------E--------B----?-------o----E-X--T-E-----------------X------------------?---------o-------?--v
-------B---------|-??--------M---------o-----------------T---------?--------|-o----|-----B-------------?-?-------B------------------|--------------o--|-------------M--|----B-----TB------------o------T
----oB--B--M-------E-----B---Mo----------E--o-------M---?-|---o-B-T---E--B----------E---------------X--BE-------M----------?-----------o-E---------B---------------------E-------E-----B--T-o--------?--
--------------?-??-B----o--X--B---------------------------------------E-----X-o---o-------------T----o--B----M--B--------------E-T?E----------X--------------------Xoo---B-B-|----o---------B-----------
T--B-------------M---------?-?---------------------o----|--o?-------|--Bo-----Mo---o------------E------------?------?--------------?----------?Eo----?---------------X---B---X----E------------E--|--B--
---B-B--B--------B|----B----E----------o--------T----------X--------B--------B------?--------------B--X-------o-------------------E----T-X--o-------------------B-------M-E-----T-----------------------
---o---B------?-----------?-----E---------------M--o--B---------------B--------------B-T--E-------o--oEo-----|-----XT-----|--?----|------?-------|?---------|oT--|B----------||B---E--M-------B---------
m------??-----------------M--X----E|-------------oT--B-B--MTE------B----------------EX--M---------??--o-------------------------B------?----B---------T-E-----?-o------------o---?----o--------------o--
---o?-----------X-----------------------E----o--------o----B--------E|-o---------?----o------E------|-----------o---E------------------?----------o---o-----------------X-------?-------------------?B--
