-B--------B-E----------------------o-------------------o-------------EB--------o--------------------E---------B----X-------|-------|-----------------?--?----o------E-----X------X---B------------------
---o-------------B---E-----B-B--------------------|---------------------------B-----o--------?-----------B--------------BB------?---------o--|------------------T-----M--?M---X----------E--------------
---------------------M------?-M---------T----o------X-----------o--E---B----------------B-----------M-B----------?------T--Bo----------------B----o--------------EB----------------------X-?------X-----
---------|--?-----o-----o-----o-------Bo-------------------B------B-----B--------B-------M-------BB------B--------------------E---------|--------B--X-------T------------|--?--------?-----B------B-----
--B--------------------|---B---------o--E------------E----------------?o-B---EE---?---------B-?-B----------------------?-X---B-----------------B-----?-X------X-?------------------|-M--------B--o------
o---------B------------B------------B-------------------------o--------------------XB----T-------o--?B---------B--------------------------------B--?B-oE---------M----T------X---------------|--E-------
-----o--o------B---o-------o---------o--B------B--o--E-------B-------------EB------o----?----------?--?-----------X?--?------------o----T------B-X---o-----------------------X----E------X--X---?-----B-
-----B----X---T---B-------M---o----o---------------------B-B--T-----E-B------------------T--M-------------------o-Xo-------------|-T----?---?-----------E--B--------------B---------oEB-------------M-Bv
B-----E--B-?--------?----------Bo--------|----|--o----------BE------------o-?---T---------B-----X------?----?---?--E---o-----T-------o--?M-------E-----T------E-B--------MX-------M---------?------E----
B-------o-o---------M|B------X---T---o------X--------o?------------------------------------|M---M-----Eo-M-----?|--?-E---|o-o---------o---------M------------E----------X----------?--E-oB--o----|----?-
-BE---B-?------------?----------------------o---?---?-----------E------E------|--------E--o------------------o-o------?-|---------oo---B--|----M-|---B-M--o--------------B--------B-----------------BE--
---------B---o-----?---?-?----|B-----------|---Xo-----------------------X-o---------------------MB--o--------?----------------?------------Eoo-----------M-?-?-----------B-o-----T-M--------o-----------
-?-o-------------E-X--?-----------------?-?------oX----E-------B---B---------------------B---E--------------M-B----M-o----|-?---o-----?-M----------o---|-----?--B-----M-------B---------T--M-?--------|-
-E---------B---------------------------o-----------|---------?E--E-----o------?--E--B--E-M---B--------T---------------------B--X-------o------B---------o-----?-X-o-E-?-------B---?-------M-------------
m---------?--------B----o---------------|-----?-------E--------EB--------------------------E--T----B---------?---------------B---B?M--B-----B-----o---------o-----E----EM--------E---------B---B----T-o-
----------------------o--B----------|-B-T--B--------------------E-o----B--E------------|----M-----------------T---o---------o----o----------o-B---E-------E|---------X------------------?---------------
