-B--XB---------X-----?o-X?-|-----------------E--X--------BM------T-------X--X-T-X-----o------o-------o-----------------------oo--X-----------B---X----X-------XB-------B?---------XoE-XM-------X|---o---
-X----T---X|---||--E---------XE--|----X----X------B-E---------?-E--X----X-----o-o-----------EXo-------X---o-----X-X------------X--B-------XX---X---X--E-----------X--X--TX--X-X--X-B---B---o---M--X---Bo
-?--X?|?--B--?---X------------X----------o-E-------------------XoTM---X-X--------?XB-X------?---X-----------X--oM-----T-o--------B--B----------BX-E------------------B-|-------------B-E--Xo----o-------
------|--X----------------X-----X--o--------BB-------o--X---X-X---EBE-----------o---X-|-X-o------o-o-X--o--------B------------o------X-B----oB------------B-|B-o--X--------?B-----E--B----X--X--------X-
X-BX--|--o--X-----X--o--------M--------------o-XM-BB-----o---X-E----o-X------Bo----T--BE---o------X---------E---T----X-----T----X----Bo-X--?--o--|-----|-----E--oB--X--X------X--o-----E---XT--BB---o--X
------|-----?XEXT-TE|----------X-o------B--------------|-X---Xo-X--X?---oo-XX-E-------Xo-----X------X------X--X----o----?--oo--T---X-o--o-M-o------X---XX----X-----?------?-o-M---------B---M-XXT-oB----
X-----|X-?-o-M----E--------o-T--------X-o------------X--X------o-----XX---------oo------X-o-------o-----X-------X------------------?--Bo-X-T---?|B----B-?---EB--X---B----X----------B----X------XB-X----
---E--|-XMo---X----X-Xo--o?-------------X-----|X--X-----------X-X------------E-XE-XT-X----o----X--B------oBX?MXXo----------------o--X----X---o-E----X---------|--E----------|-MX---------XXMB----X-o---v
E-X-X-|------X-----T------M-----X--oX----?-X-----X---------X-----o---|---o-BoX----XXX-----?--?---|---Xo--B------X---X---B--B--XEo-X----E-----E---o--------XX-------X------XBX-------oEoT|-----o--o--E-?B
X-B-T-|-M-MX-|-B----oE-------X------?---------o-X-----Xo-oEX-BE----X------?---o--------?------X-oTo--Xo?B-T---------?-X--M-------B--------?--X--B-XB--X---X--o---X---X-EXX-------|Xo--XX----------------
---o--|---?o?------X-?---XE--B--E----X---------?---E|---------TX----------------------X---B-X-----------E----XXXX-----------?---E----X---o---o--------B--X|----M-X-X---X-------XE-B-X-XX-|--X--oB-?Xo---
--X---|-MTX-----------XM--------BX-XM-----M-----o----MX----o-----X-X---M-X-X-|?------B------------E--------o?-----To--X-XB-o-B---------------B-----o----T--oXo-oMo-|-------o|---X--B--X----B--M------o-o
-X----|-|X-B--XX--------o-o--------X--E---XEE---?----X---o----EX-?-X--?-----------o--oB-------B--B-----X-X-----ET------?----Xo-B----X--o-?--X-X---o-|---BT-B------BX------------E-XX----B----o-X--MTMo-X
---E--|---X---oo------X------?--X-----?EEB----X-----XE---?-XX-------------------o---------o---XX-?-------X-B----X----B-------------X-B---E---X---B------------M----oX---------------XEB---E?|----X-oo---
m-?---|------------X-?o---------T-X-X-M---o-----XX-------X-o----BB----?----o---T-------X---o---B|-------o-o--?---X-X|B-o----oM-B------B---?-X---?-B-|-X---X-----X------|-XXoT-------X-------------B--T-X
XXXXXXXXXXXXXXXXXXXXXXXXXXXXXXXXXXXXXXXXXXXXXXXXXXXXXXXXXXXXXXXXXXXXXXXXXXXXXXXXXXXXXXXXXXXXXXXXXXXXXXXXXXXXXXXXXXXXXXXXXXXXXXXXXXXXXXXXXXXXXXXXXXXXXXXXXXXXXXXXXXXXXXXXXXXXXXXXXXXXXXXXXXXXXXXXXXXXXXXX
