-E-----------XXX-B----------X------------B?XX-------------------XBXBX------------o?------------o?X---MB------------------MB----------BB---------------?M----oB---------B---BM------XBB--------------B---
----?----------------------------BX?--------------BMB---------------B----------------------------------oBB-----------M-----BBBB------------B?-------------------?-------------------?XB--o?B?XX-?XB-----
-----------------?BBXXX----------BM-----XBBX----M--XXM---XX-----------B-XBM----B-----M------EXB------MXMB---------B?-----XXE?B------MB-------------------------XBX-----------------------oBB?BM---??BXB-
-------B-----XXBB---------------------EB----------------B--------------MoB?--------------X-------------XMBBB---------BB??--BMXMBBBX?B----------------?XB----B--------------------------M----------------
----B-------B?---------------M------X?M------------------------------------------------?oBBX-----M-----B------------------------------------XX------?--?B---B---BBB----BMX-----oBMB--------XB-----------
-M?BM------BB---X---------?---B---------------------B--------BX-------------------XX-----------------------X-----------------------?B-----------o-------B------------M?BXMBX------B?--XXB?---B----------
------oXEB---------BB-?---------------XMM----------XMBoB--BBBB-------------------BB----------?XBBB-----------------XM?---------BM----XXBX-------------XX--MXXoB-------------------EB--B-X---------------
---------------------X?---?M?BB------XX-------BB--BX?---?---BBBBX---XB---BBBB-----MM?MXXX?-?B---------B------------------BBBBX------------------XMB---B?-----------------B---------M------------------Xv
------MXX---------------BB---------B?MBBXB-----------------------MBE?XXXBBBB--XB--------BB-------BM-----BBB?---BB?B---------------X---------------------------------XX----------------------oB-oo------f
-BBB---------------B------oB---X---MXBB-------X-?XM------?BM-------X---BBB------EXX-----------------XXB-------------o----BB?------------BBB-------BMXM--------------------------BEX--XX-----------X?XX-f
------------BMB----oBB-----------------------------XB-------------------------------------------XBB?--------BX-------X?BXXBBBXB-----------------------------------------------------------BBBBB-B----XXf
---------?BBB------M-------------------------BBBX-------------------------oB----BB?BBBBB-XB-------X--B-------------M?---------------o--------------------------------o--------------------BB------XMoBBf
-----------------oBB-X-----------BBMX---------------------------------------------------------------BBB-BX------XBX----XM-------------------XM?B------------------------------EBBX-EB------------------f
---------------------MXBXBXX?B--------------------?M---------oXBXB---XMB-----------EX--XM--B-----------XX------------------------------------------------------?----??M-----------BBX------------------f
m-------------------------------------BB?-o?--B---------------XBM-------XB--------------------------MX--------------------------------------XB-BB---------------o------BXB----?----MB--XX---X----------X
XX?BB---?MX--BM---------?B-----------X?B------------MB-B---------------------o?-------B-XBXB--BXXBXXB?XXX------------BBX-------------MBBX--------??o-------------MX---B---------BB-------------------oXX
-XX-X-X--XXXXX-XXX-XX-X-X|XXXXXX-XXX-X|XXXXX|XXXXXX-XX--X|XX-XX-XXXXX--XXXX|XX-XX---XXX-XXX-XXXXXXXXX-XXXXXXXXXXXX-XXXXXX-XXXXXXXXXX-XX|XXXXXXXXXXXXXX-XXXXXX-XX-X-XXXXXXX---XXXX-XXXX-XXX|XXX|XX|XXXXXX
