-XX------?-------XM--------o-----o--X------M--X-X-XX-------BXX-------------------oo--------X-o-----oo-------B-----X-----o---X------B-------o----------B-------X---X-----X----X---X-----o?---o----XE---XX
-?E--ETo---BE--X-------------Xo--------B---B---EX-------M-BE----E-X---------------E-----B--------?---E-E--?----EX--o-------Xo----X--Xo--------X---X-----------X--B-----------------------B--------X-----
X-----|-------------X------X-E-------X-----B--XX---oo--X-X--X-o-X--E-X-------X---?-----o---o--------------XXB------------------X-------?---X----X---X----o---XB---XX---EE-----------------M--o-X-EXX--X-
X-----|B------X------------------------------X--B-X--------Xo-------?-------X--MX----E-X-o--E---Bo------------E-----X-X-o--------X----E---Xo-BX---------X--------B---o--X--o---?---M-XX-o-----?B--------
---X--|X----X--Xo--X------o?---X--oo----------------oX------X---XX-X-------------X------X-X-----B-X----X?-------X--o-------oo-----E----M----BX-XX-B------o---------X--X------------X-------o-----X------
?-----|------?X--?---X-X--X----X-X--------------------?-X---?X-------X---------XXX-X--------B-o--XX------EX--------B---------------XXo?-----------M------XXo-X---?--BX-o-Bo-B-oB-----------BX--XB-------
------|X---X------X?-X------?------X----Eo---?--EX--o--B---?--X---B-------X?--X-EX---X-----X-o---X------o---------------------------E---B---X----X--X----X------XB--------X---X-X------------E--X-X-----
X--X--|----?--X-M--------X----E--B--Xo---------XB--X---o-----X-----o-ooo------?------------X-------EX---------XX---o----XX--o--BX-----------------ooMT---------------XM---X--------------X----?--------v
---M--|MMX-B---Xo?-B---XX-X---X-o----XEo----?--------X-------X----X----B-X------------X--?-----B---X------X-M--X-------M------EXX-o--------B--o---Xo-T-X---o-------X----------?o----X-E-E-E-----?-X-----
--X---|--o?X--X----X-----M-X-B--X--X------XE-X-----X-o-E----X---X-------o-----------o-?----------XB?--?----X----o---o---B-------o-X----------MX----o-XX-------------XE-X---------X----EXX---B-------B--B
-o----|----EX------X----------?X--------E-oo-------------------M-X---o-oM---X-X----X?------X---------o-X?--X----------X--E--BX-------X---X-----------o-------?X-oX------BM---X---------X--XB-B-----o----
------|--E-X--------------B-B--o-----o-----E--XM-o-------XE------------o-oX------X----X-----B--X------EX-------B---Bo?---X--?--X---o-X--------X-?-----o-------o--E?-----------X-X---X----XB---X----?----
--E---|-oT--BXBX--------X--Xoo----o-------------o-o-E------oE------X---E-----X----X------B--?----X-X---------X-----------X--B-XX--B-----XX--X----?------M-E------X--------B-BM-------o--------------X---
---T--|X-|--oX----o-E--o---EM-X-X---o---X-----XT-------------X----XXo-X--------X--------------B-E-------X-X--X----------?----o----?--------oX-XX---BX-M--XX-------T-X?--B-----XX-XE-o----X-o---------TX-
mX-TX-|--|--?--X-------------?---EX---X---?----T-----oo-E-?X--------------E-B-oo-X---M---------------B-----X--X-----?------------B--X---BM-------?--------X---X---T---X--X--B----E-?--BBoX---------o-T--
XXXXXXXXXXXXXXXXXXXXXXXXXXXXXXXXXXXXXXXXXXXXXXXXXXXXXXXXXXXXXXXXXXXXXXXXXXXXXXXXXXXXXXXXXXXXXXXXXXXXXXXXXXXXXXXXXXXXXXXXXXXXXXXXXXXXXXXXXXXXXXXXXXXXXXXXXXXXXXXXXXXXXXXXXXXXXXXXXXXXXXXXXXXXXXXXXXXXXXXX
