--------oB----BB--------------EBB--------------??---------X---------------?-----------BB-----------------BB?-----BM-BB?--MX---------------------------------M-M----o------BB-----?M--XB-XBBB----B-XB----
---?---------------------------B-----o--------------------?------X-BX------X--------------------------?XX-----EX------------------?BX?-B-------o--------B--?X----------------------------------oo------M
-o----------B-----------B------X?B---XXB-??B-----------------o-X-MBX---------?-B-??-----------------X---------------------X-E---------?-X------B----?-----M----E---------?MB-X-------------B------------
-B--ME-BX------B-------------X---------------------------------?------MB-------------------BE----?--------------------X-X--------X----XXX------BXB?-------BX---------------XXX----B-----------BX-----M--
--?B----B------E-----o------o---BB-----MXB?X---X---X-----M-?-----B?-MBX---X--------------X------o??-----------------------------X-XM---X----BM--?B-----------BB------------------B-EB-B-------?M--------
-------------------M?--X----BMB-?M------------E-----------oB---oXXB---E--------MM----------------M--------------------------B-B---X---?-?X----------XX---------------B-------------?-B-----------X-B----
-----------XXEBXX----o--E-X--------B--?XX----------------oBB--------X?B-----------------------------B?----------------------------M--------X---------------------------X------E-----------B-----XBBM-X--
?----XBME----B---------------ooE--XX-----------BBB?----------------BBX-------------B----X?----?--------?-------o---X-B---------?M------------B-------------M?B--------?X--?------o---------------------v
--------------------------------X----------Bo?BXM--X------------------X---------BX---------------------XBBB?---MB?----------------------------------------------------------BBBBoXB---------?XX--XX---Bf
-----------?-----------------------------------------E-XB----------EX-----o--oXX------o------------------M-----------------?--B-----B?---------------Bo-?-??o---------BXB?------ooB-------------------Bf
------M-------X----------------XB--E----------------oB-----------B---M----o----------X--B----------------------------------?-----B----BXM------------B---------------------o------o---X---X------M-----f
---------------------BBMB---------B-------BX------BXMBMooM---X---------BB--------------B?---X-------X---?------------o-----------Xo-BB---------------------oo-----------------------------X--XX---B----f
-----------M-------oBB--X----?XB-------BB-----------?-B?---------------BB-X----?-oBB-----------X------XXM---?B-------------------------?---------BB--B----------------oX--------------------?----XBM---f
------------BMB-------------BXX--X-----------------------B----------------oB-----------------------B----------------------------BB----?-----BBX-----XBXXXXXXMM--XB--------B----------BMBBM--M----MBB---f
m--------B--------BEX------BX--------------X-E------B-----------?--------o--X------X--X----X----E--X---------EMX-------X-------------MB------MoB?X--------X---MB----------------X---BM??---B-----------X
X?B-----MBBEX-B---------------------B-?--B--MBX----XBM--------B-X---XMX---?B---------B-----------------?---B?-TX----BMB--X?-?XBM-------BX---M?------B???M------------------o---------------?EX---------X
XX|XXXXXXXXXXXXXXXXX---XXXXXXXXXXXX-XXXX-X|XXXXXXX-X|XXXX-XX-XXXXXXXXX--XXX-XXX|XXXXX---XXX|XXXX-X-X-XXXXXXXXXXXXXXXXXXXXXXXXXXXX-XXXX-X-XXXXXXXXXXXXXXXXXXX-XXXXX|XX-XXXXXXX||-|XX-XXXX-X-XXXXXXXXXX--X
