--------------------X-E-XB---X----o--------------------------X-?-X-X--o-----X--------X--X-----o-o------XX-----------oB--BX-X--------B--o-?-E-X----B-------?---o---BB-----X-----X------------?----XX---X-
---X-X-----X--------X-----------oX--o----X----X-----------X----X-----XEoX-B----XX---X------------o-----?-----------o----o--X------------X---X---E-----X---B--X-oX--XX--------------X-------o-o------X---
?-XB--------------X-----oB--X?-Xo-------B-------X-X-----?B-X------o-XBE--------E---Xo------X-E-?--XXX-------X--?o-X-?-----------------o-----B--?o--X-X---B-XX----------B--------------XBX?--------------
-E----------X----XX----BX---------X---X---B-o----X-X--MME--o-----X---------X---------X-B--------X-------------?E-XB---X-------oX------------X-------B?-E-X-o--XXo---------X?XB--B----------X--X--BB--Xo-
---?-----o-----X----o-XX---------X---X--o---------MX----X------------------------MX-------X---------------------X-B-----X-E-?----------------X-------X--X--------o----Eo--B----o--X---X-X-------o--E--oo
E-------X-o----EB----X-----XBo----X-E-Mo--X-B-------?---X-X---?---?X?X---B--X-X-----X---------X----Xo----B--o----------E---o-E-----B-------------BX-----------B-XE--o-----E----------------Xo-X-------o-
X---------------X------------X-X--------o-E--------------?-----------X----------X--M------------oB---E-X----BXM---MX---o---------X-------------M---XX---XX-----XB-B--------------X-o-----X--X------B----
---X-------X--?---?-X-------X---B----------------X------E--------?------B----o-----XE--MX--?-Xo-----X-B--M-------X-------------o----X-XEM-o--X-o-X-X-----o------------X----Xo------?----?---------oX--Xv
-B--o----o---X------o---X-B--B--o-------M---------------oX----o--X---E---X------o---------------?--E-----o-?--------X-------X----------?------X--X-E--oX-----------X---X----o------X--------X-----B-----
-BB-----------?--XooX-----E---?----B--X-----XX--B--oM---B-X------o----------M--------E------B----BX---XX-------Xo----X-----oB------------X-?-----X-?----XX----o----M-----o--?------X--------B--------o--
--Xo----oo------B----X--X-XXX--E----o-X---------B-------M--Xo-?------X-----------o---------------B-------oXX------X-?-X-----------?---X---?-----------X--X-----oo--------o----?----o--------X--M----o---
-BXo-X--B-----?----E-----------M-?X--------X----X--X-X-E--------X--------?-X-?XBX---X--X-o--X---?-X-M---o------XB--EX-o--X----oMX----------X?---?EX------------------XX-XX-o---------BX-----X----X--X--X
-------X----XX-X--MB?-----------X-o-------B------X-B----M----X-M---o-----------o---Xo--X------o--?------X-B----X-----------o---o-B---?-B----M--B---------XE-B---------oX?X-B----XX-------X--X-o---B-----
oX---X----Bo-X------XX-oE-o----E--o-----X--XB-------o----B--X--B--B----------X------XB--X----X-o--XBX------?------E-----X----X--X-----o?----X---X---E----X-o-B------oX-------X--------X-o---B------o--X-
m---B-|--------B------XX--o-X---EX-oE------X--X?-o-XX------X?B?----------o-E--B-|----o-?------o-X-X-X-?-----X-XM-------X---------o-X?-------------X-oo-B-Mo-E--X-X-----B-X-?----oX-B|X------BX-?-----B--
XXXXXXXXXXXXXXXXXXXXXXXXXXXXXXXXXXXXXXXXXXXXXXXXXXXXXXXXXXXXXXXXXXXXXXXXXXXXXXXXXXXXXXXXXXXXXXXXXXXXXXXXXXXXXXXXXXXXXXXXXXXXXXXXXXXXXXXXXXXXXXXXXXXXXXXXXXXXXXXXXXXXXXXXXXXXXXXXXXXXXXXXXXXXXXXXXXXXXXXX
