----X--------B--Bo------X----B----X?o-X----XX------------------X---X--X--o--------o-X--XBo--o-X-X---XM-X--------X--B-----B--?-----o---X--E--o------o--o------------?-XB?--B-----XX----X----E-------?----
------T----M?---------BX--X----X---?------------X--E?------------o-X----B-B--X-X--------oo-E--EX------o-----X-X----o---XX?----X---X-o-X---o-?---XXo-?----X----oB-----XX-----oX--------------------o-----
-X----|------------BX-----X------X-X-M-X-----X----?-E--XB--B-ME-----------X-?--E-X------BM?----X----M---XX--X-M-X-X----X-E-BB-o------X?X--B------E--XX|------X------X--o--X------B--X---?o--------XX---?
---EB-|---------X----XX------------X-o--X------o----X------oo-B----------B-X-E--------X------BX--E--o---X-XB------o---X------o-E---------B------------|-X------MX--B----oB-----------X-----E---X---?----
E-----|-------------X----------------E--B----------X-------------------XB---|----X----X--X-----?B-X--?X-XX------X---?--X--E-X---X-o---E-------M-Bo-B--XE----------------E-------X-o----X-----X---X-X----
Xoo-o-|--?--?-?--?-------------E------o------X--B--------Eo--o---o----------X----X-o-------B-o-oXoBX-----X-----X--?-ooXB-----------o-X-oX---o--X-----oX---o---o----X-X----o---B----XX----o---------XE-B-
-B----|--T-------oX-X-o----M-B-------B----X-----o---X----?------X---XX----X----X---------o-X-------X-------X-----------------------B-X-X-------?-o--------E-B-?---------B-o---------XX---XB--B----X----X
------|--Xo-B-----------X---------------E--o-oB-------------------X------B--------X-XM---------------o--X--?---B---X-----------B----o-X--oo---XB--MX-----------X-X--M--X----B------?o--------XT--------v
---M--|-X--------X----?-------?-?B--X---o--------B--X-------X----?----B------o-Xoo---X-X-X----B----X?------X--------BX---B---X---X--XB-X----------X---o--X--?XE-X----X-o-------o-------X------|------E--
X-E-o-|-----M--M-X-----o----------o------X----------o-XX--------X-------o-E----X-X----?---o--XE--X--o--------M-------o---B--Xo--o--XB-X------?-------o--o------B--M---?--------Xo-o-E-------X-Xo------X-
----?-|X--oo------X-X----o------?--X---X--X--------X--MX-X----X-X----B--E---X-M-----B--B-------?---XMoXo---Eo-X------X---XXX-XEB--?---E-X---o---o--?-o-XX--M----------o-----------?---oE------o--B---?--
-X---B|----XX-X?E--------B-------------E---X-----X------X-E--XX----X----B-----oX--------------o-Bo-B----------X--o-o----------E-------X---BB-E--?--X--X-----?---------X--X------------?---X-E-X--------M
--X---|X?------B-----o-----?-o---------B--X-X----X--X-o-o--XX---X-------X------XX-----oo-MX--B-B----X-o-X-?--------------------X--T-X-----o---------X-B--E-X----B--o-o---B---------------X?------------o
---XX-|-EX-------MX--EXE--o-X-o-------------XX-Xo--------?-X----Xo----X-Xo------B-----X-----X-------XM-oM--X--------EX---o--X-----XB-----X-X----?------E-------o-B--o--o-------X-B?------B?-BX-----M---M
m--o-X|----X-X-?--?--X--X-o--X------XX--M---XX-X------?-o--------------------o-o?---X---X-----------E------X---X-------E------X--M------------------X---B--E?E-------o----?------?-----X---X----X--?----
X-----X-------X------X------E----E------B-------B---T-------B-------X------E------o--X--M----B--X---?------?-TB-----M-o-|X------BX---E-X-B?-----X--------------Xo--B-X---BX?o--B--B--o------TXXX--------
