--B-BBBX??-----------------------------oBM---------------X---------BBBBX--o?X--------------?X-----------------------E?X----------------------------------------XXXX-XXXXXX-------------------BB?--------
--------------XB--------MXX--BBX-BB----------BB---------o?BBX?B---XXM---B--------------oB----------------BB-------------------------BMX-XXB?MBBX--BX------??o---------?XBX---BM-------------------------
--?M------oB------------------BXX-------------B---XB----------------MXMXXB---MXX-------BX--------------MB--------?--------??BB---------------B--BXXXX-----------B-----?XB--X-----B----------------------
-----------B?-------------oXX?B---------o------------------------------BBBMB----------------------o------XXX-MoX?X----BX---BBX?BX---------------------------------M----------------------------XXXBB----
-----X---X--?X--BBoMM?BBX----------------------------B---------X?BBMBXBMBBBBB-------------?BMX---------------------------M----?----------BoB-------------------------------------------BB-M-------M-----
-?---B----X-----------XB-XX--X------------XXXMX-XB---BBB---MBBBM----------------XXBB-------XX?-------------?BB-------?----------------X------XX------------------------B--------?XXX--------XX-----BBB--
-------------------------------------------------------?EB?---BBX---------------------------------------------BX---------XX-----------------------BXB--------------------------B--EX?BBBB?--------------
----------oBX---------MM----?BXM?BBB?XBBoBX-B---------------------------------?XXX-------XBM?M-------?B------------------------B----------???---------------------------?XXMB-----------------XXB-XXBBBv
--------X--------------?-------BBB----------------X--------------------?XBB---------------BBX------------------XXXX-oXX--------------oB---------------XM??-------------oX--------X--X??-----------------
------------X--------------------------------------------------?BX--------?---------------------------------?B-?B--BBBB--------------------oBXXXB-------------XXXMXMB?-----------?B---M-----------------
----ooXXX---------------?B----o?-----------?---X----------------XBBEX-------------------o------------------------XMB---------BBB?M----------BB------B--BBMBBXBB?---------MXBX-XB----------------B-BXXX?-
MBBX-?BB------------------B?MB---------------------o----------BB?XX-B---X-------------------XM--------------------------XM----------------BXXBX----MBB-------?BBB----BM-------X?X-X---------X------EX-B-
--------X-----------?MXB------------o?----------BX--------------------------------XXB?B-MXB-----MX-BB?X---------------------------EXX??B----?XX-----------MB------------M---??B----BX---------X??-XBXXB-
-----XBB--------?TBB--------------BX--X--------------------B?---------------------B---------??X-BX?------------BBBMXXMBXBBX-X------------------BXX---------------X-------------------B-BBM?-M-----TBXX-o
m-TBBBXB---------|?BB-----------------B?--XTB----X-----BB?BX------------------T-----BX-----------B---------T--?M-----B----B-----------------B?BB----BXB------X----oTX----------BXXT----B----------BXBX-o
XXBBXXXXXXXXXXXXXXXXXXXXXXMBXXXB--BB-BXXXXXXXXBBXXXXXXXBBXB----?B?XXXXBXXX-BXXXX-BB-XXXX--X--XXBB-BXXX?XX-BBXXXXXXXXXXXXM?-XX-B?XXXXBXXXXXXXXXXXMXXXXXXXXXBBXXXB-XXX?-XXXXXXXXX-XXXXXX--XXX?MXXXX?XB?MX-
