--o---T-T?---------B-XM-MM----B---o-------------o------B--XX---------Eo--B-------|---|--X-----BT--TB----XB----M----Mo-------------------|--------------------------?------------------------------------
----E-|X?-----o------------X-X--B------------------X------o--T---------o--------------------E---------T-M?-o-----------------E-----------------------------------X---o-o-E-----|---------|------MT----B-
-----------------E??-X---------o-------M--M------------X------B------------------X-------?-------------?-B------T-B-------------B---------XB------M--XX----------T---------X------------------M---------
-------------------o---?--BB-----------------M------------------------B-|-------------------T------------------E|B--oX?o--------E------o----XXB?-------------B------B---B-T--------------?X--T----------
----B----?---------BXX-----M----------T------------?-------------------------X-------------------B-----o?---X----X?X--------------------o--------T--------------o-------------------o------?------------
|-?o----------------------Xo---|------M-----B------o---------X---|--o--?-o---o--X---------------o------M-----------------------o-o-B---------o---------T-|------------------E-T----------------B--------
---?B------B--???-----------TX-------------o-X-XB-----B-B----------------XB----------M--BB--T----|-------X--------oB------B-----------------?-----B----B-BB--------------------oB---MB---B--------o-----
---------------------o-----o--------B---M--o-------------E-?--------T-----------------T|---o--------M--ooE---------------------E-------E------E---M|--X----?-------------X-B-----------M------X--------v
-----M---X--BEE-X--------X-E-----------oB----------|----|-------------------------X-----------------------------X---o------------?-----|---|--------------X-|--------------------------------|X---X-M--f
-XM---------BB-XMX-------------------------B--oBB------X----------X-----------|-o-XBB--------X--E--M--------X--------E---------T----?EB?X-|-------------------BX---BXB-M----------T-----BXX-?------XB--f
----------------B-XMX-----------E-T-----------BXM---T-BB--------XB-------B-----X--------o---T---------XBB-B--------------TB-----B---------------T-X------?--M---T----?------------|---o-XX?------------f
-------B------o--B---------?BM-----------------XBX----oXB-----B--M-------------------------------------B-T-------X--T----------|------------o--B---------o-XXM--|---BTX-------------?B-------------MB--f
------MB------B----?-----B-------------------XX------------------X-T--Xo---X-----X--XB--------?BXE-T----T---X-------------o-----?-------?-------------oBX-----T-------------------------X--B-B---------f
-----------E-X----o--|?-|---XXB-----------------------MX-----------|M-------?----------Bo----------B--------------------o------|------|-----------XB---------?BX-E--------------o--?-------------------f
m---------------XB?XB--------------B-----T-----------XBX-------X-?---X------BB-----------------B?B?-BB------------------------ToM?-----------------------o---------o-------------BMM--------?------TX--X
X-----------o-X---------------M-B-oB--X--M-----------------o-----o---|---oB---------|-T-BM-------?---T--?---------------?-----o---T--M-----EB--|---------X---T---------------E---------------T---------X
XXXXX-|X--XX-XX-XX-XX-X-|X-XXX--XXXXXXXXXXX-|XXXXXXX-XXXXXXXXXXX|XXXX-XXXXX--XXX-XXXX|-XXXX--XX-XXXXXX-XXXXXXXX--XXXXX-XXXXX--X--XXXXX-XXXXXXX|XXXXXXXXXXXXXXX-XXXXXX-XXX-X-X-----X-|XXX-|XXX|XXXXXX---X
