EX---X--------B---X----B-o?X---------?-B-------o-M------E-oo--E-?-EX-----X--X--------X-----X--------------EX-----XoX--X-----?-X-X-X--X-Xo-------------------XE----Bo--------X----------EB--B------B-XX-X
----B---o-----B-----?-o------------------o--B?----B----X-?M----X?----E---?-X--X--Xo----------X------oB--X-BX---o---------?--------------X-X---X------XX--M----------------MB-------------X-----------?--
--Bo-B-MB------Xo-o----o------o----?-------------X-oX---o-----------B--XE----------EX-o--o-------Xo-X--X-----X---------XX-X-o------X--XE--o-X-o----------?-o------------oX-?E-------------B---X-o---B--X
-----X---------X--X--o-BM--XX---------o-------------B--oX--XX-------?o-----M-X----X----------o-------------B-----------X----M----------X----X-----X?------X---B-X---XB----X-o------X---X-o--X--M-E--Xo--
---X-------E----oo?-E---XB-----?o--o--------------------B----B--E----------------oXo------X--X--B---------------------B-?------------o--X?---X----B-----X---E-----X-E--X------?---------Xo?-XX----?---X-
o---X-----o--X----?-oXXX-X?--E---X--X---X?-?-----X-Xo--X--X----E--B---------------------XX-X--XX--X---E-B--X--X-X------?---oE--X---------X--BX-E-------?--------X-ooo-X---------?----XB--XX-X---X--X---E
--------M---------------E--E-M--?B-o---B-B---?XE---XB-X------?oo--X----B?-o------------E---X----X-X------BE-o-X-B-----XXo---EB----------------X-----o-------X-----------------?---------B----M--B--M-o-X
---X--------XX---?-----o---B-X-o-X--Xo--B---E----------o-----X??o-----o--XBM-------X---B---------X-EX--?-X----Xo-o-----X------X--------B-o----------B-----X-----X----------X------------------B-Eo-----v
-?------X--?--Bo------E----X------XX-B--?-----B-----XE-B---o----X-X?X---XX--E---BM-------B--X-?---X---B--X-E-----BMX-----MX-o-X-B-------BoX---E-----X---o----X-X-X----X--XXX----MXXM-----EE---oX-----o--
o----B-X-----B----X----E-----X?----o------BB-oo---MXE--------?-EB--X---------------X-X--XB----MX---M--?o-BX-o-E--------M--o--X--------?o----o---?------------B---X--B?B-X---XM-E---o-o----X-----XX----X-
--?------?--X-------X---X---BB--B---XX-----oo--------X---B----X-----X------X---M-o?---------------E--oo---B-------M--------Bo---X-o---o-----?--X----XoB--------------------?-BE----------------o--XX--?-
---------------X?oXXXB-X-----X------X----X?X---o--oX---X-----o------B-------BBo-E-BXE----X-------B----E----E----------XX--------------o----o-B--------X------------XX-----B---------------------------o-
-E-B-X-X-------X----------------X----E-------------X-E-----?--E---X---------?XE---X---M---M---E?XoB-----------X----B-oXE--E-?----?---X------XB------B----oX---BX---E------B--------M---X----o--?----X---
-----o-E------EX-?---------------------XXM------?-B-XX?-------------B----o----X-o--------Eo-------XX-o----X--X----B--o------ME-------o--XB---------E----?-----XX--------B-X--X-X--X------?---BX-----B---
m-----|-o-o---X-o----E-X------------------X-E------------------X--------X---X----EEB----X----o-BX-----Xo--E----|--------XM--Bo-----------?o--B?-X---------X-EX---X---E---------XMX--|-o---M-Mo---?-|X---
XXXXXXXXXXXXXXXXXXXXXXXXXXXXXXXXXXXXXXXXXXXXXXXXXXXXXXXXXXXXXXXXXXXXXXXXXXXXXXXXXXXXXXXXXXXXXXXXXXXXXXXXXXXXXXXXXXXXXXXXXXXXXXXXXXXXXXXXXXXXXXXXXXXXXXXXXXXXXXXXXXXXXXXXXXXXXXXXXXXXXXXXXXXXXXXXXXXXXXXX
