---------B-------------------o----o---------o-----o--------M?B-----E-----o------X---------?-M-----o----?X--?B-o--X---MB----X---------M--------------------XXBB-----------X----------------------X-------
-X--------?-----------B-B-----------------oX----B--------------?M-----X-----------o----------------------------o?-----------------------------B---------------------o--------------------------------X?M
-------------------------BBBB-----------------------------------------------B----X?---M--E------?-----oXBB----X?-----XX--BX-o-------------------------------------------BB?BBB?-------------MB----------
---oB-------------o------------B---BB--?--------B------------XXX?-----------------------------BBX----------X----------o--XB----------X------X-BB?----B-XX?B--------?B-BBBBX---------------------E?XBX---
o-------------X------?M----------------B---------?--ooX------E---------------BB?------?--M-----------E?------EB--o?BBM----------------o--?--E-----E?---XXB------?--oB------------B-o-MB----------o------
--------XB-------------BEX--?-------M-----------BM--------BB----------------?X-----oX-----BB-BX--BX--oMX-------------?o----M-B---------------XX---------XBBBB---oXEB------------X-----------BMB?--?BB-?-
----------------XX--XB---------------X------------------X----B--B---oXXX-------?---------------------------o------------------XMB--o----------------------------?--------Mo----B-B----------------------
X----------------X----------B-X-X-?----?-XX-------?-----oMMX------------------------BBXX--B-----XE------------o----X-------------------MB-X-XB-------------------X----------------------?--------------v
X------------BXBBB?X-----------??-----------X--------?B-----o-B?M-------oBBB?-M---------------XoB-------------------------------XX--------------------BBXXB-------------oB-----------XXM----XB----BXMBMf
--B--------------------------------------XB-------------------X-----M---------------E--M-----------X--B---------B----B-----B------------------E-X------------X---------------oB----------------oX-----Xf
-------------XM?----------------BX----oB-------------X?---XB-------------------X-----------------------------------o?---X---------B---B--------XX-M-----BX----------------BM----------X-Bo-------------f
------X-----------BE-----M?--M--------X---B-----X-X--------X----------B---XB-------B-----------------oB---?--X-------B----------------------X-----MEo----?X-X-----------------------------------------Xf
----------XB-X------B-B----------------X----B-----------X--B---o-------------M----------X--BBB-----------Xo--------X--X--BXB---BXM-------------------------------o?---------------------------------BBBf
----------BBBX?-----XBBM-----E-----EB---------B-------MBMB-o------------------B-MB------------------XB-X---?B------------X------?--------XXB---E-o-BBB-------MB---E-----------------XBoB---------X-----f
m----B-o-E------BX------------o-----X---------------XB--------o--E---------------------------------------------------o---------------o------------------------X?X----------------------------------X---X
X------------------XB-------X-----T------------------------X-X--------------XB-?------?XX-X--------------BB--------E---o--------------o?-----------------------B----------------?--B---XB--M--------oB-X
X--XXXXXX-X|XXXXXXX-XX-X--X-XXXXXX-X--XX-XXXXXXXXXXXXXX--|XXXXXX-XXXXXXXXX-XXXXXXXXX-X-X-X--XXXXXXXXXX-X-XX-|X-XXXX-XXXXXXXXX|-XXXXX-X-X--X-XXXXXX---XXX--XX-XXXX--XXXX---X-XXX-X-XX--XXXXX|XXXXX-XXXXXX
