---Bo-o--X----------o----X---------M-------?-T----------X-B---E----X-XX-X----o---------o----------X---------M?----o------X-----X--o-E---------B----XX?--?---X---XX-X--X--BTE---T-----------B-XX-----B---
-T--?-T------X-X---------XE------X-T----E---?-B---X?-X----o--?--TE?-------TXBo----X?XX-------E----?-X----BX--E-?--X-----------X-----TXX---------X--X---------X-------------oX-----X-B----X----o-Xo---X--
---X--|XTo-X----------o---------X----oMEB------------oX---X---?o-oo-T---XX-X------oXX--B---------?---T-oE--X-X-----XX-----------?-o--X-XXoX--T--XX-----X-------------X-o---o-----------------XB---------
------|--o----B?X-----?---E-------?-----MXM----oTX-B--X---E--T----XX---XB-X-?--BB--X----------X--E-Xo--X-T----X-XET---B---X---oX------?-----X-X----------X--X-o----------X--XX-----?----X--T-Xo---------
-E--XX|----------------------------M-------X--X---XX--X-----X---------E-X?XX-------E-----M------E----oB-X-T-o-X-------?-------E-------?-X-----E---------------XX---o---------XX--X---X----X----X---X----
--X-o-|-------X-X------E-Xo--Bo-----E---------M-------T-T--------------X-X--o-o?-------------XT---?-----E----------BE--?---B--o-----X------Boo----oBE-o----ooo---oo----T----X--B--X----E?-XoE-----------
-X----|TEX----oB-----ToT--XXX-------Xo-X--X-----X--------oXo------T--XX----X?---o--X---XX-?-----E---XX?--E-X-X----o--TXX--XTB--X--X-X---o---X-T--------XX-----o------XX--X---??--B-XE---X---------o-----
------|-?---XX--X--TE---EoM--BE---------------M-----X--XB--------------o-----BX---X--X--T-----X------B-X----------------------o------------------Mo---oEX----?-------?--------X--XX--E---T?----?-B--o-Xv
-T----|X---------X-TXX---T----X-?---B-----X?-o------X-B----------E------------X---o-X------M-X--------------------B---X-M-M--XE--X-?------o------X---XX-----X-oXE-X?B---B--?-T------X------M----?----BX-
B--Xo-|-----B--------XX-X----?--X--------------o-o-B-o--X-X-XX-TT--B--XB--X--X--------E-?X----X-X----X---oXo-------------B----oXX-------X----X-?-----XBX--------B--?--X-M---?-o------o--T-X----XX-------
-----X|---T------?---o----------------XBT--------EE----T-----?B---------X---X-----?---EX--------M---X----T--X-----X-BM--X---------To-------------X-----E----XX-------o------B----B--X--E--o--------MXBX-
-oB---|-B--o----X-B-X?----B---oo---E-?-X-X--Bo-T--B---X----?-------B-------?-B------B-----E--T----oXX---X--oX---E-Xo--E--X-oX------B-----X---oX-----T------o-----o---oBo------E-----X--oX--XX-B---------
------|--T----XM-X----------?------X--X-T---ET----o-BM--oMX--T-TX--XX-------B-ooXM-oo---?--T----X--X--------E--?------XB----------X-X--------------X-------X?--X-X-Xo--X-----XX-X--X----XB---o--?---X---
-o---B|-X|---M-------------?---XE---BX---o-X------------------T---X---XX---------------E---------E-X----------X-M---XX---X--------o-E-?---oX---------TBX-XB-X--Eo---------X-X--X----B-----X--X---X--X?--
m-----|-o|--EX-X-------o---X---X----------------MXE---B---BE--|----X-----oX-X-------X------------------BE-E-----X---XB-------X-------X----T-XX--?---X|---X----?---B-E--X-----X--E------X--XX?---------ME
XXXXXXXXXXXXXXXXXXXXXXXXXXXXXXXXXXXXXXXXXXXXXXXXXXXXXXXXXXXXXXXXXXXXXXXXXXXXXXXXXXXXXXXXXXXXXXXXXXXXXXXXXXXXXXXXXXXXXXXXXXXXXXXXXXXXXXXXXXXXXXXXXXXXXXXXXXXXXXXXXXXXXXXXXXXXXXXXXXXXXXXXXXXXXXXXXXXXXXXX
