o-------?----B-------o----------------------------B-?-------||---------T---B-------------o-E--oE-|--------------?oX------------XB-|-M----B-?M---|------o----------B------B---------X-Bo---o-------------
T----|-------------E-----o----------?--------------------o---?--o---------------E--X--------o----B--------E-----B------------------o---------o----E----------------o--------M---B----oB--------------?--
-----B--M---------------------E-------------------------B-X----E-------------------?---B---o--------?--T-------o----------------E--------X-------o---X-------o-----|-----------T---------o--------o-----
--------------|----o-----|B----X?-------B--B-E-----?----------T?-M---------E-----?T-----------------------T-M--o---M-----B-E----------------------o-o-M--------o----Bo---?---o--------------ME----------
-T---o---E-X---EX-----E------M--BE-------o-----T--M---------------B------|-E----X------|-------oo--o----------------o----o-ME---o--------------T----------------B----B-----X-o---------------------Bo-o-
-----------?----------------T--E--------------------B?----?----o-o-------------o----T--------?-----------------B--------------?--B------X?-------E?E--?-----B----M--B|---?--?--?----------X------?-o----
-----------------------E-----------BX----o---------X---------o-T-------o-----?--B-----T-------?-----B----------E----M-E-----o----|-o-M-----BX------To?----------------o-----B--o----B---o---M-------?---
---T------ME--------X--------B--E-----?----E-----B------?-----oT---?-----E----------B--o------E--------------B----------B-------B-----------B---T-E------?----o--------BM---------------------B-------Ev
-------B-----?--B-------------Bo?-B-------|B---------------------------o----E------------B-E-E------|----B------o--------o-------E-o---M----|-----E--------------------X-----o--E--o---XB--------X------
T--o-BB-----T-?-------?-------B--M----E|---E--?-------E--M-----E?---------|B--E-----B----------o-----o----------B------------o-?-oo------?------?-----?--------E--|----------E--------------o-----------
------?---?--------T-B-?-------B--MX----------------o-M|o------M-------|---T----------|----X-B-oT--------------------M?----B------BEo-------?----?------E-------o-E-----E-------B---o-E-----?--B----?---
-|---------B-----B?B----B---------------------------X----X--E-----B----?--T--E----o-----------------------------o-----M---B-M-----------MB--X--X-|---T--E-X-o-o-------o-o---|----------?-?---E----------
-M----B---------XE----oB--------B------------B------o-o---|-X----|--------To----------------M--|---o----B--|---B-------o----?---XBo-E------------X----------o---B-----E--o------E------------X----------
----?-B-T---------------------------X-------------?----|-----------T---o------------T----------------B------------E-------BB-E-----?--M-E-----X-oBo--------------------------X-o----------------o-E-----
m?-o--------------------?--o?-o--?--|----B------------------------------?-----B------T-B--??--B-----o----------------B---To---M---T--X--|---------------XM---------?---X------X----B-----------T--------
XXXXXXXXXXXXXXXXXXXXXXXXXXXXXXXXXXXXXXXXXXXXXXXXXXXXXXXXXXXXXXXXXXXXXXXXXXXXXXXXXXXXXXXXXXXXXXXXXXXXXXXXXXXXXXXXXXXXXXXXXXXXXXXXXXXXXXXXXXXXXXXXXXXXXXXXXXXXXXXXXXXXXXXXXXXXXXXXXXXXXXXXXXXXXXXXXXXXXXXX
