----T-----------------o--------XB------------------E--E-------?---B----o--------------o-----------------------------------B-T----------?-------------------o--------?E-B--E-----?-o------------o--------
--o----?--?-------X--------------------------?---------------------------o---------M--------?----M----?-------------B--|-----------M-o----E-------------X----------T-------------B-X---------------B--E-
---o--------------M---------E-EB-o-----B----------B-----T------BT--B----------------?--------------------------?-M----------M-?-----B--B---o------------?-----------------------------------------E-----
-----E----------B-------o-------------------E-|---------------B-----------------B--------------?-X--M----B----------------|----------------|-oB--------B---M---------B---E--------------B----E----------
----EB-------o-----B-------------------------------B--X-------|--------o-----------------B--o-o--E-o---o----oX-T--X----------------------------?--o--B---B--------B---------------------E---------------
-----?-----o--B--o-------------------------------o---To---B---?----B--------E--------o--------------------T-------B--------o---X-B-B-----M--To--------X----B-------X---E--T---------B-------o-B---------
---|--oM-----------------?--oo---------E-----B------?----------B--?----?B------oBE----B----B-?--B---|B----------B-----TBo-----X--------B----EE----------o----o--|--B---B-----?---B--E-------------------
----------------M----------o----o--E?-----E----|-----------E---------------E------B--E---------------T----o---T----------------X----Xo--?---------B-E-------?o-----------------B-------------------?---v
---M--------------X?--M--------------------?-X----------E--B--|--------T-----------------EM--?---B?--|--EE------------M-----??------|-----E--|---------B-----o------?---X------BE------B?--o--------oX--
-o-----------------------B----------------|oM---------B-----------B-----------------------oB-------B-------E---|o-B-B----------?------------?-----------?M-----------E---M--B-T-o-E--B--|-XE---o-----EB-
---------T--------------o---------------o-------E---------E-----------------?------?----E------------o-----?--B----o|-----------------oB-------X----------------o------------oX----T-----B--------------
------MX------E--------------E-B---------B-?---------------o------------o---|-|-------?|-----E------------?------------------E|---E----T-------?---E-----o-ooM-B-------?----------------To---?----------
----------M----B|-----------------------B--o----------------?---------M---------E-o------X--------B-M---??-E--------------B--o-EB-----------o?-B--------------------------------------ME--------B-------
-------X-------------|--------B-------o--------E--------------o-----|-o-------X--------E-o---B--E---------E---E------------o--BX------o--------------------------------|--MT---X--oT----------EB-B-o----
m------?---------??----X----E-|-------------o-B-X------|-------M------B----E----o------------?-----o----o------------------T----------?---------T-----E-MM--B--------B---o?--------------o|--o----------
-----B----------------?T-------o--B------|---o--------------o--X---------------|o----T-?---------?--T--?--EE------------|---?--------o--------------X---------------------------------B-o---T--------B--
