------o---------o-------------X-------------B---X---MX--X--------------------M-----?----B-----------oE------o---------MXo---------------------o------B----E---o----E-----B---------------o--?-----------
-----X-BX-----------B-----------------------------------------------EXB--MBB-----------XB----?------------------------------------------------------------------------------E----X--------------B-------
M-M----EX-------o-X------------o----E------------B--------o-------------------------------------X-------o--------?--------X-----------------------?--B?------o---o----?---o-X---------------BB-B-----o--
----------o-------B?----------B----------o----------------B-------?X------------B--MBX------?-------------------oXX-------------------XM-----o------------------------X---------------------------------
----------------------------M------X-------X?-BBB---------------o--------------------------B--X------?-oB?----------------M--------B-o---XB-----------------------------------------M-------------------
---------------------B---MXXXE?--------o---oB---------------X------------------?X-X------------X--X-o--??---oXX--?BB--------------------------------?-------o------B--------B-B---X--B------------------
---BX-BoBB--------------------oB----------------B?--------------X-oX---------------------------?------?-----------------BX----------------B----B----------------?--X-?-MX------X-----o-----------------B
-------oB-------o-?------------------X------X-------X---X--------------------------------------o?---------------------o--------?X-----------o---B--M----------?----------------------------E-B------?--v
----?--X---------M---E-----------?X------M---o------------oB?o---------E--XM------?----Xo------E--------------------o-----------X-----------E?-----M----B---------o------?--------o------o?------------f
-----------o-------E----?---?------B---o-?------------B---E-------o-o-?-----------M---?-----X--BB----X------------------------------------X-----------------B---------------X-------X-B---X------X-X---f
----------------B-oB-B-------?---E---?------------------------------o---M-B-B-BBB-o----M------E--X-----------------------BBM-B-BoB---X-------------------------M-----X----------------------o----X-M---f
----------------------X-------------------B------o---------------------------B--------------M-------------EX-B-E--X----M---X--------------o----E-o-------------o-----------o-X---------o----------o--o-f
------------o----------?---?-----o-o---------------------------------o--------X------o------------------------o------------------------------------X-?-------------------------------------B-X---------f
---------------------------------------------------------------o---o-E----------B-------?B------------------M------------------B--------------------X---B-------M-----------------?----o-B----------o--f
m---------------X-------------------o---T--------------X-BT-E----X-T---------------o-B----------X---------------T-----BB----------oB-B----------------E---------------------------------M-------E------X
-X---------------B-------------------?--|-------------o-T-|---X----|-----T-----X-------------X-----------X------|-----------------M-------------X---------------------XX------TT------?---o----------X-X
XX-X|XXXXX-XXXXX-XX-XXXXX|XXX-XXXXX-XXXXXXXXXX-XXX-X-X--XXXX-X-XXXX-XXXX---XXXXXX-|XXXXXXXXXXXX-XX-XX-X-X|X-X-XXXXXX-X-XX--X-X----XXXX--XX-XXXXX-XXXXXXX-X-XXXXX-XXXXXXXX-X-XXXXXXXXXXXXXXXXXXXX|XXX--X-
