----------?---------------------------BBXMB------XB--------------MMMB?-------X?XXX-X?X--------------?M------------------??-------------------?---?--???-----------------BB---------------------XXXX-----
---------------------------BM-----BB-----------------------------XX---oX?----------------X----------------------X----------------XB------------BBBMB----MMXB-----X---------EX-------------------X??MX---
-------BB-------------XXBB---?XX?-------BBB------BBBB?X--------------------B?BXB--------XX-------------oXX-------------------------------------------------XoBX-Bo?-----B-------B?----------------MB-XM-
---------------BBBooXXB-------B-------------B---XX-B-BXoX------MMX-----B--------------------XB------------------------EB---X?----------??------------------------------B------------B?------B?-----oB---
------?----?-B-----------BBB------BXBB--------------------BXB-------------XX-MXMMB--------------------------------------X-------?B-------------------B?---------M----X----------------------------------
-----------------XXM??XBXBM--------X?B---BB------XXB-----------------------MM---------B-----MB------BX-----B------------------XMB------------------BXBBB-------BBM---XM---?BXXX--B-----B----------------
----------------------E---------MBBB?BX--MB--BX----------??------------B?------------------BBX----------BXB?--B------------XBB----BBXBXXXX-----------BXMBBB-X-----------------------------------XX?-----
Bo-------X-----BXoBX-XM-B-----------------------------XXB-B-----?-------BBB-----------?B---------M--------------o---------------------B-BBXB-------oXX-----B-------MBBM?BBBo---------BXB---------------v
-----XB-------BBM------XX-----------M----BX--BB-----XMX---------?B-?M------XXB--------------------BBBX--------BM--------------------------------?----oM---------X-----------------------------BB-------f
----------------?X---X-----------------------------BXBo----------MBBM-------BB-----------------------------------------BM-MXX---B--MB-----------------------XB---------------M---B--BX?B------?------oXf
--------------------------X?--------?B-----BX?BB----------BBBX---------?---------XXMX--------X--------??B----------X-------------B-BXXB-------------BBBB---------------------B?X-----BXBBBBBB----------f
-----X----BX?----X----------B?BB?X--------------------------------BXMXBXXX-----------BB------BBBB---------oXXB-B---MB--------------------------------------------------B----B-XXXBX---XBX-------X--X?BBf
------------------oBB-MX-----BBXBXX?BM-----B------BMXX--------------MB?-XXX----------MB------------XB-----------------------?-------------------??X-----------------------M?B-------------------XB-----f
--------MBBBBBBB-------------?B-?B---BBXB?B----------BB---X--?XXB?--------------------E--------B------------X---------XBX------M-----------------?X-------------XBMX--------------?BB------------------f
m------------------BX---T----------oBX-B---------------------X------------------B?M--------------XBBX---BBB---------T?X----------?X---B--X------------------------------oX---BBB------XXB--MBB?------MBX
X?---BBB---MMB-----BB-------BBB------------------------------BX?---------BXM?---------BB----?------------------------------------------------???BB----B--?BX?--------B----------XXX--BBB-------------?XX
XX|XXXX-XXXXXXXXXXXXXXX|XX-XX-XXXX-X-XXXXX|XXXX|X|XX-XXXX--XXXX|XXXXXXXX|XXXX-XXXX-XXXXX|X---XXXXX-XX--XXXXXXXXXXXX-XX-XXXXXXXX-XXX|-XX--XXXXX||-X-X-|XX-XXXXX-XXXX|X-X-XXX|X|XX|XXXX-XXX|-XXXX-XXXXXX|-
