--------XX---X--M----XXMB-------------------E------------?------------------X------------------------------X----E-------XX?B-M-----X-------BX----BB-----MX--BB------X---------M?----XXoBBB------X??-B---
------BEMEB?B-------X--XB---------------B-----B-------?--B-------?---BXM----oB----------------------------------------------------?B--------------------B----------------------------B------X-----------
-------BBB------------BX-----XX------------------XBBBB---?-----------------XB??BXXXo?-------?B-o-XB-----M?X-----BB------XXB?--------?X?--?MX-----------------XB----B-M---------?XBB-----------------X?B-
EB?------o------------X?----------------?--------?XBoBM?B-------oXB----------??-------BB------------------E-----------------M?-------MBBMMX-------?BXM??X--XB---------------------------XB--XXM-------X-
----------BXX-----B------------BB--------B-B-----------X-BX-----------?--MX----B------------X?BB-----E--o??B-XX----------------------------EX?-----XMBXXX--XXBBBX---XBB--XXB-BB---MB?-------------------
----E-?M----------XXBM--BXB?-------MXB---BB------X-------------------------XB---------B?BXXBM--------------MB-----------------------XXXX-BB----------------XB--EBXXBBB------------BBX----------MXX?B----
--------------------------------X-------------------BM---------------------------------------------X--------B-o--------------XX-----B-X---------BBBM------------------------------BMM---X--B?---BB------
BoMB-----BB-BX-B----------------BBX-----------------------------B-------------------B---------------BBX?--------o--BMMBXBX--XXM-M-M?B-----BX------?XX--BX---------BX----------------------?BBB?--------v
--------------B---X?---B-------------X---B-------EX-XBBBX-------BX--MooX-?---------------?---X------------BB-B---------------E------------------?----o?B--------B-------------------------BB-----------f
---------------------E-o-------------------o--------X--------??BB---M-------B------------------------------------------BM-MB?---------------------BB---------BX--B-------B?XBMXXB--B---oBBXXB?---------f
-------------E-B----------XXB-------?BBBB--EXBB-----------BBBoB-------------------------------------------------------?--------X?B------X--BB-------BX------------------------------------------X------f
-----------------------------------?BX-------BBB?-----------------BBM-BXXB-----------B-------XXB------B---XX??B--------B------------?B------X-----B---XBX----?BBXX----B?----------------BX-------B-----f
------------------oX--BM?----BBBBXo?----------------B--------------------?-------E------------------BB----------------------BB------MBB?-----EBM?-------M-XBX---------------BB----B---?BX??------------f
-----------?----------------------X-------MBE----------------E--------------------XBBM-E------------------XXB---X?B------------BX---------B--M---------------B?B--------B-----B?----X--?---------------f
m------------------XX---B-----------------------------X------------------------BXX--------?MB--------------------XB-----MX---T----MX-----------TBB---------XXX---EXM----------------------------o?BBXXXX
XX---XBB---XB?------BBBBB?-----XBB------------X-XX-----------BXBXB-------------M----MXB-MEX???M--MX?B----------------BX------|B---------------BXX--B--BBB----XXXXXo?--MXXBBXXMX-XBXXX-BBBBXX------B----X
XX|XXXX-XXXXXXXXXXXXXXX|XX-XX-XXXX-X-XXXXX|XXXX|X|XX-XXXX--XXXX|XXXXXXXX|XXXX-XXXX-XXXXX|X---XXXXX-XX--XXXXXXXXXXXX-XX-XXXXXXXX-XXX|-XX--XXXXX||-X-X-|XX-XXXXX-XXXX|X-X-XXX|X|XX|XXXX-XXX|-XXXX-XXXXXX|-
