-------o-XX--------X---B------XX---E-X---X-----X-X-------X---------|------------X-T?-X---?--X------X---X-----------X----M--------------oB-T------T----|----X---X---B---------E------------M-----------?-
---?o-T|o----------E----------oE---E-XBEB-X---XXB-M-------o--X-X----X----oo----------XB---XBE------X-XXX-----------?-X-X-o------|-B-------X------B-----XX---------X--M---------XM?----B----X----------o-
----o-|------oX---o--X-|---X--o------X--X----------E-o------X--------M------XX------o-------------B-X----XX---M-------X-X-|--XX---X--|-----T-----------------X-o---?---M-------o-----------?o---EoX-----
------|-----------------o-X-----B?----|------X---TX----X--X-Eo------------oXE--XoX-o-E-X----------o---X-X----Xo----E-X-MM----?--------------X-o----o-----o-?--oM-B------X---X-E--X-X-----X--------B-----
X----?|-X-------o--o---B---------------??---XEXT--M--------o-BX-X-----MX----X----XE-?--?-----?--?-B-TXB-------o---------X-E--BX|----E--?B---------Bo----X-X-------XX-------o-X--X------X----MX--X|-o-X--
--X-|-|--X--E-XM--M-X---o--|-------B-?---XX-X-----------------X--oX--X-----XXE--E-----Xo------------------XBX-----B-X---------X------oX---E-|-----------Bo--o-B------X--BXM--X--|--|X-----o-o------oo--o
--X---|B-XX---X--X-X---X--?--X--BB--X----E----------X-E-----XX--M-----------TE-X--------X--------B-XT-X-X?--BB----B----B-?X--X---------XB-X---------XM----XX-----X--|X--X----?oXB-X----X------B--X---o-o
-XE---|---------XX-E---|-X--?-?--X---o--??Xo-------XX-B---T--X------X?M------X----------B-X----XX-X-X-----oX--o----o--X------------E-------X-----o--oE-------BE-------X-----B-----M-|------------------v
----X-|----E-M-?-o----X------EX--------X?---oXB---------?-MX---o--T---M--oo--X-----XXXX--------?---oXX------|X----E-B--E-M--XXXX-B-o-E--------M---?--B--X-M----o-----B-X----o----B-o-------|---X-X-o---o
--|---|E---o--X-XX----------B?X|---BT---------X---o----X?-----------T---E-BE|--X-------o--o---------X|------X-X-------M----------------X-----B?--o------XX-MX----------------------X----B?M-BX?---o--B--
---X--|o----X---|XX-B|---------------X------------X----X---X------------B----o-EB?--B--------------------XX-B--X-----X--B------T-------------X-o-o-------X-E-|----X----o---X---?-o-X?B|-----B----?---X--
--?---|--EE--o----o---XoXo----?--X--X-------oB-o--M-----o-B-X--------B-X-------o---B--ET-E-X-B--o--------B----o---X--X-----M?-o-------X--X------XoX---XX----EX----X---X----o--X--?B-E-----X--------B--o-
---B--|--E------------oBX-E?-------T-X-?E-o---X-----------o-o----XX------X--------o-X--------o|---?-B-BE--X--X----X-----BX-?---X-X-----o?-X----o---oE---X-o---|-X--T-------B--X------X------X--|X--M-XX-
|-----|oX--------X-X-o---|----B---|--o----B-------B----X--XB-------B|----X-o-----B------------------X-----BX?-B-------X-X-X---------B---X-----?o-------|?----BX----?-X---E-------o-----XX-o-T---E?--X---
m----X|--------MX---------XX---X-------------X-E------------M-E--------XX--E--------------XB------------BX---X---X---------?-----X--X---X-----E-X--------XE--------o------|-------X-X-------X-?-o---X-o-
X-----XX------?--o|X--X----|o-----XXX---------X---M--X--------------oo-------X---X-B-----o--X-E--|----X--B---B------X--B----B--------X-o--X--o-X------B-----X-------X-X--X---------Xo-X----M-----o-X-o--
