o---------------------X---------X?------X-EX--------o--------MB--------BB--------oB-------------BMB-?----oX-XBB---------------?------B--------------------------MBX--------------B------------X----EB--o
oX-----B?-------M---------------------------------oM---------?----B-----------B--XBB------B-----------MXB-----------------------------XB-------B--------------------------------------------------------
-X---XB--------EMX---E----------------------------------BB--------------------o------oX-------------B------XBBB------------M----------BBBBB----BX--------o--------------------?XB-B?------------X-------
o------M---------------------------XB?BB-----------E----------------X-?B-------?XX------oB-----MB--B-B----BBXBB---------B-----oE--------B-MB-----------M---o??XM-----B-----?XX-----B?MXMX?BoMXB---------
?-------BBX---------?-o------?-------------XX-----?X------------------oB?MBXB---X-----------XB-----o---------oB-----M--XBB------?-BBBMB---------------------------------XX----B----------XXXXX----------
-------B---BX----o--B-BM-B------------------------------oX----XX-----M-X------------B---------------------?-----X-------o-oB----------------------------BX-X-?B--------o--------------------MoM-------o-
--B---------------------XB------X--------------oB--------------------o-------oX---B------M----------B------BB---BBE?---------X-------------------------------M-------------------------BMX---oXBX---B---
---o------------------oB?--BB--------------------------------XB--------X--BB------------B-----------------------------o-----------B------------MBB---?---B-----------B-?XB-----------------B------M----v
-----------X-------------X----------?-----BX--------------------------------XB----------------------M-----X----?MoBM-o-o?X-XB------------B??-----------B---B-----?-----?B-------------BM---------------f
-----?---------------o----MX------------XBB?M?M--XMXB----------------------------MXX-------BX------------XB?-----------B--------------------------------o-------XB----XBBB-BM-B------------------------f
---------M-E?X?----------------?----------X---------------------X----M-------oMMXBBB---------XXBoB-----------------------MMB--BXB--BXBB------XX---------------------X--------?------?B-BB------X-------f
--------------o---?---------M?XB---------------------o---------o---------------------------------------------------BB-----XXB-------------------------------MM-----------------------------BXoBX---?B--f
-----------------------?B-M------M-----M------MXBBo------XBBBB-Xo?--------X--------------BB----------------------B?--------EB?-----------?BB---------------------------------------XX------E-----------f
-----------------------X-----B---o?-------------B-----------XX-------?BXX---------------------XBBB----------BMXXXX----------------XMBBBBB-------X---------??-----------------------MB-----XX?-----X-??-f
m------o-Eo--------------X-?----------XX----------------o--------------------?----B-----o-----o----BoB--------------------------------X---MoBB----XXBB-----?-XXX---?XXB------------------?X-T----------X
----------?M-o-----------------------------X---?B------BB------X--T?------MBB-XX?-----------------------------M?----------BB---MXXo-----E-----X-------XM-------?X--------BBB-----------X----|?--?X-TB--X
XXXXXXXXXXXXXXXXXXXXX-XXXXX|X-X--XX-XXXXXX-XXXX-XX--X-XXXXX-XXXXXXXXXXX-XXXXXX-XXXX-X-XXXXXX-XXXXXXX-XXXXXXXXX-XX|XX--X-XX||-XX|-XXXXX|XXXXX-XXXXXXXXXX-XXXXXXXXX-X|XXX-XX-XXXX-XXXXXXXX--XXXXX-X-X-X-XX
