-----------M?X--------B?B-------------BMB?-----BBMX----------------oM---------BB----XXBBX---------------------o---------oBB---??X-------X-MB--B?------oBB-------------------XBX------?X-X-------------B-
---------?BB--XXBB---------------B------------------------------------------------XX--X---------?MB------X-BX----------------------XX--BB-----BXM---oBBXXBB??--?X-----BB---------------XBX--------------
---BMMBB-BX------BXXXM-----o-------------------------------------------MX--------oX------?X---BB--------oX------------?B---------------------------------------------B--------X?-----------X-XBB-EBBM-B-
BBB---------------B----B?------------------XM----------BB?----------XBXMB---BB?-------------------MMB------XXX----------------MMBBXXX?BB?BM----X----------------B---------BX-?M-------------------------
--------XM-----X---XB------?B-----------oB--------------------------------??BB-----------------BB-XX---------------------X----------XMM------BX---------------XB----------------------------------------
--------B----------------MBB?BX-------------------XB--?B---------XB-----------------------------BMB--------------?EBXXBXX-----------------------BB?---BBB-X-------BB----oX----o-------------------------
----BBB----------------X----------BBBX---------------------XXB--------------B------------------------------oB----------------BB-?XX--------------B----------------B-BXEM--------------------------------
B-------------XXMB---------B-------BX--?--E---M?--X---------------XXM-?X??-------------------------XEB---------?BBB?BB-----------EX------------------------B-XXX-ooXX-----XXoBMB-----------------B-----v
--------BXMM----------------M?--?---------------------XB----B?------BB-------BMMBM-------?BBB-------BB-------------------------oBX---------------X------BXXBMMM?X---XX-----------BB----?BB---------X---f
--------------------------------------------------------XBM-------XX---XXXXXBB----------------B?BBM--BBBX-----------------M------?BB-?-------------MB------------------BBB-B-------X-BM----------------f
-----M?BBXXBBBB?---?BX-------------------------------------------------------BBBB-----------------------X--XX------------BB-------B?X--------BX---XB-----X----MX-------BBBB--E------?-BBX--M?XXBXXX-M?Bf
-------------------XX---oB-----------------oX--------B-MX?B---BB-------------------MXBB??B--------BM------XMB??---B------o???-E-B?oB?-oB-----?----------MBMXXXB----------------XMBXBXX-?------------X--f
-------oX-----B---------B------------XX-XXBB---------------oB-BX?X---B-----------------XX---XB-------XMBM--------------MB-----------------BBXXBXBXoXMX---XM-----MB------B--X----------?---------?XXB--Xf
--------X-----------MX?X-?B------BB--XX-------------------XBX-BM--BBXX-oX--------------------------------------------??XB-----------------------------------------B-?BX---XB-----------oBB----------oB-f
m-----------BBXBBX---BB?--X?--------------?BB---BB----------MX----oB--oB-------M----o?XB--MB--------------XXX-----B---------B?------B?---------------------?-------?----?--------B--MXX-----B-M?M?----MX
----M-----------B?X--------------BB-------BBB-B?--MBBBX--XB------------------BB------------------------------B---------------------o-----------------BX----------BB?BT-?-B-XBM--??BB?-M---oX-M-B---BB?XX
XXXXX-X-X--XXXXX--XXXXXX-XX-X|XX-XXX-XXXXX-XXXXXXX-XX|XXXXXXXXXXXXXX|--XXXXXXXXX-XX-XXXXX--XXXX--XXXXXXX|-X-XX--XXX-XXXXXXXXXXXXXXXX---XXX-|-XXXXX-XXXX-XXXXXX-XXXXXXX-X|XXXXXXXXXXXX-XXX--X--XXXX-XX||-
