----X----M------o--o-----B-E--BX--------B---------------o--B-----M-Bo--X--EE-----X---X----------X-E-X--------XX-X-X-B-------B-X---X------X----XoMX-X------E--------Mo--o--X--B---?X----E----o--o-?o?----
M-X---T-------X-------------?---X----X---?o-X----------EX-----------Mo-----B--X-B-----B--?---EX--o-E--------X---?----o--E---X-----XB--XX----B-M-----o---------X-----o---BB----X---------M----MM--Xo--B--
----?-|---oo----M------o------?-?---B---------Xo--------------oM--X----------------B-?X-------------M-X----?----?o------E------o------B----------B----X------XX-E----------B-?--------oo----------oX-Xo-
------|X------------B-------??X-------o?---o--XX-------o--XXX-E---B----X-----o-----BX--B-X--------?----?o--X--------X--o--X------X--oX-----X-X--X----X-----X--X--------Xo----X-M-o---o--B----?X-----XX--
o-----|B-?-----oMX?-------B---------------XE-X------E-B------------?------------?---oX-----------MX-----X--------X--o----X-----X-X------X------------X--X----E-o------------------------------------M-Bo
-?X--X|X----------BX-----o--X---X-------X-------o-----X---------M-----o----------E----B-o------X------------B---oo--X---X--------X-oX--------Eo-----------------o-o-E----?---E--X-XEo-X--XM-----X--X---B
------|-EX-X--------XX----X-B---X-E------?--X----o-B--B-------X---B-----BX--E--------B--o-----XE--X?-X---E-X------B-X-B---X-X--oM--M-X-EE---------------------o------------?Xo----oX----X-E?E----B------
-X-X-E|--?-------------o-B-----X-X------X---E------B----------------------Xo---XXB-E---------X-X-----X----X----X-X-XX-----o?--X--X------XX--oB-X---E---?----X--B-?o----------X--o-------o--X-----------v
----B-|--------X----------------X-EBXX---?---------------------B--M---Bo?---------------B---X---------o-----XX-----------o------o--------?X--o------------E--X---X----------EX---E--X----X--------------
-E----|---XX---MX--X--------o-----X-XX---Xo-----X--X---X------------------?---------X--------?------X---o-o-B-M-BB-X--X--X-----------------?----X-------E--X-M------B----Xo--o---o--------?----------EE-
XB?---|-----B----------------M------X-o---MXX-----X-X-------M-B-M-oM------X---o--X--X-X----B------?XB-o-o-o---X------XX--X---?X-------------------B--------------o-o-------E--X-----o----?-----oX---?-o-
X--TX-|oM--EB--?X---X----E-------X-------------B-------EB----E------X?-XB---E-B----?X--------X---------X---B-------E-X-X-----o-----?---X-----------------Mo----------X----ooX-------X-o---X?-B--X---XB?-
--T|--|XoT-X----o---?---------X-----------B-XX--B---X--X--?o-X--Xo-----Xo-----------------?-----------Xo--X--oX------o--------XX---XX--E?---X-------X----M-Xo---o----------------o----------B--------B--
-X||--|--|-------EB-X------------XM--X-T---E----------T-X-B-X-XX-X-----B----------MT-X-X------X---B?-X-----------ooM----E--------E-X------B----X-----X--T----?------X-----X-?---------------------X-----
m-||--|--|X--X--X-------E---X---X-X--BoTM--X--E-XX?---T--X-----------o----Xo-------TX-X-X-?E--o-X-------oX-------X--------------o--o-X----X-XXX--X------|--------X-----X-EXo----??---B-X--X---X-E---oX--
XXXXXXXXXXXXXXXXXXXXXXXXXXXXXXXXXXXXXXXXXXXXXXXXXXXXXXXXXXXXXXXXXXXXXXXXXXXXXXXXXXXXXXXXXXXXXXXXXXXXXXXXXXXXXXXXXXXXXXXXXXXXXXXXXXXXXXXXXXXXXXXXXXXXXXXXXXXXXXXXXXXXXXXXXXXXXXXXXXXXXXXXXXXXXXXXXXXXXXXX
