--BB-----------o----B------------------B----o-B-----X-----XMX------MB-B--BX-X-------------------B-XB-------------------------------oX-------------X---?-----oX-------?BXX------------XX---?-----------Bo
--BMX-----------------------------------B---M-?---XXX---MBB------XXX---?BX---------------BB---------------------B?-----------------------------BoBBX-MBB-?XX--MX---------XX---------------------B-------
-------------------------------------------------------?B------------------X?BBB-----------?--------------X--X----------------------?XM--BB-------------------------M?B--?--M----MX-----?----?B-EM------
MMB------B--M?EXB--------------------------------BB?BB--XXBBX?-BBBX-X----------------------X--------------XX---------------------------XBX------------B-----------?MBX---------X-----MXXXBBMB---------XM
-------------B------------------B---XX-------------X-XBB-BB---------M?-------B------o----B-XB----------------------------MB-BMBo----?M-----o------------------B?--X------------MM---------------?X?BBB--
-M?XBo-----------------BBX?X-----------XXXBBXX----------------?M------------------BBBBBM?------XX--------BB?B--------E------------X?---------BBXX----------B?--------------?-XX-----------?---BB-----BB-
---------------------BMBBB-----------------------B----------------------------------------oBB--B-----?-----oXX------------------BXX--BX-X---------B----M?-----?-----X-----X----------------------BB-----
B------------X--------B-------o--------E??BMM---E------------X----B----------B?BX------XB------------oX-XB-X----o-----?BB---BX-BXMX---------------------------------------------X?-BB---------------X--v
X---oX--------X----------B?X---------oXX------XM-----XX--oM------B--?------XB---------------MB-----B---------------------------------------------------X------------??--oX??BB---XM---X--E-----o-------f
----------------------------------------------EB----BBX-B--------oXB--------?B---------------?X?-----E------B--MBBX--------------------MBBB--BB--------------------------------------B--------X--------f
---------------??MX------o?---XXXX---BBMB-----?B?-------o------------M?----------BBMBX-------------BB--------------oX??X---------------------------XMBX-BBX-----------------------MB-----------------B-f
-------------o?-----------------------------B-?----B-X-------------------X----X?X-BBBM-oB-----------X-----o-X-------X?-------------oEBB----------M----------X----------------X-X--EB---?BBM--BMX-------f
-----XB-------o-----X--------------------------------oB-----B------------------X----------------------------------X-----X--o----------B---------X-----BB-----------------B-oBBMB------------------o--M-f
-------?BB---------o--BB----X-E--M------------o?B----?XBX-BXXB------BB-----BBMBB-------XXBXXBMM---XB--------??------M-?B-B------MXX-------XXBB--oBB-------??BBX--BM--?BB------?-M---------?X-MB--------f
m-----------------------------XBB--?----X-----------------------X---------------?---------B?---B----------B-X----XX-------------------------o------------B--------------?X------?--oT----oXX----T------X
??--?---------------oXB---------XBX--------M------------------BB?---X-X?-X------?-------------------------------------------------------B-----------?---------------XXXXXXXT??----X-|-oBB??-B---|BB----X
X-XXXXXXXX|XXX-XXXXX-XXXX-XXX-X-|X-X|X-X|XXXXX-XX-XXX-XXXXX|X--XX-XXXX--XXXXXXXX-XXXX|-X--XXXX|XXXXXXX|-XXX-XXXXX--XXXXXXXXX--XXX--X-X--|-XXXX--X-XX-X-XXXXXXXXXXXXX-XXXXXXXXXX-XXXXXX|XXXX-|XX|XX-XXXXX
