---------XB-XX---------------------------------------M-oX----?---------B---------------------X------M-M?-B------oMB--oBX---B?M----o------------------B---------B-------------XB-------------------------
---------B--X-------------------------X---------------------------MB---X??-------------B----Bo----------M-----------B-oM-----o----------------------B------BXB-----?X-oXX-------------------------------
----------------X--XM----o--------------------------B---------------o-------------------------------EB-----------o------------X-------------------------------o---o-----B---o?------------------EB---oX-
---BBBB-------?-----------------BBB----BB---------------E--------------?X--------X?X---------------------------------------X----------------------------------------------o-------------BX--------------
-----------------------------B-BX-----------BBXX-------B--------X-------------------------BB---------?XoX-----------------M--------B-----XBX----------------M------B--------M-------------o-------------
------------------------BBBX------------------XXXXBBXB--------------BBBBBB?-------BBXB------------XBX?XX----BXX----?XB---------B-X--X-B----M?XMX------XXX?--XBB----B--BB----------B-----------B------X--
--MBBBBoBBBBMB----?-----------??----------M---?----------------------MX-M---------XX-----------?------?-----------------XX----------------?BB-------------------?--X-?-M-------X------------------B?B--B
--------------------o-----------E----XBB----?---------------o-----B------M---B------------------B---------------------M------------------------X--o----------X---------M?----o-------------------E-----v
----------------------------------BBXXBB--B-----------?X--------X-----?---X-----------------BX----------------------?BBB-------X---XB-----------?---------B-------B--------XXX----B------------X---?---f
B-----------M------?X---------o--X----------X-----?XB-------E--?----------B-------------E------BBB-EM-------------BM---B----------o------------B------B--X--------?--------XB--------------------------f
-------------------XX-X--------B-----------------------------------o----M-B-BXBBB------XX?M------X-----------------------BX--BBBo---X-------E------XMB----------------BM--------------------M---?--BMB-f
--------EB------------BBX-------oX?------B-----M----XB------?-------E---M---------------------?MB----B---XM-------X?---o-----------?XXB------M-----?XX--?------------o---------------X?-B------oBB----Xf
------B-------B-----------------EX-X--------------?X---X-X??----o-----------------X-------------------XX------------------BB---------------------BBX-?---------------?XB-B-XB---------------------B-B--f
-----MM?B-------oB--------------BB-----B-----------------------M-------------B-------------------------XB?------------------------oMBB---------------oXBX-------M------------X-------------?-----------f
m----------TB------------M?---X----B----XB-------o--------XBM------X-?X--E-B?X------T----B-----TB----------------B-----?-------X-X----------XB-----T-----------Xo--------------------------------------X
--E?--??-o-|--------------------o----?----------oBX----------------------XB?--------|----B-----|------------------oB--------MMB-------------------?|--------X----B?----------XMTX------?B--------------X
XX-X|XXXXX-XXXXX-XX-XXXXX|XXX-XXXXX-XXXXXXXXXX-XXX-X-X--XXXX-X-XXXX-XXXX---XXXXXX-|XXXXXXXXXXXX-XX-XX-X-X|X-X-XXXXXX-X-XX--X-X----XXXX--XX-XXXXX-XXXXXXX-X-XXXXX-XXXXXXXX-X-XXXXXXXXXXXXXXXXXXXX|XXX--X-
