----E--------oXX---X-X-X-----------X-X---XX--E---B--?-----X-X---X--?-o?X-----B--EX--------B--------o---oo-----------B--------X---X-Xo---------------------------X--EE---MX-E----X-?--?-B------------X--X
----X-T-----X-----------------------B--?--X-B----------X---------X-------X-?XX-----B---------o--?-------o-X---B-------?-----------------------XX--E--X---------------X--o-------B-----------------------
-----o|--E--?--EB--o---XB-------E-----------X-X-----X----XX--E-oX--X-----------M--X--E-----B-B-----X-XXX-----B-----------X----E-X------Xo---E--------B-X--X-XE-B--X------o---XX------X---X--o-----B-----
-E--?-|---Bo-X-o---o----B---Xo-B-X-B------X-----------------X---X--B--X--B--M---E-E--EB--E-X-------------E---MXX--------------o--B-o-----B--------------?X--?-------?-Xo-B----X----------B--BE---X----?-
------|--ooB----o-o-B---B-----------B-------X---XE-X--------XBE--?o---Bo--Xo--------------o--o-----------o-?EX----o------------------Xo---o-----X-X--XX-XXB-------X-----------E----o---X----X-------?---
B-B-o-|?X?--o----o------X-X-----M--X-X------X---B-B-X----------X------B----------X---X--B-------------X-------X-------MXo-----X-------B-----BBXMX-------------------------X--oX-Xo--B-----------XX-o----
-X---E|--X------?-------Xo-oB--X-E----XB-B-Eo------M----------X-oX---?---M------------X-----B---X----o-X-------X--o---XM-X---X----M----X-o--X----X-----------XoXE--XM--E?BX?------------X------M--X-Xo--
--X---|---EX--E--X-----------------o-o-X----X-------X------X--X----B------------XB---------?--------EXX?-?-B----X-X-------X?---?-------------M-BX-ME---o----X--XX-----o------E------E-----E---XB-B-----v
----B-|------XXXB------o-----B-----?----?------X----o-XM----X------B-----B---BX------o-?--M-------XoX--E--------X-oo--M-o-----X--X-----E-----------Xo-o---EX--X-B---------?-XX-X---B----XX-------B------
-X---X|----------------------------?-------?X--BE---XX----X-?X-X----?----------??-------?B---------X---XX--------?----X--X--X---o---M----o----X-------X--------?o-------X--X--X----o?---M----X--ooX-----
---B?-|-------E---o----o-----?-X-------------o-E----?----?--X----------X--o----X---BX-----?--X---------?Xo------o------B----X-----XEE--o------X---------o-X----X-----XoXXE----X---------B--B--X-X--B---o
--X--X|------E----?---------X---?------------X-----X-----o-----------X---X---------BE---E--MX--B-X---EE?-X-------------o---o---B--E------X--o----X-E-------X----X----B--X----X-----X-----oM-------X--o--
-?----|--T-X------XE--B-------B----B--X-------X---o-B--E------X-o-----------X------B--BX--BXB-?----B---------M-----oM-B----B------X---------?-X--X-B-----------?------B---XX----?------?-----------X----
o---B-|--|--B----X-----B-?-----X-----X--X--o--X------------------XT---o---oX----?o---X--o--?-----------o--X---X--------------X--?E----?--E--X?----X----XX--X-----M-o------------M--Xo--X---------X------
m-----|--|--X-----X--o------X--oB---EB---------X-?---E--------?---|o--X--oXX-----X-X--X----------B-X-XBM-EB-X--------?-X-X--X----------?--X-M----------X-M---?-----X--B-B-----XX---X--o--X-----X-X-----X
XXXXXXXXXXXXXXXXXXXXXXXXXXXXXXXXXXXXXXXXXXXXXXXXXXXXXXXXXXXXXXXXXXXXXXXXXXXXXXXXXXXXXXXXXXXXXXXXXXXXXXXXXXXXXXXXXXXXXXXXXXXXXXXXXXXXXXXXXXXXXXXXXXXXXXXXXXXXXXXXXXXXXXXXXXXXXXXXXXXXXXXXXXXXXXXXXXXXXXXX
