BB----T-?---T?----XX-TX-------T--------o----B-Xo---E--XMTXE-----------TX-----------o-M-----?--?B----?-------------o------o---TX--?---------------------------XXo---XX-----X---------E------Xo----T---E-B
------T------o--E-E-o---oo------M--------X-X--------XX---X-B-----o---BT--o--X--------XE---X--------X--?X--------------------------B----o-X----X--oX-----------T----o----TB----------X---E------------BXX
-X---X|-X---E-E--------------XX-X-----X-X----?--X-X---------X-X------E----------------X----B---X-----o-E----XoB------o-------B?--X---T---?-B----X-XT-o----o--o---------X----------X-B-X--------XB--X--M-
X--B--|--?---X----------------X--o-XB--X-o---T-X----T------?-----?-To------o-X--X-------?-o----------oXX---T---XT-XXX-X--X-X-----o--B-X-------------------X--E---------M---------------------------?----
----T-|----oB-----------X------o-M-?TX---oo-?----M---B---M--------X--X----ET-B-----------B--o-------X-?-XBX-X--E--T-B---XX--------o---E-------oE-o-----B-E--T--M-o?oo---------------T-o--T---E-o----oT--
------|M-?------o--BM--E----X--T?-??-TT-----?-----o----------X-oXXo-----E----------X-----EX-------XB----X--X-X--X-----XX-?---X------X------------X-----------oX------o------T-X--ooo-X--X--X-----B-BX---
oo?---|--X-------B--------X-B-------B---o---XE---------------X-XX-o----X-X-------M---T---?--X-----X-----?----?------o-M-?-------XT----T----B----EE-------------X----X-T----M---------oX-?---X-o-o-------
---X?-|B--X-?--o---o-BoXo-----------?-------?o---X----------------------B--XBMX----X------E----o---o-------oX-BXET---B--------------X----X-T---X-E---E--BX---------o----?---------------oB---X---------v
------|M----------oXX---B-X-------------T---B---X-------B----------X--XXB---------X---X----X--B-BX-----X-X------X--------o-----MX---X--T---------XXB----------B--X?-X--XX--o---oB---X?X?-X-oX-o?-----X-o
oBoo-o|----X-------?--X--BM------?--------X--X?---X--X----------X----------------X-X---XX-X-----X---------------XX--X-T------X------------------B----X--B-XX--------X-----B---E--Eo------?-----E-T-E--o-
B--T--|--o-?---------B-----B--o---XX---X---B?-X-----B--X--?XX-E-X---------?-M---------BX-X--X-X-E---X----------EB------------?-X---EXM--TXB----?-X-----B-----------X--oXX----X--------X----X---?----X---
--B---|-E-o-X---oo---B--X--X---?-------B--X-T--X-----BX-----XX--------BX------XX--XE--X--------o----X---X--------X-?----------o--E--------------?--X--------XXB---B-------------X-XB-oo-E---X----?X-----
-B--oX|--T------B?------EE-TX---E---Bo-------X-----o-----EX?---------------------o--------o-X--o-E--------XE-o-X-XX-BX-B-------------------XX-TX--E----------XX--T-----oT--------E-M--?B---------E-XX-X-
----X-|--|-----XX------T?-----o----B---o---BXoX----X-o-B-o------X-----BM------X-----X------Xo----T------MT--------------XX-X-X-X-XXE------------------EBX-XX-XX------B---o-X--ooE--?-------X-o----------
mXXo--|EX|---X-M--X--X?|--B-------X-X-----X-------o---------------E-------EX-X--B-----X--o--X----T-X-----T??----EX-B---X------------M--o-M-------X------------X-X--X--BX-B--X-------X--------BB---------
XXXXXXXXXXXXXXXXXXXXXXXXXXXXXXXXXXXXXXXXXXXXXXXXXXXXXXXXXXXXXXXXXXXXXXXXXXXXXXXXXXXXXXXXXXXXXXXXXXXXXXXXXXXXXXXXXXXXXXXXXXXXXXXXXXXXXXXXXXXXXXXXXXXXXXXXXXXXXXXXXXXXXXXXXXXXXXXXXXXXXXXXXXXXXXXXXXXXXXXX
