---------E-----o---------oo--E--o-T-----BXE---------|-XM---------o----------o------E--B?-----------------E---X-----T----o---------ME-o--------------?-o------E--o---------B---To---------------B--------
|---------------------o?B---------M--?------------B---|---------X-------------M-o-----------------------M-BM----------EEM-------M?------EE-------E------E--X--------X----------X-----B---o--------X-----
?--X----------?-----------------------------?---------o--------------B------------E---------------------M----T----M------------------B--------B-------------------------BB--------B---------E-----------
B--------|-o--X-M---|----B--o---o--?-----M--------------|-----X--o------------------T---Bo-o--o------------T------?-|E-----?---?----?--?------?-------|----o?-?---B---o--M---------Eo-----X--B-M--------
-----------------------------M----o--B-----------o-------------B--o----XT----B----ET----------------------M----------B---------E------------?-B-o---------B-------?--------------------o----B--o----?o--
M----o-----?---B-?M------?-------------------?---------------o---oo-oE----E------------------------M-----|----X--------------------|----------------o-------------------o-------------T------------E----
--------o----EE--M-T-B-----------------------------------------XB-----------------------|-o--o---T--------o-o-----------------T---?---------E-X|-?--------------TTE------B------------------------------
--------------BB--?--------o?--------------------M?----oT----T-o-|--------Eo--o--X--------B---------------------------T----?o---------|o---X?B------E---------E---E-?-?----o----E-------o----oM------M-v
-------------------o--EE-B-----?---------E-----X---B-------------M-------|-?--?---o-------E---B--------B-------------E-------o-?-E-------B---------B-|--BM-----E-T-------------BB-----------------------
-----?----?-|o-----B------oE-------------X----?----o---M-X------o----B-E--|-BE?--?-------?--B-------o-----o------------B------BB--|-------|------M--------------------E-B------?---o----o-----M---o--B--
----B----o---o-------B---TE----?--------------|?--o--------?----E-EX-----|-----E-E-E-----|-----T---M--------MB----M--------?--------|-----E-------------o------B--|---------------o---?-----------------
----E-----o--B--------------------M---TX---oX--------------?--B--------B--------------o?o---B------?------o-o------------------o-----o?-----B-------X-----BB------------B------X-B----------------------
--o-o-M---------------------E----------|-B---?---B?----X---E?------------X-----------T------?--------?M-?------XM--------------B----------------E---------E-----------------?E-----?------BB--------o?--
---BB-?--MB---B----------M-----B----------------o------------M-E----To----TE-B--o--M---o--o--E---T----------|--------|-------M---E-----------T--?---------------?|-----X---o--|o-----B--?|---E---o------
m------B-o---B-------|------------B----------X-------------------X------------------------------------------------??-----o--------------?-------o-|---E----------o--M--------|-------------M--------B|-|
-B-|---?-----------------------------E--EE---X-----?---E-B------------E-----?--B--------------T--o-?------T----------------------?-E-E-------E------B-X------o----o----------M-----X---M--?-------------
