----------o----o----E-o---o--------E---E----------B----------|----Bo?-X|---------?M-----------------------|-------o|o-----B---TX----oX--------E----E------M--------------B---X--------T--?---?----B---?-
---T-----T--?------?---------B--------B------o-----B-o----X---B---------------o-E------------T----------------------------------o-----------M----B----E--EX----T-------------------E---?-B-M----E?X---B-
-B-E-----E--o-------T?-----BM---X----B-|-E-------------------?----o-------?---------------B?--o----------B------E------------------?-M---------------------------|----------------------E----T------o-X-
-M--------M------M--Bo--o----M------------XE--?-M------X-------?-------?M-------------?------------o---B----o--?-------B----------------?--------B----oE----o----?X---------E----------M------o-----|---
--------E--------To----B-------o-------?---B----------------------E-M---------E?----------------oX-------T-E----o-------|----E--E---------------------------------Xo---B------------------T--?----------
-X---------M-----------------BB----------------?--B-M--|M----T?------------B------o-------T---B-B--------o----B-----------o-------|-----?-X-------------------X---------B---E--|-oB---B-----------------
------o-M-|------E------------E-B---|------------?--------------E----B|------------B------B---------B----------T------------|X----X------T----------B--------?---------X-----B------B-----BM------------
------E-?--o-------------X-o----------o-----------o-----------T-------------------------?---|---------?---|------------B-----------E------------------o---------?-----B??----o-M------------B---B------v
----------B------E-?---o-o-X----o----EE---o----?----o--oB-----E---B-------------o-----B---------Boo-----X---MB-|-----------------?-----------------------------------E--o---B-----M-------?------?------
-----------?---------------o--E--BB--------------------------E----------E----B----?------------------B----?----o--o-------B------E-------------?---X-o--------------T-X---------B---T--------X------M---
-------------------------------?o------X-------M-B--|E---------oM------X--------------------B-------E-------------E----------------------o-------o-------------B--------X--ME?-----------oo---M----|E-E-
-------MX--X----------------------------EB-T--Bo-?X----------B----?---------B---------|-----------------?-o------------------|----------B------E-E-------|o---------------T--E-?B--B------B-------EM---X
--B--|------------------------o-----?---?------T--------?--------o-MB-------E---?B-E---E------o-|----BoT--------------E--TM-------B----------?---------B----E-----o--X-M--E----o-----------o-o----------
-----B----------M----------T-------?---o---------------------------B-----------------X--E-----------------B----o-------------------------------?----To----------o-------o-------B-------------------B-E-
m--------?-----o-|---T------E---------------?-------------------o--------------T------o?--B-----------E-----EX--o---X--------E--B-----B-B------T---?-----o---B---------------o-?|o--E---o---?---o-?M--M-
----oB---M--o--B-------T--?X----------B--o---------X----------?BXo--?-----------o------------------------------------------------B-----------B-X-------?----X-----M---------B----M---o--?-Eo--o----?----
