o----------E-|-----------------?-----o-T?--?--M------------X--------BEMB-M---?----o--?-E--B--E-------o----------?--------------X--B-------------o--E-----------------------------B--M-------------------
----E---B-B--B--------------------B----------------------------Bo------o--------------------B---X------B----o--E---B------------------------M-------X--B------E--------o------------------------------?-
----|X---------------------M----o-----?------------------------------o------E-E--------------|---------------T-----------B-?|o----E----?----------B-----------------------E----BE-----------------------
--------E-T--------B--|--------T----------BB----------o--B-----------M------B--Mo------|----?---?-B-X------------------------------------------------------B---B---------E----------------o------B----E-
o---T-M--------o----T-----------------XX-|----o-------B----T----o---------o----E---?------?----------oB---------------M-o------?---X----B--------E--E--------------EE---------EM----E----E-----X----Bo--
-------------E-----o-o---------X?---o--?--------M---o--X----o--o-------------o-------o--------------o----B---T-----------M-------M------------?---------B----MET---------?B--o---T----------------------
o--B-------------------o---------------M-------------?----------M|-----M---M---?---E-------|-?-------------X------o--o--------?----E------------o---?-----------B-----o--B-B--TB-----B--------?-o------B
---oo---------o---EB----------------o-|----?----------oo-o-----o----B?-------|---o---M-|-----B----------M-------------B---o--------------M-------B----------?-----E------o--------------------------o--v
-|---------------T---M---------B-------------BoB------------------B-----------o-------------EB|-----------o--X---|---------o----?---E-----------?-------EB---------------------|-X--------------------?-
-------------------------E----B----------o---oo--|----?-------------?-----------------B--------B--|--------?-?E----------o--T|-B-B---o--o-|--B----B----T--?|------------X---------------------B-E----?E-
-?---------E----------?----------o?B-----|-------E--------------?----------------------------o-o-----------------------------------------|------------B--o---------E---------------|---o-----|--|---?---
------------------EE-?--------------?-E---o-----------B--------o-o-------------o------------------X------------------------------B------BoX---------------|-------X-----T--?----------------------BE---E
---------E-M-----B---------o---------T--------------------------B-----------oX-------?--------Eo------T---------------T-----o------B-X------|--X-M---------E-------------------T-?------E------|--E-----
-|---?--------oo---------------------------------Bo------------|-B-E-------o----M--o|--E------------E----------T---o----------B---o------o-----------------------B-----o-|------|----?---------?-X-B----
m-------------E---T----------B--X----X-----oE------------------B--------|B-----M--o---------------------------------------------?-------B------o-E-----?---E----------------------------------------BE|-
---B-E---------X------B--X---|o-M-oB-T--E-----|---T-o----B--------ME--?------|-o-------------------o?-?-MM--------o----o-------------M----?----M---------B---------o-----??-------------M-----o---------
