--------B-----B--oM------X---------------X--------------------EB------X--------oX---------B---------M------X------------B------MB------------------M--------?Bo---------------BB-----------BM----BB-BBX-
-----B---------------------------MM---------------------------------------BXo-------------------------MB-oBXX-BM?-------------------XXXB----oBMXX?-BB?-------------XX------XXBBBB------------------?X-B-
-----------------------------BM----------------------oo--E------?-B--o-X-----XB-----B----BMB-XBM---------B----------B---------X---------------B-----o?-----------o-X---------B---oB---------------------
------------------XBBBMX-------XXXXMMB--M---MXMM---X---------------o--------------------------------------?B----X------------------BX---EM---XX---------X---------XM--oM-----M?B-----XXB?B--------XX----
-BXBBBBB-------------------------------?X-----------XB--------------------------BB---XMXX----------XX--B---------M----B-?-----------------------------BBBB------X-------------------------BBB--------B--
------------X--BBXXBB--------------?-B------?B---o-XB-------------BBBBBM--EX-MX-o-----------------------??---------X---------?B---------------------------X-----------o----------?MB---o-------XXBX---X-
?---o---EX---------B------------------B----B----BXBB--XX-------------------E-------------------------MB--------B--o?o------X------------------oB-----------------XX---XBX-------BX--------------------M-
--------------------------XMEX--BBXB---------------X----------------B-----------------BMX-B-------XX--------BXX--------X--BB---X?BB-o---B-------X-M-------XX--------B--X---M-----BM-------------------Xv
XX------------------X---------X-BMB----o------MBX?-------------o--BX------------X--BX-------------------?B-------?BXX-------------------B--M--X------XXX--XXB-----------XX-----------------------------f
?BBB-------B--BBX--------------------X-B-----M-----------------X-BBB---XM?B?B----------------XX-------------------oXB---------------BBBX----------BB---------------Xo-X----------------XBB?------------f
----------X----B-----oM---------------------------oX------------------------o???------------------?--------o----B-----------B---------------------o?X-XX--?--oBM-----------B----BMMBBX-o---------------f
-------?B---M--------------BB--------------------------------B?-?XB--X-----BBBXXBB-------------------M-------M-MX----X---------oX----------------------------------------------BM---------oBB------oX--f
-----------------------------M?--------------XX-------B?--XBM?B-B----?XB----XBBXXX-----??-----------------XB-oXBBB----------------?oX------------BX----------------------------------XB--------------BXf
-----BBBBB--------------------------BXBB--------------M?----------MB----oM--------oB?BBBX--------------------M----------------B--oM----------??----BM?XBX------B---------BX-M-------B-?-MB-X-X?BX--XB--f
m------B?----B---------EBMBX------------o--X?------------o?--------B?-----MB-------X-MM------------E------------?X-B-----?BE-X-----B----?--------EXB-------EX-M---?XB-------------M--E?--X---------E---X
X----B-X---BBX-B----?----------------M-?-X----XMXX-Xo--------BB?-oX?--------XXB??--MM--?------X?M--?B---E--------------------?----?---XXB-----------------------------BB-XX----B----XB---------------XXX
X--XXXX--XXXXXXX--XX-XXXXXXX-XXXX-|XXXXXXX|XX--XXX-XXXX|-X-XX-XX-XXXXXX-XX|-X-X|X-XXXXXXXX-XX-XXXX-XXXXXXXXXX-XXXXXXXXXXXXXX|||XXXXXX-XXX-XXX-XXXXXXXXXXXX-XXXXXXXXXXXXXX-XXX-|XXXX-XXXXX|X--XXXXX--X-X-
