Xo------o------------B-----BB--?-----------X-----X---------?o-------oXX--------X--X--X--XX--oB-X--------E--X------------oX-E--E?E-X-------o--X------X--BX---?-------E-B-E---B----X----X-----Bo-----B----
-E------X--XBoB---MX-------BE----X-XX-----X-X--X---?--o-----X--------------X--M--o---X------------B-----E-XXBX--B--E---X----------M-----X-M-------B--------------X-X-----o-X----------------------XE----
B--X---o-----X------X----X--------?--?------B----E--o------o--X-----o-o---B-X----M-----Xo-----X--B-------?-----------------XX-----X--XX--------X-?------------------B---?-----oX--------?-o----?------B-
B-BE---E-o----------oo--E-------X---X-X-o---B----X--o---B-X------B-oX---------M-----X---B-X-----o---oX----X-------B------X---E---X---X--X-B-----E----------B---X-----B--E---o---oo--oBB-----------------
E--o-------------------------o----X--XXX----?--------------B--X--X--------X-XM---X----------?---X---o--?--o--X--------?---X-----E--X------XB---oM--o---X---X------X----o-B-----XX------X--EX---------o--
----X--B-----XXMX-----X------EM---E----X-----------oXo-------------B---------X---X-----o--X------X--B--------o----o--X----X---o--X------XEB-XX------------X----------E-----oX--EX----X---X---X-o--B--M--
-?-----------o---X--------------X-X-------------X-------o----M-------oB----B-----?X----B--------X-?--------X--Xoo-------B--------M---------EX------oo--------X--XE--B------X----XB-X------------M-------
-o-----?-o---X-X--------M-----X--X-------X--X--------------XX--X--o-X--o-----------?MX-----XXX-----XX-X------?---BX----X---X-X---o--------o---B?-X--------XB-----XX----X--------------X------------X--Bv
--X------B-----?--X-------X-XX-------XX-----XE-X---X-----o-M----X---B-X-------------B--B-X-E-----X-MX--------o---X-----o-X--?X----X?o--X-X-----M------X-------X-----B---------Xo----XoX---------X---X--o
XX-----X----??oB-----E----o---X--------------E----X---X----?----oX------X---------------E--o------X------?--------X--o-E--X---o-X-E--B-------------B-o----X------o------X---------------X--M------?----X
----o----o-X--------------o------M---?-------X--B--X--X-o----X--X---o--EX---------E------X-X--------B--X-------------------o----X----------X---------EX-----BXX----------o-E--------B-X-X----B----X----X
---oX-----M-XX----oE--M--------o-X-oo--o?--------o-----MME-B?-?----------XX--------------o----B----?-X----E----?--X--E------------X-B-?-----------X----------o--------XB------XBBo--B---oB---B----X--BX-
-X-X---BX-X----------E--E----X----X----B---------X------E-X---?------E---B-----o-X-X-------B------XX-------XX--o-----X------------------------X-----o---?-X----------------X---X--oMo------X-----X---XB-
-----M--o-E-o-----------M-MX--X--o--?X--X-----------o---B---?-o-----o---?-X----X-X-X----o-------M---X--XX--EBB--X---------?B-----X----------X--?-?------o-o-----M------B---X--------------XX-------B---X
m-----|XX-?----------o-----B-----E-XXX--X------EXBo------------?---M----o----XX--o--MMo-------------oo-----------------o---XBoB---E--E---------------------?--o--Mo-X--MX--?--?o----------X-BE--B-----X-
XXXXXXXXXXXXXXXXXXXXXXXXXXXXXXXXXXXXXXXXXXXXXXXXXXXXXXXXXXXXXXXXXXXXXXXXXXXXXXXXXXXXXXXXXXXXXXXXXXXXXXXXXXXXXXXXXXXXXXXXXXXXXXXXXXXXXXXXXXXXXXXXXXXXXXXXXXXXXXXXXXXXXXXXXXXXXXXXXXXXXXXXXXXXXXXXXXXXXXXX
