M-B-----X--------------o------Eo--X-E--?--o---B---X-E--------M-X--X--X-XX--?E-----E-------Xo--------------X-E----?-------X-------X---?--M----BM---B------M-------------X------?X?-----?-X-----------EEo-
-X----T---X---------X------X--X---X-----X-XX---B-X---M----X-B--------X---o---------X--X---BX--------------o--------o--o------X--o---X--?--E-----X---T-----XX---------------X------X-----o---X----X---?--
oE----|-B-Eo--------X----XX-B--------B-----B-X---M--E---X-----B---X------------E-----X--o--BBo---o--X------------X----?-------X---BX------X-oB--X-B-|X-B-------X-E----XX--E-o-------?---------EM--Bo----
----X?|-X--------X-------E---X-XB--X------o---o-----M-------?--------B-------?o--BoX-------------E--------o------?----o--XB-------------BM-------?-MXX---B---X-----BX-X--X--X-------EX------o-B-----o---
------|X-----Bo---oE-o-E--?--X--B---?---X---B-E-B--------X---------------X----?-X--X-XX---M-X---B-E----------o--X---------?--X-------X------Xo-oX----------?-XBo-X---?---X-X--------X--X-------o-X-----X
X-----|-----------------X--X----EX---oB-X---M---B-----X--X-XX--X-?-BB----X-------------------------E--X----------------B--------------B--oB----Eo-XM------------B-------?-B-X-X---X--------------?------
-?----|--E-X---------B------BE---Xo---?-o--BX?-EE---o-----X----------X?-----M-------------X-----oXX---?-o--o--B----EE--------?----B-------X?---o-X-X---o--X---Xo----XB---o--X-X----Xo---X-------X-------
o-----|-XXX------o---------X-E---E?-------X---X-B--M-----BM---oX---oo-M---X-XXX--X-oo----o---X--XM--oXXXX---?X---X--X?-X----------------E-----E-------EX?---X-X---B--E-----B----?--oBXEB-X-------B??--ov
X-----|B--o----XX-------X-?--------------MX--o-------X---?--E----?---E------------X--------X----X-----o-------MoX--X--?---?-----XXXE---X---B---?---XE----o-?----X--XoX------o----X-o---Xo------X----?B--
-?---o|---o-XB---X--------o-----o-E-----E------E------EM---o---X--X--------X-BX--------------o-----------M-X----------------------o----------Xo----B---------------X-----?------B-X--------B----XE-X-X--
---X--|-------------o--X------X----MX-----E------X-------oX--?o-X-------E----------oXX---------------------X--??---E--B-------B--------X------BX-X--------------o-E--X----X--oX-----B-X-B---X-X-------X-
?-M-B-|----o-----XX--Xo----o---X-------X--E------o-X--B--X-----B-X--X----X---XX-E------E-------X-X---?---o--X---M--EX-X--MX-X------X----o---------BE-----X---X--o--E-----ME--------------XB--XB----B----
----XX|X-T----X----XX-E---------X-----X-----E-------------------oX-----E--B------X-o-------oX----------?-M----o-X-X---------X---BX---X------------o--------o------X--------o-----?--X----B--X-?----M---X
-----X|--|--XT--o-------X-B---EX-------?X--------?---?-E-X---X--MX---------------X--BB---BEo-XX---oB---MX-o----B-----X-X-B------B--?--X----Bo-X---o--B--M---T----------------TBX-B?--X-EX-BXo--E-------X
m-X---|--|--o|o--------?---o-------X---X-----E-X----E-X------------?-BX----XX-X-----?-------B---?------o------?-----o-----XE-------------E---------XXE---X--|-o-X--XX--------|X------XB---?X------X----X
XXXXXXXXXXXXXXXXXXXXXXXXXXXXXXXXXXXXXXXXXXXXXXXXXXXXXXXXXXXXXXXXXXXXXXXXXXXXXXXXXXXXXXXXXXXXXXXXXXXXXXXXXXXXXXXXXXXXXXXXXXXXXXXXXXXXXXXXXXXXXXXXXXXXXXXXXXXXXXXXXXXXXXXXXXXXXXXXXXXXXXXXXXXXXXXXXXXXXXXX
