-?X|--B-----XB----B---E-o--X--E-----------X--------XX----Xo---X---------o----B---|-B----o------XX---------?-oX-----------B-XX--------------------BB-?--X-B-----X-----------------BXMX----?-X---XE---B-|E
-----------X--------oX-----X-----X--T-----B-----------B------?--?--------oo---E---------X-X-o--|--XB--o?--X--EX-EX------ooX---------X--oT------?---?--BB----?E---X--------o--X-T-------|-------X-----X--
------B--Bo---BE-X--------E---oX-----o---?---XMX---------B------M-----X-E-----?------?----------------E-?--------X-Bo-?-----BM------?-XX-------XX?------X-------o--|X-T--------------X---BXB--X----X-X--
-XX--M-|--o----M--------X---X-----EBX------XX-------?X-X---o--o------oX-----X-----o-E-X-oo-----o---o--o--?----X------------X----o-TX----------X---?--------X-----Eo------TXEXX---X----------o----E--X--X
---?o--oo-----X----------X------X---E---EX?-------XT------|---X---X---X--------X-X--T-o---XX?-------XE---X-E---------------X----------------------o-X?------?----X-----B---BX-B-BT--X----|-------X|----o
-E--o--XTXX---M--B-|--XX--B-----?--B-X--X--B---Eo-X--EE-E--?X--o---o----X?X-----------------Xo---------E-X---E-o--X?------EMB--------XoX----X-M--B----------M-XXT--|--oX---X--?------X----?------XX-----
-X---oX-X-?--------o-|?-------B----MX---X---X----X--X---X------B--|----B--Xo----TXMM--o------X-B|----X-----X----M------------X-M---o------?-TM-B--TBX---o---o-----?T-X---X-----------o----o---X-E-XTT--B
o----?-o--|----o--X------X?---------X---X-------X-?--------o------B--X-X-o-X-----X--XT-o----o-------X----X--X-----X--------------X---------T-B------------T-----------EX---X-----------E----?B-----MB--v
B---X------o-EXX--X------?----X----X|----XX-o----o---?-X-E--XB-----X--X----B-o----X-X---------o---?--M--ooX------XEX---------X----------------B--X---o-XE--------B-X-T---X-----o---------X-X------X-----
------o-------------------X-X-----XoX----?--EB?--B--o-X-----X-EoXT----?-X-o-o-------?--X-oo-XT-Xo-X-------X-X--o----XB--X-oX------B-?B--B--------X--M------B-X--B--X--B-----XB-------oooB---X-BX-X-E-Bo-
Xo------o--X------X----X--B--E-------oo--o-B|E-Xo--E------X----B-----T-B-B-M-|o---X--XXM------|---o--------XT------o--------Bo--T-X------B-M-Xo--X---|---B----o-------------E-XX--X--?BX-XoB---X----EX--
------|-oX?----B--o-X--X--------o|-o---BX--B--o?-------------B----o|--XoX--X?X------|---o-------|---o---X---XX----------B--o------X---------X-----------------X----------M------o---T-X----?---TT--B--XB
--X---|--X-------?---M--XX-----Mo-XX-T--------------BX--X-----B---X--------oX--|X-----XX--B---|-XB--------M-----XEo---X|----X--X---X--------X-|--M--E------------XX-o---X-----o-o-o--o----XX?------B-XXo
X-?X-X|-----E---------X----T-B----X---EB?--X---------B--------o-------X----X---?----B---------------o--E---X------X--E-E--X-?-----ET-M-X--??--------|----o-X----oM--------XE-o----X--X|---B------XX-X---
m-----|----B-?--XB---|-----M-----X----XM------------------o-X--o-oX-o-?o---X-----M---Xo-----B-oX-EX-----X--X-----M----X-----o-----X----?---X-BE-------MX--X--X|---M---T-XXM---------------X-o------B---B
XXXXXXXXXXXXXXXXXXXXXXXXXXXXXXXXXXXXXXXXXXXXXXXXXXXXXXXXXXXXXXXXXXXXXXXXXXXXXXXXXXXXXXXXXXXXXXXXXXXXXXXXXXXXXXXXXXXXXXXXXXXXXXXXXXXXXXXXXXXXXXXXXXXXXXXXXXXXXXXXXXXXXXXXXXXXXXXXXXXXXXXXXXXXXXXXXXXXXXXX
