-------------To-------------------------X--------o-----X-------------M-------------------?------------------B---|-BXM---------------------o--o----------------B-----------oM----?--------M-----B--------
-----------------------B---------B-----o--B-|-T----------------E-o--------Xo-------------------------------------------------o--E--MM-------oB---X-B-M---------T-----------B---B---T--|------E----------
--------------BBE------??----B----------------M--E-------------------------------------E---------TBB--BMX--------------------M-X----BX----E---B---------o----------------E---X-o---------oMXoB----------
----|------?-------o-----------B------------oM---T-T------------------M-----------------------B-------------o----------------------o-o-T-----------------------------------M--------------------------|-
------B-o-------------X--------o--------------o-ooB---M--B-oXX------EX----X-------------------------X--------o---------B-------------------?X----------M----------?XBXo?BXB-X?-XT---------------B-------
------o-----E---X-------?------X--B--B--B----B-EXBX------?---E-----o----------|-----oX-----M----------B-----M-?--B-XBo-X---B----------------B--------??------B-----------?--X----B----|--------------?--
-----?-----------E-----M------X----------------o----T-------X----------------------------?X---E--------------B----------------------o---B---------T---B--T----|--------------------X-----------??--o----
-----------T---X---X-----Eo------TXo----T-------B---|-T------X----------M-T----o--------BX--X?X----X---M---T-o--o------------XX?B---------o-o--B----------X-B-T--X----TXX------------T-o--oBX-TM------Xv
-----B-X---|X-----M--------------|---------------------o---|?--T--o----------XX---X-----MMM--------E-------------M------BX---B??--X-X-o--B--------EB--B-------|-------B--------------|-------------X---f
-----------T-------------B-XB-----------------X--T-----T-------|------------------MX-------------X-XM----T-----X-------M---------------------?------------------------------------?--------------------f
-------------------------------------------------------T---?-----MBX--------MB----T-T--X-------B---------|B-BM------------o----B??MBBB-------T--------M---------T-X---o-------------------------------Bf
-----------------X---X------------?-X?---------------X------------o-----------------|------------T?-----o--T---------------------------|-----|-------------o----|X----E-------------------------X-----Bf
-------------------------------------BBX----------MM-X---XBB-----------------BBT------BX----------------B-?B-------o---------T-oM--X-E--X-------------T--BB?--|--M--X--X-----o-M-X---------------o-BXT-f
-------------------------o-----X----------X--X------------o----------------------------o----M--o--EB---oT---------------------------X--------E---X-----?B-----?------o-----M-----o-o-----------------|of
-----------------------------M---------XM-----------X---X---------------X---X--BB---MX----oX-----|--------?---------------------------------o---T--o-----B---B------X--oX----B?-|-----------MB-T-------X
------?-M---------------------T--------------M------------?o-----B---------o-T----------B-----B------o---o------E----T----------------------------------o------|-----------------------------XX--?-X---X
XX-XXXXX-X-XXXXXXXXXXX|XXX-XXXX-XX|XX|-XXXX-X--XXX-XXXX-XXXXXXX-XXXXXXXXXX-XXXX-X|XX-XX-XXX|X-XXXXXXXXX-XX-X|XXXXX|X-XXXXX|XXX--XXXXXXX--X-XXXXX|X-X-XXX-XXXXXX|XXXXX-XXXX--XXX----XX|---XX-XXXXX-XXXX-X
