------?-oB----BB--------X----------------------------X------B--------B-----??----------XB?MBB---B-?XX------------------oBX----B---X-----X----------X-oBBB-------------XB---------E-----BBB-X??M----?----
BE----XX?--BBXBB----B-BB----MBMX----------M---------------------MMBBB----oBB--B-----------o---------------X--------------o---------------------XoX--------------------?-B?---------B-------------------M
-BX-BB-MX???------------BMB----X--B---X-B?M------XB?----X-?--------MXB?X-----B-------XX---B?B--M---B------------------------B-B----------------------BoX----------------EB----B---B??BBX?----------XX---
-X---B------------X--------E--------------B--------X------BX---B----------o--------BBB-M----------o------X--------------------------------------B---BB?--X----B?-----BB----X--------B-------------------
-----------------?----o---------B----MM--------------BBo----B-----------------B-X-B-----------?oB----BXB-------------XBB----X------o------X------------------------------X--------------------BB-----?--
-------------------oBXBB?----X-X-MB---BB------------B?---B-E-------------------MXX--o??--B---------B----------------------------------------BB-----------------oB-----------------BBXBB--M---B----------
---------XXB?XXXXB-------------------BBBM-----------------?BBBB-----------MMBB---------------------------------------------------XBX------oB-----XXB------------------MM-----EBX---BXBB-----------------
B------BoBB?-----------------o--BB?-------XBB--BBX---MB----------------------B-------------------------XX-----------------X-----------MXBBB---MB------------------------------oB---XBXXBX--M?-------BB?v
-------------?BBB---------------B----??-XB--?B-------?-------------o-o----X----?BXB---------------------------B-----X---M----------------------X------XX---BEX---------------M-------------------------f
B-----------BBX-----------------XB--------?-------M?BBMX----MXM?-------BB-----------BBB------------------?-XX-B----BXX----------BB---BBBB--------?BBBBB-----X-------------------------------oXB----B?MBf
---------?-----BXXBB------------------X---------B--BBBB-X?B--M?--XXXB----B-----?B-XXMX---XXX---oBB??oB-B---XXBXXB--------------BB----MX-?---BB----------------------------------------------oX---------f
---------------BBB----------XBBX-?-o------?----MXM-----o--M-o-----------------M-------------------------X-------M---------X--------BB--------------------XBB----X--B---------------------?B--------BB-Mf
----------B--------------B?B-----B-B?----?------BM---------------BB---??---------X---MBB------------------?MB-----------------------------XXX--BX------X---------------BoBBB----------M?X---------?----f
--------------BX-XX-------------o---B---------BoB--BB-----B---------------------?B---------------X-X----------?----------------------------o-M-------------E------o---?--------------oXBX--X-?---------f
m----B---B-----------B--------XB---EM?-------T-o---------------E---?X------BB---------MBX------------B--BX-----X-B---------------B------------X-M----X--B-----o---o----------------M---------Mo--------X
XBB--oBM-----------E--B-----------?--BB--MM-M|XMX--B-----------M-B---X-MBB--------B---MX-X----B---X---B?-------B-----------X--o---------------?BX---X?-----------BBB?----B?-B----o?------------------X?X
XX|XXXXXXXXXXXXXXXXX---XXXXXXXXXXXX-XXXX-X|XXXXXXX-X|XXXX-XX-XXXXXXXXX--XXX-XXX|XXXXX---XXX|XXXX-X-X-XXXXXXXXXXXXXXXXXXXXXXXXXXXX-XXXX-X-XXXXXXXXXXXXXXXXXXX-XXXXX|XX-XXXXXXX||-|XX-XXXX-X-XXXXXXXXXX--X
