--B?----E-------oB----------B?----B--|-----------B-------------E-E--|----X----B-?----------T------------M----------EME----------------------o-------o---?-----------M-------T-?---T-----------E-o-------
----B?---E------E-o----------?B---o---B-|----------E---------E------------E--------------?-----B----?T-------------?-----E--M-o--------------E---o-M-|-----?-------M---X-----?E------------------B|---E-
--M-------o----------------------------------B-----?--|-B-X------BB-------o-----------------------o--XE-B---?---------------------------T-----B-----B---T-T--o-------------T----M---------T---?----?----
---o----E-?--------------X----?------------o----?--------TE--------------------o-M-------------o--o-------o--M--------------X-------?---------------------o---------|------------E-------B----o-------Bo
-------TB-o---BX--o---------------E--------------------B-------|-X?--------o----|------B------------------o------B-----------o------M--E----M---X-------------E----------B----------------B--o---M----?-
--E--------o---E--------B----?--?------------X-----M--?---BB-o---------B----|--EM--|-o---B---B?--------------T-----o-------------------o-----------------X------------?---M-M--B-T-B--o-------------B--B
E-?-----|--B--------M----B----------ME------E---E---M----------o--?M-------MB---------------B----------------------------?-----BB-o-X-------X-----------?--------M-o-------------B-----o----B---o---B---
----o-------------E-------Bo----------------------|---------|----------oB----------M------------------B-X---------M----?-------------B------M----oo----X------o-----|---o------o-----B--------o?--B----v
---?-----E---T-----------------------------------|--?-------X??------EB----?------------?----X----------T-o------o----E--------B-------X--------------------T--o?-E-----B-?---o--B-----o----------B-----
---------------T------B------------------|--o---------TX------?------------M------------?----|BE---M-----B-B-oM--M---M-----?---|---B----------------------B------------------B----o----X--X---------Eo|-
--?------------E--|-|-----------M------B------------B-----------o------------EBE-------------------E--------B--------E------?o---------------------------B------B-----------------B--------------?----o-
----B--X-----------X---o-E--?-X----------------------?-MM------o---M--o------------------------------B----?---------T--o-B-----B-B------T------oB---------M|-B--BB-M--------|---------E--o-----------|--
--o------------|M--------------??-----TEB-?----?------------T-----------B?--o------T-----E------------o--------T------B------X------?--E--------------E-M------B---------|---------?-o----M----------B--
-----?-------------T----?---------------B---B-------|--T-----M---------------X----E------E---E-------X?M------------------------B---X---------------------------o-----E-----?--------o-----------|-----T
m----------E-----------------------o-------E-----o--o-------------X------o--E--------B----?--------M-B-----E--o-?----T--E------o-----------E--------------?------------o-----E-o-B|-T--E------E---------
XXXXXXXXXXXXXXXXXXXXXXXXXXXXXXXXXXXXXXXXXXXXXXXXXXXXXXXXXXXXXXXXXXXXXXXXXXXXXXXXXXXXXXXXXXXXXXXXXXXXXXXXXXXXXXXXXXXXXXXXXXXXXXXXXXXXXXXXXXXXXXXXXXXXXXXXXXXXXXXXXXXXXXXXXXXXXXXXXXXXXXXXXXXXXXXXXXXXXXXX
