M----------X-------------------------X---B-----------------BX------M---oBM-X---XB---------------------------------B-?-XBB------X--------oXo------------------o-------MBX--M---?--------------------?----
---------------E----------------------------B-------E----BX---------XX-------------oX-------------?--X------------E------------B-B---XB-------XX---------BBXB--------?-----------------?B----X-------?X-
-------------------------M----?-E-X-----------?----X-------BX---------------X-B----BB----X----------------B------------------------------------XBB-------B--?--MB--------------o------------------------
--??---E--------------------------?------XB---------BX--------X?----BBX----------------M-------------------------B--XX-B---------------------------XXBX------------------------------B------------------
------------------------------o----o-o-----------------M-------?---oX------------X----------------o------------------------------B------------------------------------------o----MB--------?------X----X
------------XXBBo-----------E--BM--------------------XX---------M??--BBB-M--BXXBB-------BBBBBB--BBXBX--------X----------XXB-----oB------M---MX--------BXMB----------------------------------XX?X--------
------------B-------X?---XXB-BXBB--B--B-B-----XBM------------------XXXB-----X---MXB?B-----?------------B------------------M-B---------------E-BXX---------BX----------X----------------------------EMX--
-------?M----X-B?B?---------BBo----B?XBB-o--BX-------------------------------?------------X----o----------------o-------------------X?BX-----BB---BB-------------X------BBB--M-------------------------v
--------------MB-------?X----XXB-------BX---------?M?---------------MM------o?BX---------BB-BX-XBX--------XX-X----------------XBBX-XM??B-oX?-----------------E----------------?XX----------BBM-------B-f
MXX?----BB------------B?---------------BB-B----XXXBBXB-X----M-BBM---------MBBBXMBBBXBXB--------XX-------------X------------BXBXX--------MXBBMBXXB-XBXX-B-----oX-------EB-------X?B---------?M?-------XBf
--------------?------X--B---------B------X----X----BB-------------oX------------------------?-----------------B------------M--B?MBBB-----------------------------X-----------------oMB--B-------X------f
-------------X--B?oBBB------XM----------------------------------------------oBBBBB--------------------X------B-XX-----------------E-B------------------------------------------------MM--------o-------f
---------------X---BBX---X-----------?---------------------o--------------B-------o-----------o----------------o-------B-----?X-BB-X--?-?-MoXB-XB------B?B----------o---?B------------------------oB-B-f
-------X-XB-------X---XXXBX--------------------ooX----XXB------------------------------------XBBB-----------------------------------XX?-----B----M---XBBBBX?BBB?MBBXX--------XXXX-------------o?-------f
m------B------oBME---------oo----------B-------oXB-B--X----------?--BBX-----B----------X------XBBB---------X-B------X---------------BE?B----------?----------BB------XB-------?-------EBB-XBB----o---BXX
Xo--------------BBB-----XXXMBM----o-M------------?M--------T-----------B?XXXX----------B----BXXXXXXXXXX-X---------M-----------XBXXMBM--B--o-------X-------?------oBB-------T-----------------------TB--X
X--XXXXXXX-XXX--XXXXXX|XXXXX-XXXXX-XX-XXXXXX-XXXXXXXX-XXX-|XX---XXXXX-XX-XXX-XXXXXXXXXXX--X-X-XX-X-XXX|XXX-XX-XX-XXXXXXXXXXXXXXXX|-X-XX-XXXX|X||XX-XXXXXXXX-|XXXXXX-XXXXX-XXXXX-|XXXXXX-X-X-X-X-XXXXXXX-
