X------E--X-ME---o----X---X-----E------o-M------------E------o---X--X-oB--?X-----o-Xoo----o---------------------------B----o-------X-----Xo---o---------X---X-B---E----o--o--------o?--X--------------B-
-B----T------o-----------------X------X----X---------o-o------X--B-----------E--o-E-XX---------X---o-------XXX--------o---------Bo----B---o---o------------X-------X---X-----X-----------X-?--?----XB-XX
------|-X---M-----X--XM-o-o--B---X------X----------X--oo----------B-X---?-XX--------o--X---------X------------------B--------X?-----XE------?---oX---B----BB------Xo-X?--X---X------?-------XBX-X--X----
----B-|X------?E-o----------?-------B--?-------X--------o--------B----?----X--X--B-?------------X------------X-X--X----X-o--------M---------XX--------E--X---------------------X-------B-----X--X-----X-
X---oE|---X----X----X-------------------?-----o----X--X---?---BEX-?----X--X-------oX---E-Bo---XM-----------E--B--------B-B-XoB-oX------o--------E------B-X--X------------BE-----X-X-E-------X-----------
------|-----XXM--X--------?---B-BXX--B--X------X-B-----X--X--oX-E------X-E----X----X-E?o-X--X-------E-BE-------B-X-E-X-------X-o---BX---E-oo-B-X--X---X-?X--oXBBX---------B-oX-----X--E--------X----?---
-X---X|----Xo----X-------?----X---------------X--------B----X-BB---X-----X---------XX---X-----X----B?---------------------B------B--o--------------X-B------o--B----X---oo-----X-E--?--XBo--Mo-----B----
-XB---|---o------X--oX--------oX-Xo---X---E--X---B-oXo-M--B--?-------------------------oo-----X-----?---?-----------X----BX----E-X-----X-----E?--------------------B-M-------?--------X--M---X---X-----v
------|X---o-X--------oE-----XX-E--------?B-X--B------X-E----E-------?----------Eo-o--------XB-?E------X------E---?---X--X------XX-oX-----MB------X-------B---?-X--oXX--B--?E---X---o---E-?-X---------?-
----X-|X-X-X-------B---------X--X--X------------------------?-o-X-X----------?---X------B----------X--------M---oo--B---X-?X----X-----o-o-X------X-------------X-X------------------X----B----X-E------X
-o----|X--X--X--o--X--X---o------X---Mo------oBE---------------B-X-------X-EX---X--B-o--X-o------E---EX--?---------XX--?-------X---X-----B-X-o----------EX----B--B------B-B-X--X--B-X------?-XB-----XM--
E-----|--T-B------?Xo----X--------XXB-------XX-o------X----o-o-----oMX---X-------B--------XX-?-X------?-X-X-------------o-------------?-o--oo----XoXB----o-------X-X--XX---XX--M--o-X--XB------X--X--Xo-
--XX-X|--|------o-M----------?M--X----o----------?---------X?---X---BX-E-----B-?----------o------o-BM-------------------------------o--Xo--X-----------o--E-----?--------MEX----------X--B-XE-oXXM-----X
X-o---|X-|-----X-X-------------EM-X------------X------Xo--------o---------X--X-------------X---X---X----BX----X-------X----X--X--o-oM-----T---E-----------X-------?--o--X-?---oXoBX-?oT---o-----X--X----
m----M|-B|E-X?---------------o----o-XB-X---X-----o-B-X-----------X------X--E-----------------?---M-M?oE-BE--o-E--X---X---X---X-X--o---X---|-------------E--?---------------X---o------|?--------XX--o---
XXXXXXXXXXXXXXXXXXXXXXXXXXXXXXXXXXXXXXXXXXXXXXXXXXXXXXXXXXXXXXXXXXXXXXXXXXXXXXXXXXXXXXXXXXXXXXXXXXXXXXXXXXXXXXXXXXXXXXXXXXXXXXXXXXXXXXXXXXXXXXXXXXXXXXXXXXXXXXXXXXXXXXXXXXXXXXXXXXXXXXXXXXXXXXXXXXXXXXXX
