X--X---X----X--X--oX-B-------X-X---XBX-X-------o----------EXoM?-E--------X---------X--X-----M----X----X-X--XX--X-------X-X----?-----------X--X-?--B-X--X-X------X----------?-----?----B----B---------X--
------T-E-Xo--------o---oX-----------XX--Bo-X--XXX------X-MX----X-XX---B-----Xo---o--?---X--------------X--o--E?--M?-------X--X-M----------X-----XX--X----o---M-------X----oXE---XX----X------X-B-------
------|-X---X------------------ooo-------B-----o----------X-------o-o--Bo--X-Xo----B-o-----B?----X------X---Xo---X--------?-------------B---------X---B-X---o---B--oX--X----X-o---X-X---E-------------X-
X---X-|-------X---------B------o-X-o--------o--X------o-X--------o-B-----------o??X--Bo-M--------o-------------X---XE---X----?E----E------------B-----E---X------------X--B-----X---------B-----XXX-o--X
BX----|-X---B-------B--X-M-----X---X-o----------XX??---B---X-----------M----------B-----XBo-------------o------X----?------BB-------X-----oX---------------EX-XE-B--X-X-----o-M---?-----------X-----Xo--
--X-XE|-----B-X--o--M-?-X------X--MB---B--Xo-------X--o----------EX--?--E--XX--------B-----X-oX-?--o--X--Xo---BX-----B---?-B--X-oXE---BoX------oX----BX-X---o----X---?------o--X------X-----X---o---B---
----?-|---------X--?-------B---------------------o-------X---X---------------XX---------EE----------XX-oX-----XXX-XE---X--E---XE--------X------?E?-----------X-XXX--X--XX----------?-X-------B----E-----
X-----|X-X-------E-----X------B-XX-?------X---X-----X-----B-BX---MX-----XE------M-E------o--X-----X-----?---------o------X--X-XX---o--XXM----?------------o---------B-o-------X---X--XB-o-----------??-v
-----X|---X----XX-B-M---XM---X----o---------B-----X-EX---------o----------------XE---o?-----E-----X-------X--EXB------oX------o----------------?------------oX-----o---XE-----B--X-----oXo----Bo--X-----
-o-XX-|--X---M-----BX---------o---o?----o-?-X--M-X--B-B---?E------B---X----------X-E--------E-o---------B---X----XX----X------------XBX-----------X----X----X--X--o-M--------XX--o----------------------
-X-X--|--X--X---Xo-------------X-------XX---o---B-----X?Xo---------X?----------X-X--------E--------o--XB---MMB?--E-X--------E-----o-o----------------E--X--o--X------X---------X-----X-X?---------o-----
------|----------?BXBX-------------o--X---B----B-M--XX----B--?---o---X---X---X---X--X-?-----------------X-----------BX---EX--E--Bo-X-----E?X-X-E---------------BM---X----B-----X--X--X---X-o--------X-o-
o-TTE-|--BE-------?---------------------X---X--?----B-------E------M--X-X-X-?-X-X--XX-X--?oo------X--XM--BX--o---------Xo--oX-o---------X---BX?------B-------------E-o----M--------MXE----X--X----B-X---
?-||X-|Xo|-X--------B------EX------B----o----------ooo-X----------X-X--XX-------------X--o----B-------TM--o---E----o-oXTo-X---------X?--------?-------X------E--E-o----B--X?---T-B---?o--o----?----XB---
m-||--|--|-XXo----X-E-o-B--X-----X------------o----X-------o----X-o-X----X-------o------?XX-----------|------?---------T----XB--B----B---E--?--E------X----------B------X-T--E-TX----------B--BX------?-
XXXXXXXXXXXXXXXXXXXXXXXXXXXXXXXXXXXXXXXXXXXXXXXXXXXXXXXXXXXXXXXXXXXXXXXXXXXXXXXXXXXXXXXXXXXXXXXXXXXXXXXXXXXXXXXXXXXXXXXXXXXXXXXXXXXXXXXXXXXXXXXXXXXXXXXXXXXXXXXXXXXXXXXXXXXXXXXXXXXXXXXXXXXXXXXXXXXXXXXX
