-B--------X?-?------------BB-----------XBXM----XBEB--BBB?--BB-----o?---------B---------------------oBX?B--XXB?B-----B-----------------------------------------------------------------------------------
------------------------------------XX-------X----------BX------?B---?B-------------------XBBBBBBB-------------------------MX---------B-BX---BB-MBM----B?X----?X--------MB-------------B-------BBBB-----
EBM?BBB------XXB?------------E---------X--EB--B-----------------------------------BBX?BBM--------------?BBX?M----------M----------------------XB-------------------------------??-------??B-------------
-XX------B-----XX?-----B-----------------B--------------------B--XBXEBXB---------M------------X---------------------------------------------XB---MXM------?BBX-------------BBB---?BBBX---------EMB--M---
-----BB---?X------BX-------XM----------BXX-MBB-----??BoX?BX----------------?BB?-----------XBBB-------B------------------MXXM------E-XM-----------------XX------------------------------------oB--XX-BB-o
--------------MMBBB---BXMX---------BMXXB-ME?-----------------------------XXoBB?----------BBBB----BMBBX---------------B------------XXX-------------------BBXB--BBBB?X---------------B---------B-XB?BEBXM-
----------------------XB--------XBB?X-------------XXX???--------------BXX----------------------------------------XB-----MX----------o??X?----------------------------------XX-?M------------------------
-----B?---------------XX-MX?BX----------------------B--------BBX-BMMXXX?----------X?XM-X?B-------------------------------B-MX-------------B------------------o-----------------B?---------------X------v
---------------?B-B-------------------------B---XXB--------------X?XB------------BoXX---------?M?--XXBX---------------?-----------o------------------oB-------------BB---------E?B-----------??----??--f
--oXB--------EBB-------BXX--------------XXXX---MXB-----M----BB---?X?B-----------------------------BBB---?B?B-------X?M---------------B-M---XBMBBBB--------BBX------------------X------BXB--------------f
--BMB------------?XMB-B---------------------------MBB----BBX?---------B-------XBMXB?--------------XBBX----------------BXX--XX----BB?--------??---------------XX----BXB--------------MMX--------BX------f
------------------------BMX----BX-B------?-----------------M----X---M---XM-------BB----------------------BX?--------------------------------------------------------------B-------o?BX-XB--------?B?---f
-----BBBB-------XX-----------?--XB---------------------------BBB-------------BB--B---------------------XBBBBB?----------------------------------BBXXB?XB-----------------------------------------------f
-------B?XXB------T?-BBB?BB--------------?--TM-E---X----------B-------X---B-XBB?----XB------------T----XXBXBBB?BXB-BB-------B----?B--------------BX--ToX-----M?----TB-T--------------------------MX-oB-f
mMTXM-M-T---------BBMBX-------o?T---------BXXX---------X?-----------------------------------XBXT-----MB----B--BB-------T-T----------oX--XBM-----B-----BXXXXBXoTB---X?B|BX?X--T-------------------------X
XXXXM-?M|XXXXXXXB?X--BXXXX?BBXXXB??X--XXXXXXXXXX?MMMBXXXXXXXXBBXXXXXXXBBXX------XXX--B??BXX?XXX-BBBXXXXXB-XXBBMBXXXXXXX|B|BXXXXXXXXXMXXBX-BX--XXXXXXXX?BBXXXXXBX-?BXX-XXXXBBB|XXXXXXXX--M-XB--XXXXXXXXXX
