X--X------o-X-----X---XBX?------o----X-E--o--M---------X----E--X-------X-----M---o--------X-?----X-----B----B---------X-X----o----BX---E--------E-X-----o-----o---X-----oX---B------------------X--oX--?
-B----T-X------------ooo---X-X---E----X----X--X-------X-X--o-o-------o-o------X-o-XoXX------XoX------X--?---?o---X---M--E---X---X-X-o------E----B----------XX-E------B--X-B-----X-----X--M-E---B-----E--
---BoXT-------XX?--------------------------B------------XE--------XX-M-XX-X-XX-XE-X-?-------X-----X--------o--------X--X----------?-------X-----XE------------------X--------X---------B---?B---------?-
-XB--XTB-X-------B--B-B-B--X-Xo------?---X?o-o---X---X-------M-XX------MX----oo---Xo-------------------o------X--------o-o?------------------------X--X--X--X-Xo----X--XE-----o-----------X-M------B----
-----XT--------------X--E--E--X-o---o-X-oX------BX---o------------------BX------?----E-o----BX---XX?------X-?--------X-----Xo--------o----B--?o--X-X--X-------B-o-?-o-----B----------------o-X---X------
-?-o--T-?------o-o--o-----------o--X----------E----B---X-?--X-------X--o---?----X--------X-o--------X----E----------------X?----X----------X---------o?----X---------XXX----E-----XX---X---B-----MM-X---
---B-ET-M----------X------------X-----?--------------oB--o---XX----X-----BX-------X-o-XX------o-----X-o--XX------------------B--------X?----o-------XX---------X--E------o-------------------?o-X--ME---
---o--T----o-?--------o------------XX------?------X----EBX-X--X-----B---B-----Xo?--o-----------B-------X-------X-----X------X-XX-----X--o-----o-M-X-X--oXX------X------------X------oX?-X-?-----X--X-oEv
XBo---T------M-------E----BE--XXX--------X--o------X-X-B-------o-?-----------?----XXX-----XB--o----E-M----------XB------X---oE-XX----X-EMo---------------X-B---------X-B----------o---B------EX--?-----M
XXXE--T-X-------?--E-oM----------o--o??----B----X--------EEE--M-o----?-E-M---------XE------?----B------?----------BXX-------------------------X?--oXB-X----B-----------------o-----Xo-E---------XE------
------T---------MB-o--XX-----------XXXXoB-X------------EX-----B----------------X-X-oX----BX?--o-o-X------X-o-E--X--X----?---E--XB-X---------------oX----E---EXo------XM--?-----M-----o-XBM-?-----oEXX--B
-X-T--T--X-?----o-E----------X--B--M--X-----------X--X---X----X----?--------B-------X----------------------------X----X----X--B-X-----XX----------o-------MB----X---------------------X--------------X--
-oTT--TB-TX?--X-----------oX----oMo--------------EB-X----------X-X-X--X------------E-o-BB----------?-B---------X--oX--o----?--M-X-------?o-------------E?---E-----?-X------------X--X-o-X---X-----------
-TTT--T--T--------X-X-X---TBo-----------B--X-M-------T-B-B--X--B-oX-X-XX-B---B-------X-----EE---X--X---E-o-o-------o------oE-----BX--------X---X--o---E----o-B---------------E?X--------T-Xo---o-B---X?-
m|||-E|--|-------BX----E--|M--MoX---M-XX----X?----B--TE-------X----E-------B-BX---o-------X-?-X-------------o--EBXX-B-X?-X------X---E-B--EB----------------o---------------XB-----X--?-BTBB--B--------X-
XXXXXXXXXXXXXXXXXXXXXXXXXXXXXXXXXXXXXXXXXXXXXXXXXXXXXXXXXXXXXXXXXXXXXXXXXXXXXXXXXXXXXXXXXXXXXXXXXXXXXXXXXXXXXXXXXXXXXXXXXXXXXXXXXXXXXXXXXXXXXXXXXXXXXXXXXXXXXXXXXXXXXXXXXXXXXXXXXXXXXXXXXXXXXXXXXXXXXXXX
