--X-X------X--o-----------TX------X-X-----------M--X?-------X-----E|----E---X------o-o----X------E-B-X----M----Xo--X--X-----------MB-X--X?-------------X--X-------E--o----?X---B-BXB---X-XX----------X--
M----X-B--?------?------M-------X--------o-o|o-----X----M-Xo-M--X--XE-------T---B-|-X-----X-----B-------XX---X----X-M--?--B|--------X-X-----XB-----X--X-X----B---o---------?-XX-----X---EM?------o------
---B----------oX--X--?--To-o----o--|--XX----E-X?-o-----oB-T---?-X------------o--Eo-XM-|-MBoX---------X-X-Bo--X----X--XX--o--o----XX--XB-?-----o-o--X--E------------B------E---M--X------M-o----X-----|oo
-X-------X-------X---|-E---X--?----?X---?--------?X-o-XXX--|-------B----X--B-XB-X----X--E-X----X|---BX-----o-o-X-----?--|-|--------X----X---o-------E---?-o|-------To---------XX------------E---XX-X----
X----B---X--EM-----X----------X-------X-------T--?-M-?-B-----------Xo--EX----X--M-o--Xo---|X--X-----B-|--X--------?o--X----------TMoX-X-X-|--X-X----o---X--M----X---XX-X-X-X---o?-o------T-XX---M-----M-
-X---|X?---X----------------B---E-----X---X---XMXE----XX-------B---X-?------X-----E--o--X-B---------X---oX---BoE---Xo--?B-|---T--o-X--X---?-------X----o----------X--o---------------X------------E-?---
-B--B-X-X-----X--X---o----X-M|----?---?--B-BX-M----BX-----?----|-XX|X---?X---oo-----XE-----oB-X-ET--X-B----o--B---Xo-o------X-------?------E---------?XX---oB-B-XX-B----o-X---B----BX-B--o--oXX---X-----
----|---B-|---X-X-|--X--X------?-oB??BX-----X-X--B-|--X----M-X----X----X--o?Eo-XB--B---M--XX----------Bo------E------X----------o---o---o-o----B--E-----X---------E-X-o-o?--------X--X----XX-------X---v
XM----o--X------X-X--------o-X--------E-Mo--X-------o------o---------B---X---o-X--XB----X---BE--?---X--X-o------oX--?----o-----o-B-E------X-XX---E-X--E------X--oXX---------oX-X---------------E----B---
--X--E---T----M-XX-----X-------X----?X-|-o----X----X-------X-X-XX---------o---EB-------XX-X--------M-|-------------X--E----o-X-||-------X-X---|--|o---oo--o-X------------X-----oX-X-----B---XET---E--XX-
------X----XoX----o-E-------T----------XX-o--EX----XX-------X-X------oXo--------XM-----XE-X----MoE-X-----T---B-------X-o----To----XX-----X|------o---XX--X-M--EX-----X-X----|E-XB---E-------B-------T-BX
--?-|-X-X-?--o--X-X----X----M-E--E--XX--E-M---EX-----M-----X---X-B-|-BoX------X-?---XBBX--o-------|--M------T------E------oB----oX-BXo-|X----X------X----X---------oX------o--?--oM-------X--?---E------
---?-X--------X---o-EXX---X--X-oX-------T---?o--X------------X-?T--------B----B---------Bo--------EX---------------oX------?o-XXoT-X-----?----?Bo-------?-------?-------oo-----?-B--Xo-----?--?o--X-----
----------X-------X----B---------o--MB-----oX--E-X---?--X---------X---?--XX-|-o---------------o----X--EX-------X----X-X----Eo-EX----M-|-------M--?---M?------X--XM---B--------B--B--B-B--------X--------
m-|---X--o-----XX--B-------T?---B------E---o-XX--X------X--M--|Xo--E--B----X-----XT|---oo-M-B--o--X----T--BEBX-E---------X-------Bo---------|------XT-T-o----X----------X----oX-X-ooX----------?------o-
XXXXXXXXXXXXXXXXXXXXXXXXXXXXXXXXXXXXXXXXXXXXXXXXXXXXXXXXXXXXXXXXXXXXXXXXXXXXXXXXXXXXXXXXXXXXXXXXXXXXXXXXXXXXXXXXXXXXXXXXXXXXXXXXXXXXXXXXXXXXXXXXXXXXXXXXXXXXXXXXXXXXXXXXXXXXXXXXXXXXXXXXXXXXXXXXXXXXXXXX
