----------oB--------B--------XX--B-XBBBBX------------------------B-XXX?XBM----------------------B-XBB?BB-----BB------------------------------------------------------------MB-----------------oXB---EB--
---MBB-EXEX--B-------------------B---------------M?BM---------------------BX-B-----X-?--BB-BBX-------BB--------B?-----------------------?-----X-----------------------X-----o-------------BB-------X----
---------B-------BB--B---------------------X-------------------------o-??----------B-------XXBB?B----------BXX------------------?????----------BBBBBXBE-------B-----MBXB----------------------XX-XB-----
------XM---BB-------BB?------------B---XB--------------------------------B?------?X-------------------------XXX--X----------------E?M?----M---------------------------------M---?--X--X--o--------------
-----MM---------------------?---------------------------XX---X?BXBB-BB------------------BBB---------B-oX-------------BXXoBBB-MBBB------------X----MX?XX------BX----------------------oX??X---XMMB--X----
-----??-------------------X---X-----------?-----------BB----------------X------------------------oXX------------------------B----------------------X??-----------MMBBB-------------BBBB-----------------
-----------BBB-----XXBBXBXXXBo?-----------XB---BX-----B-----BXXB?MBBBB--------------------------MB-----BXXX-BX-BB?XX--XB----BXX?B----?X-----------BBBB-----------X?XB?-----?----B-BM--------------------
B---------------------oBB-------MB?---B-B-X?-------ooB------------------------------------BXB------------------------------X?X--------------?B---B??BX---?-XXXXB-----------------------XXMB?----BB-o---v
-----------B?B-----B----BBBB---------XXXM-----------------XB-------?--MXMBXBXB-------MBo--------------------X--------?B-------X?BoBB--EX---------------------M----------------BBB-----------------M----f
-------------B-------------??B-oBBXXXM-------XBBBB----------???BB----------BX----BBBB---------?XB----BX---MBM---------------XB-BBX?----------------------BX-------EXXXX-------B--------------EB--------f
---------------BMB---X-BM-----------MB-----------------B----------B-------------BB--M-----B??X?---------------oBBB---------XB---------?X?--------BB?BX-----------------------BX-----------------B?XXMXBf
--------------XB---------BBX------------XX?B-----B--XBBoXMX--XXB----XMBM--B?MX--o--------X---B-B-?BX-----------------------------BXX-----X------------??B?--------------------------BBo----B--XX-------f
-----BBX-----BBBB----------------------E-B--B--o----------------B?---------X-----X----------MM--XBBBB-E??--------------BBX---?-XXo-XXBB-B--E---XMM-----??B--------------?-B?------------------M--------f
----------------------------?--------B--------------B------------XBX--M-----BB-XXBXX--------------------------------------X?ME---BB--------------------------B-----XX-----X-----------------B-Xo-------f
m-----BBB--------------oBB-------T--o?-------?---oB?oB--B-------??------------------BBBB--o--B??B---------------TM-B-----------B---T-----------------------M?XMXBB---------------------------------?---X
X?-X-----B----X--------Xo----------XB---------------------------------MBBM---BB--------o----M--?M--------------------B-------------|-----B-------------B--M-BX----XXXMMBTXX---BB-----------X-----?-BB--X
