--XE---------------?--------M-----XXXoB-BMM--X--?X------------X------BX-------XB------XoBX----------BXB-------MBMX-B----------X-?MX-----------------BX--X----XXX?BBBB-------XX--M---B-------BBMMo--B-BB-
---o--E?------X-X---B------------------------------X---------------XB-BXB?B---BBXB-BXB---------------------?--?-----------B??--B-X---XXM-XB----X--X----EX------------------B-EBBM-------X---------------
-----------------B---------X-------------------------o?---------------B-BXB--------B--------E----MBX----oB-------------B--BBM---------BX?X------B-----?-----o-------------BMX?----------BXM--MX--?X-----
--B?--------?-----------------XBX-----BM-----------------------X--------------------------------X-----XB?B-XBXX---------------X??X--?X--B---BXX--XXBX?------?----------------BBBB---XXX-------X------M?-
XX------------BM-------X-------B--BB------BX-------B--BBB-----XBMB-----------B?------------------X--?EB---------------------------??B?--XBBBMXX-EBBXB-----------------X-----------XB?------------------E
--------------BXBXBXXB---------------MBBX?--------------------------------?B--------MMB-X-----?MBBX-------BBX-----------------------XMBX---------------------BX-----MB?--------X------X?X------------XBX
--?----XB----X----M------XX---------------BXXB-M??B------------------BM-----X--------XBB---------X--------------------BX----M------------------XXXBX--------B?X-X?X--------M-----B-----------o----------
-------------------X-------------------X--------B----?--EB----------------MB?-----------oM---------------------------BX---------------------------?BBX---------------BBBB-----XX-M------------E??------v
----------EBM--------------------------------------B?--------X------------BM----oX------X-------------XXX------o---?EB----XB--------XXB-----X------------------B-----MX--------------------------------f
?-----------------------------------------------XMB?X------------?------------------BMX-B----B---BXXBB?B---oBMBM--?XXM--------------??B-----BB?B----B-----?BBB?-------BB----------------BB-----XXEX----f
--------------------------------------------------------B-------X--X---------?--X?B----X?M--------XB--X-oBX-----------?X---BBX---BBBXX------------BX----M---o------------------XXB-------X--MoX--------f
--------------------------MM?----B?B---?------o------X-----------X--------BX-BB-----------XXB-X?--?XBXB----------------o------------X-EB-B----------------------XX-X-------------M------?--BXB---------f
--------------------M-B----------M-X---------------------------------BooXXX-----------------BX------------------------------?-----------------------------MB?------B-XX------XBXB----------------------f
----------------------------------BB--B----B--BB----B---------M-------------------BMB-----XX-----B--BB----BB-------X-----B--------------XX---------BM-----?X--o-BX?---------oBB-----XMo---------B------f
m--------T----------BM----B-----------------o-------------------------B-X---------MX-Xo---------X--B-X-T-----TB?--------------------B--o-XX-------------BX----XX--------------oXX----?XX---BM--------XXX
X-B?BB-BX|--BX--oBX---------------------------------------------XB?-?-XB-----------X------------XM--------------------------B?XXXMX--X??----B?MX-----BBBB-----------B---------XX-BBM--------XX-XXXBB--XX
XX-X-X||----XXX---XXX-X||XX-XXX-XXX-X-|X|-XXXXXXXXXXXXXXX-X-X|XXXXXXXX-|X--X-XXXX--X|X---XX--X|X|-X--XXXXXXXX-XXXXX---XX-XXXXX||XXXX--X-XXXXXXX--XX-X|XXXXX-|XXX-XX-XXXXXXXX-XXXXXXXXX-XXXXXXXX-X-XXXX|X
