------E---B?-o-----X---------o----------------o-------X-----B---E-X----X-XM-------E----------E-------------------o-?------X-X----XE---XX--X------X---X-EX------X--X-o----------E-X------X---------o-----
---E--TB------E--------X-------X-E--------X-----X------X--X---------X-------o-------X----o---?---X-EX-X--------X-o--------X-o-------M--B-X-B-----X------?---X--------------B--o---------E---------BX----
-----X|-EMXB--B--------M--XX----------BX------XBE--E-E-B--?B---?----?X--X-?B----------X--------B---X---o----X-------------o---X----X-X-----------o-------XX-----E-E-?X--XX-X--E------X?--X-oXX-o-----X-?
--X--?|o---------XXB-MoB-oX-------X---B-B-oX-----B------X--BX?----X?----?X---EXE------BX---------------X----MB--M------------EX--X-----M--------X------B----X-o----XX-B-B---oX-o--o--BM--E-?oE-MX?-----o
--o---|X--M-o----------X--XX-----BX--o-o?--X--M----------X?---------BB--------X------X---o-----B-M-?--X-----------o----------X--EEo------B---X----------X----E--X---------o-X----X--XX--X--X------BX----
-E----|----M-X--B---E-E-------------------X--?---X-X-EX---X------o-----XX--E--oX--X----------B-X-X---XEX-o-------X--M---XM-B--------XEo-----X--X---M--X-----B---------B-----------Bo-----B---X---o-X---X
--B---|----X------o-o-----------X---X--X-X--X-------B-----------B-XX-o--------o-----XB--------X-----E----X-o-E----E-o-o---X--E----X-----X-------X-?-oX-----X--X--o--E-----o---------X--M---------------E
------|-----o--?--X---B?--X--?o------o---------XX-------X----------B-----M---X---X--B-------E---o-X--------X--oE---B-BX---B--X----X-B-B-Bo-B---M---------------------------?---XoX--X---X----o----?-X-Xv
X--X--|----------o-X---------------X--------X--------o----------E-?------------?XX---E---BEo-----BX--o-----XX----o-------o-X----X---X---X----X--------------------X-o-o----oXX---------o--B-B-----------
-?----|--------B-X-----X--B-B----B--Xo-----MX-B---?B---?-EB---------------BB?M----B------------o-----o---------o---B-X-----------o----o--XX------------?--?---o-o-oX----M---M----E----o----XX-----XX----
-----X|-M----M-?X-X--------oX-X-X------?--X-XE--------X-----?----B------?---E--X-----X---------------M----X-----?--oX---X--B--X-X--B-B-----B---X--?-------o-------X-----------?---o----o-X----X-?-------
XB-Xo-|--M---------------X-----X----X-?oE----------------------E-------o----------X-?---X---X------B----------------------------o--B-----?-X----o-----------------B--o-X-----XX-XBX---oX-X--X---X----B--
B-----|X-X--oB-X--X-------------X-oX------------B--?-E--X--?X------BXM--X------X---X-----X-o--X-------X-B--M------B----o-M---E----E--B------------E-----E----XX-----oBX------o--E--------o-X-----XX--X--
----?-|--|BX-----MoT--------XXX-X-XoX-B?o------X---o-X-TX---X--o-E------o------E--XM-----M-X-EXo-oXB-------X---X-X------B--X--E-----------?-X--?--------B---E-X--o--EX-------X----X---XX-------B-----X--
m----X|-o|--E-XX---TX-X----X-------X-?-B--o-------E?---|-oB----X----oE--X-o-XXo?-----o--oXX?---X-------E----------Bo------X------XXX--X------X---X--E----?-------X--E-X--X-------?---X-M---XX---X---?---
XXXXXXXXXXXXXXXXXXXXXXXXXXXXXXXXXXXXXXXXXXXXXXXXXXXXXXXXXXXXXXXXXXXXXXXXXXXXXXXXXXXXXXXXXXXXXXXXXXXXXXXXXXXXXXXXXXXXXXXXXXXXXXXXXXXXXXXXXXXXXXXXXXXXXXXXXXXXXXXXXXXXXXXXXXXXXXXXXXXXXXXXXXXXXXXXXXXXXXXX
