-----T---------E----o-o------o----B--B------o-|----------------X-------X------X-----Xo-B-X---B--T--------B-B----B-----------------|-|---B-------T-------|X--------?--B------------------------M-?XB----X
----------XB---o-----------E---o------M-?o-----T---BE------------oXX----------------B--X------T-o-o---TXX-------E-oBM--MT-?--B---o-o---------------------------X-------Xo-B------------------o-------E--
----------X--------------B-----------XE---------------------T---X--------------------B---X------?o-M--------?-------o------------E-------------------------------------o-----------B----X------------|--
-----X-----X---------------------------------------------------?-oo------XX---?----------oM---------------o--|-------------?---X---?---------------?---o--o-------?-----M----------|--------------------
------B--?-----------------------------------o?E-----|?-----?------X------------o---------------------o-----------------------------BM--------T-----------------BXBB--B------XBB-BBX--------------------
-----o--o-------o-X------?---XX|-M-----------|M---------------?-------o-----------------|X--M---X------------M---------------------M----------E---------X-------------------------?--T--MB-B-----X------
---------?-----------X-----?M---X-----B--o----M?EB----------X-B-------B?-----B-T----MT------X------X--X-?---MX-|---------------------Bo-------MM-B--------XB----B---T-o----------E--------?B-----o------
---o--B--B-o---?------------------------------------------E-----MB-------X-----|-----|-----------------Xo-------B-----X-B------BX------------------X---?--?-------------------------------XB----?--E---v
--B-------oM-BB---T--X-------MM--?--T-------------------------X----XXB--B-X?-E-T----E----|o-------BB----T-XX-B--o-----------T--MB-MBB----------------T-----------X--o--------BE------XB----------------f
-XX---------o------?X----?-------?--------|---------B-----?----o---M-------E----------------------------|-o--------------------o----------?----?-X-o----------B-----X-----X--B---------------------X---f
--------------BMB--XX------oBX----------B---oM--------o-----B-----------------X-E-----------X------------M--------XB----MB-------------------------T------------------X------o---EX---BMB-----o---?XB--f
-----o------E----X-?---------X---------X----o-T-o------T--------EX--------------------------B-----X------XT-o--T------------BX-----------------------------M--------------------X------B?-----XM-------f
-------o-------------------------------|---------------o--X------------TX---------o---------------------------T-----M-------------E----o-X---|-?-------------------o-?-----ooE--------------|-o---M--?-f
--------|---X-------------o-------------------T------?-------------|------------------|--o---|--------E-T-----------o-o----E-----o--o---o---------o-----------o---?-o------oB---------E----o---o-------f
------B---E---B---X-----------B---------------|--?--M----E---T--------X--?-T-----X------B----------------------|--T-------oB----------------T--------M------------E--------T---------------------B-----X
----------------------------------------T---------------------------------------T----------o-----------|-o--M-E------M-----X--X------E------X--------o-o----------?--------o-------------T-------------X
X-XXXXX-XXXXXX-XX--X-XXXXXXXXXX--XXXXXXXXXX-XXXXX-XXXX-X||XX|X-XXXX---XXXXXXXXXXXXX-XXXX-X-X--XXXXXXXXXX-XXXXX-X-XXXXXXX-X--X--X-XXXXXX--XXXXXX-XX-X-X-XX-XXXXXXXXXXXXXX--XX-XXXX|XX--XXXXXXXXXXXXXXX-X-
