------B------X--M----------oX------E--------M----X-X-------?--X-B---o-X---X----X------B---X?-----XM------XE?X-BX----B----o---o--BXo--X---XX--XX----o-Xo----B-----o---------E---BX-?-------------B-B---XB
X----------o--o--o---E----oX-B-XX-X----------oX---?oM-o-----Xo---------XM--------?-------?X-----?----B--X-E---M---X---------?-----E?-------------?--M---------X---------X-X---------------B---X?----oXB-
--M-X-?-Eo--B---X---E----XXo---X---XX-----------------?-B--X---Xo----------------------oX--E---E--X-oXE-E--oX-----XX------Bo--o---E-o---------------E----------X-------E------o-----X--------?oX-------B
----------------?--o--?-X------------o--X---o-------?--X------B-B----X-X---B---X---B-?-----X-------------M-?-----o------Bo---Xo------X----B----B---o---Xoo-X-B-X-o-----XXB-------------?BX--?------X-o--
-?--o-------EM-----------o-?-o------B------X---------o-------?-X--X---------BE---------XX?---E---------X------B-------------------X----------------XX----------B-X?----BX---------------o-?X---B--------
----------BEX-E-----------------------------o-M----?------------------X---X--------X-------X--B-o----?--E--o-X-----------o------------XX-B----o-X-----X-------M-X-MoX---o----X--XE------BX-------X----oX
---X--X-M-------X--------------------XX------XX-----XoX-----------o-------?----MB----B---X---X--o-------------X?----X-X----BB-X------M----------B--------M-----------X-------B-o-E-------------o-X-----X
-----X--o-----------------------B-Boo-------o------------B------X--?X---XX-XXX--X--??-------oX--XXB-E------X-B--o---B---B?X--?--X--EB-B--X------oX----?----X----E--------X---oXX-----oX-X--X------B-X--v
------X--X------------XB-------X---X--o---XX----o----------M-XE-X-X------------------?---------XE-------X----X-------------MX-X-------Bo--o---------X----o---oE---o--------o----------X--X----EX--o-B-XX
--?X----------------o---o-B--B-B----B-XB----XX-?------o?-X-M-------------X-X-X----o--E-X-------?----B----B----------B-----oo---X-o-E--XBB------BE----X----E----o----------o--XX---B-X---------------XM-X
X--?-X-X?--EX------------X--B-X----------o--X-----XX-o-X---------------o----------B----BoXM----XX--X--B----X------------------X--X--o-X--E-------------X---o-----B----MM-------o----X-------------X-----
X-------------------o---------------o-Xo------?-Bo----X------E-X-----X---X-?-----X-o-Xo-MXMoXX-----X-o--B--X-X-----X------o-?----------X------X---XX--EE-o-MX--XX----o------------?E-?--E-----B------X--
-B------X--X----------E---o------oX-------B---o-XX--X-B--o-----o----E-------X-X---X----------?-------X----------X-B--XE------------?-----X----o------------X----XX-----B-------o-----E------------------
-------o------BEXX---oo-----------oM-----E-M--X-X-------o---X-E-X--o---oBMo-----------XXX---X--?------?X-----M?--------------o----M--E--Bo----o-----------o-XX-----X------Xo-------XX-----o-------------
m---B-|----X-E------------------oXo---X--------E-X--E-B--X--E-|--B--?------E-------M--?---X--X-----XX---B-X-----o------Eo-----?----E-----oE-MX-X----X-M---o-------X-X--B-------?-X--X--E----B-X---------
XXXXXXXXXXXXXXXXXXXXXXXXXXXXXXXXXXXXXXXXXXXXXXXXXXXXXXXXXXXXXXXXXXXXXXXXXXXXXXXXXXXXXXXXXXXXXXXXXXXXXXXXXXXXXXXXXXXXXXXXXXXXXXXXXXXXXXXXXXXXXXXXXXXXXXXXXXXXXXXXXXXXXXXXXXXXXXXXXXXXXXXXXXXXXXXXXXXXXXXX
