-XXBB-----BBMX-----MBBBBBB-X?BB?-------------BB-BB------?-------------------------B---------------------M?----------------XBBXB---------BBBB--MXB-oXX-----oX?XB?B------------?B------XMB?XXB-----X-----o
-------------BX---?---------X------BXB--------?BMMB-XB------------------BBB?--BB--BBBX-------X?-----------------MX-----?------------------------------------------X?M?-----------------------BB---------
---------?BM--------BX-------------BXX-------------------X------------------B---------------------------------------------------------------------------?BB-oXX-----B---------X-XBBBBXX-------?M--------
-------?BB-------------BXXMX----------------B??--------------------------------------------------?BM---------------------BMB-------BBX-------oXX---------Xo?-----------BB---------X--------XX---------Xo
--------------------BB-----------?BB------o--BB?M?B------------???---------------------?X-----B?X--------------B--------------------------B--BBBBM--------BBB---o---XB--BX---------oMMMXBXX?X----MB-----
--XoXBM?M-----BB?---XXMX--B--------XX---------X------------MX-----------X-?BXXX--oM---------------XM------B-----------B------------XBXX------------------------BXMX?--EX-------------------EB-----------
-MX------------------BB---------MBBB??----------X---------------X------------X-------------------------------------------BX?B-?---BBXM-----?XMM-----?B------------E-B------------B---BBBBB--------------
---EBoBB--B?-------XMB?XM----------X------------B?XBB------------------XX---------------M?---------------------?B?B--------??X-----------?-BXBB?XXB--B------B?-------BB-----EB--------------B-----o?---v
BM--------XXBB?B------------------BX------------XXBBB----------------------------X-?BMMMB-------?-----XMMB--?M----------------------------------?B-----M-------------------------------------o------?BBf
XX-----------------BBBXBBBB----XBXBoM---------?XMB----------BB-----XBB---------B--------------?----B------------XXXXBBM--------oB---------?-BX--MMXBXB?B---------------------------B?------------------f
-------?X---XXX--------MM?-------------MB-------?-----------XXX-----------X-----BX---------------------------------XB------B---------------BXXB----BBB----o--------------------B------------B----------f
---------------------------------------------XXB---BMB---MBBX----------XBB---XBXXB-----------MXBMB--XBBXBBB-B-----------------BB-------BB-----------B-?B-------?XXX----XBBBXB-----o--oBMBX-------------f
----------------------------------------XM--------------EBX---M-------MB-------X---MB---------BBMBBB------X----B--?---------?BX---------------X??----MX------------------------X?----------------------f
----------MMXX---------------------------------?BB--------------------------XBX------BX----------------------------------------------------------?X-BXX-BBMXBX??MB----?-------o--------B?XX--------o---f
m-----?---------B-BMB----B------BX----------------XX------B-----B-------B---------?---BX?B--------MB------------XXB?-------------B-----?BM-B?BX-------------BM?----BXBB---B?------------XX---BM-BXX----X
XXBBBB------------M-----XX----------BBMX??BX----XXB-----oX------------------MX?-------BBBBBXBB-XXXBBB---------BB--XB-?TX------------?B------------XBB?-----X----------------BB---M-oBXXXBB-----BBB-----X
XXXXXXXXXXX-XXXXX-X|-XXXXXXX-XXXXXXXX-XXXXXXX--X-XX|XXXXXXXXXXXX-X-X-XXX--X-XXXX-X--XXXX|XX|XX-XX---X-XXXXXX-XXXXXXXXXX|X--|XX-XX-XXXX-XXXXX-X-X-XX-XX-|XXXXX-XX-XXX-X|XXXXX|XX|XXXXX-X-|-XXXXX-X-XX-XX|
