----X--X------BX----o-------X---X----X-o-E|--o-M-------X-------?----o---?----X-X--B---X--B---?--B--?X--B--oo-----|-T--XX----XX---X---E--T-------------B|--------XX-o-X-----X--X----XBX-X----XX-------X-?
o---X-o----X-----X----X---X-----E-----Xo-----------------BX-------B-o---|--XB---o----|-----------B-X---E--X---BM-o----M-X----------X----?----X--X--o-----|-X--X-X?-----TX---X----------X--?T-E-X--X---?X
-X-M-----XX-----B-------B--Xo-EX------?-X--M-|-----X--X---E-XXX------o----------X--M--XoE-o---X---B--X-EX----oX---M----------X----------o---B-o-------M---X---XME-------o-|----X--------B-------TX------
-X---?B----T--------X?----Boo-----B---X-X-B--E-X----o--Xo-BX---E---------------X------o-X---X----X----------X-TB---?--------X|--EB--X------E-------X----o?X|BT------XEo---E---?T----XX---------B--X--E-?
---X----------Bo-X--XM--XT-XB-------o----?X------X---o-----------------E-----E----------X-----------X--X--------EB------XB-?-------BX--XB----X-?M---E--X?|-M-X--B---X-X--B----------------X-X------X---B
---B-----Xo------------------X-o-E---?X-----oT--------------?-------|E--XX---B----X---X----X--------X-X--B---?-----X------X-oB-X----X--------------X-?X?EXoX---X-o--?E--X-----------EB----Xoo----X------
----X---------XE-----|----?-------X--M----X---|X-X-------XX-B---------------M-X---X--T---B-------B-BX----o-o-B-------M-----|-------B---M----XXX----------o----X--?--|--M-------XX-----E-------E--TX-----
------X------X--E-oT--BE--X-X----X--E--o------X---X--------TX---X-o-----X----T---o-oo------X-X----o--------X-------------------B---XE--oX--Xo----XXo--------X-B----------B-----------X--o---o----XX-oo-v
---X---------------o-X--o----X----?------XTB------MoX--oX--------X--------||-----------X---M-o-M------?---o-M------|-|-X------X------------X------------XX---B---X?--?---X-X--B--Xo-----?----------?----
--X----XX----B--E-X---M--------X---------X--|-----X---oo-T--------E-X-------o-Xo-Xo--------XXX-B-------------?--------------------------X--------X---------o-E---X-B-E--------E-----o----X---------E---X
----XE---|-X-----Bo-X|----X----X-MX-------B---B----?-E---?-----o-Xo--X--E---X-X--------------X-X----X--X-X--B----X--o----XX-----X-o--X--------------------?---M-?-EX---X----o?--------?X---o-o-X-E?-X---
--EE----X--X-------E------E---B--------------------B---EX---------------?--E-X-X-?--E-------X--------E--o--|------?BX------XX-E---XT---------X---T-o--X------?--------X-?---X------------X-XE---------B-
------|--X?TEX----X--------------------o--oX----XEo?X--------X-X-------XXE-----oM---------E-----X----|X---?XX-XX-E---Xo-o--X---E--|---E--X--M---E-----E-X-XXo-o--XXB-E?----X-X----X------X-B-X----XX---o
B------------X------X------X-----E---B-B---X-X---X--T--BX-XX-o-X-o---------X-----------X---o-EXo--------X---E-------E-BX-X----------X------------B-----X-?--B---E--|--o------X----X?-X-Eo----X---XX-B-X-
m---E|---XX---X---------?----E--BX-------EX-----------------M-XX---?---------B--------?--XX--E---XX---X--------X--B----------E-X------?--X----X--X----------E--X-X-?-o----X----|---E----XX---XX--X--|---
XXXXXXXXXXXXXXXXXXXXXXXXXXXXXXXXXXXXXXXXXXXXXXXXXXXXXXXXXXXXXXXXXXXXXXXXXXXXXXXXXXXXXXXXXXXXXXXXXXXXXXXXXXXXXXXXXXXXXXXXXXXXXXXXXXXXXXXXXXXXXXXXXXXXXXXXXXXXXXXXXXXXXXXXXXXXXXXXXXXXXXXXXXXXXXXXXXXXXXXX
