--------M-----B---------------------XB---------B??MB-XE------BBB-----------B---BXB------XXX---------XXXXB--------------X----------------oBoo---------------E-------??--o-----X---------XXBB--XX?--------
---X--------------------------BB?M---oX-----------------B---X--------------------o------------X?----------------B---------------------------X?XX----------BBBX------BXMB---B?----?BBoXBBM-B------------M
-???X?----?BB?------BBBBMXB-------------X---X----XMBE---B-BXB?B--E-----XX--------------------------B-------XB--BBB------BBX---B------B--o??MB---X--------------oX??--oBB----------------XB-------?------
-XX-BB--------MBX-----------------------------------------------------BB--------B---?B----------o--------------------M-----MB----B---M?BBXBBB----XBEX?----------------X-EX---B--BBB?--XX?---------------
----------------------------------------?BB--------------XXB----X-----------X?-----X----------MXXM----oMXB-BX-----XX-------XMB---------X---------------BB--------BBBMXM--B-----------B---------------BB-
--------B------MB-----------oBoXXBB--------------------------BMBMM?----X-----------??--------------------------------X---------------------MB??BX---?-X--------------------XBX------B-------------------
---------MXBBXXXXX--------XB-----------------EBBB-------------------------------------X-------?--------X---------------------------------MX-BB-------BX---oX----BBM----------------------?oMo-----------
-------BM----------EB--------Xo---BXX---------------------------oMXB?MX-XX?M------XBB--B--?B---------o?-??-------------B--BM-----------------X--XX?oo------------------------?BBX---B----B-??----E---?Bv
--------------------------------BB------------?B----------E---------------------M--X---------M?X----E----------?X----?XB-B-oX------o-------X----------------------------BBB---------------------------Mf
BXX---------M-------------------?M--------XB------MMXBo-----MB?--------------XX--------X--MBXX-----------BBBM-----------BX-------BMBB---MXX-B--XX-----------MB-----MBB---?------------BX--------XB-----f
--------MXX----BBBXB------------------XX-------BX---BX----------??MB?--------XX------------oBXBB--------------------------?X-----------X-XXX?X-XB---------------BXBXX-XXB-------------------XX--BBX?--Xf
---------------XX--BXXXX-XBB---BBBBB-----M-----M-------M?X-----------------BBBBB----XM--------------------B-----?X-----MBX?X----------------XX-------BBXB-X--------B----------XX-------------BB--------f
------------------ooX?--o-------------------------------------X?-----------------?-X-----------------MXBB??-----?-------B-----------------XB--------------------------------------B-----BX--------o----f
------------?------------BB--------------------M---------BBBXB----X-----------------B-XXB---MXBX---------XMMBo-M-------------------B-----BB-B------------------BM------------B-BB----------------------f
m--------E--------BB-B?--B----------------------------X-------B----B?--B--B?-------MXE-TB----------------EE---------MXM-----------------BX-o?---------------------B---------oB------------?BX----------X
XBBX----X--EX----?XXX------------??-BMM--------------------BXB-XBB-oXMB------B--?BX----|---X???-------------B?---------BB------------B--------BXBB----------------------B-----BB-----------oBXBBX?-----X
XX|XXXXXXXXXXXXXXXXX---XXXXXXXXXXXX-XXXX-X|XXXXXXX-X|XXXX-XX-XXXXXXXXX--XXX-XXX|XXXXX---XXX|XXXX-X-X-XXXXXXXXXXXXXXXXXXXXXXXXXXXX-XXXX-X-XXXXXXXXXXXXXXXXXXX-XXXXX|XX-XXXXXXX||-|XX-XXXX-X-XXXXXXXXXX--X
