M--------E--------------?-------TB-------------------E--MB---|-----X----XXX-----X--XX-----------X--Xo--B-----------T-----|-------|---X---X--XE------------o?---------B---XXoX--XEoBE-?-----------?-X-MXX
------TX--o----T--X--M-----MX---?----o---X--B------o-XE-T--?----X-----E-------X?-T-----------X-?-T-X--TB---Xoo--Xo----X---o--o-XX-----|----|-----T------------?----o-----Boo--X----X--M--T-o---o--XX-B--
-----T|X--T----|--T-------------X---o--X-X--E------T--X?T-X----B-X----------E--X--E---?B--X---X--ToM-----X------------X--XEX?----o----X------XX-X-----XXX----------E----X--oX----?-X--o--|---------E----
--B-MT|X--T-o---------------XX--TX------T--?----X------B---X--E-----X-----o-------------E-----o---M|X-?-----E--T----T-----------B--BE?T---T---E--?----oo-------X-X-X-----X-X-o--T-BX---X--X-----To-----X
M---o-|------------EBE------o?---B-?----|o--E----o--B-X-o---X-o------XBo--T----XE---------XB-------X---B-o--|XX|-X--|--X--------------T--oTB---------X-?----B----B-X-----------T|X----o----?----|X------
--X---|---o--B-----o--B----E--X-------X-XT----o---BX-Eo-E---B-o----ET--?-ET-B----M----E-B---oX---------X--X-X-------X---X---M--B---o------X--M--o--X------T----X-X-------X-----T-X---------B-----X----o-
--E---|---o-X---?X-T------?-?-------X----|-T-E----o--X-o-----------E|---E--------------XB--oXB--o-----X-----M-o-o-MX---?o-----oo-T-XX-o-E--X-Bo-----MEMX--T--o--X?--------X----------Xo----T----E----o--
--o-X-|---------o----B------XX----X-X------|o---------o-oX----------X--------o--B-----------o-B---X---B-----T-------X--X------o--T-TX-------BX?--XB---?--o--T--------X---------?T--E--EXoX-o-X---B---o?v
------|B----X-----E-X-----X-X---?-?---MT-E--------X-------------XX--o----M------------B--XX--E--X-o----XBXM-TXo--BE--------X-X-----|--XX-X-----------X------|B-X-XX----X-X--X---|-----M------------X-X--
--X---|-------X------B-X----X-o---|--?-|--------XEo-----Xo-----E-ET-------------X----------XM---EB-----X-E---------X--T------TB----B-------?B?-----B-o--B--------X-BXo------B--X----M--------o--E-----T-
------|-----Xo-----------------To---------B----?EX----------X---X-|---o--XBTB---X--T-X----o-X--X------B--T-oo-----M---T--X---|--------Xo------------X------Xo-?-----------T--B-------E---X---XXBBE----|-
------|-T-----X------o-----o---T-oX----o---o----B---------------X------B-|-|XEB---T|X---X-----B-TX--X----------X------B------X-o----------E-------XB-------M-?-XT--B---TX-|--M-BX------XB----M-------X?-
-X--X-|-TT--X--o-o--X----X-X--?------M-XX--X-EXM-E---X-----X--E----B--XXXX-----B--T|-----o--X-X-|----o?--o-M----------|--E-X-X------X-T--E?------?---o----?---E-|--B-o-T--?X-----T-XXXX-BBX-oM--oBo--X--
----X-|-X|--XTE-----X----?X-M-X---oT----X--M-T-------B-?--To----B--E-X-----X-o------B-?o---M---?T-BX---B-X-X---Xo-X------T---E--?---B-|--------XB-----BX-X--XB----X-o--X---E--B--T-----X----E------To---
m--Mo-|?-|---|-o-o----X----X-?X----|-X--------B---X-XX---E|---EEoo-X--------B-------T--|--------E---X?X-----------------E|---M---X---------------XX----o--B-o-------------XX-Bo--T---E-----B-Bo-BB-T----
XXXXXXXXXXXXXXXXXXXXXXXXXXXXXXXXXXXXXXXXXXXXXXXXXXXXXXXXXXXXXXXXXXXXXXXXXXXXXXXXXXXXXXXXXXXXXXXXXXXXXXXXXXXXXXXXXXXXXXXXXXXXXXXXXXXXXXXXXXXXXXXXXXXXXXXXXXXXXXXXXXXXXXXXXXXXXXXXXXXXXXXXXXXXXXXXXXXXXXXX
