o---X--o-----BX------XXX--?-------MX--------?----B--------------------------X-----XM---X-o----X----E----------------Xo------?---o-?--X----MX-------X---XE---o-X--------XX-----Mo----------B----?---o-X--
-X-B--T---X---------E---XB-------------X-------X----X-o?--o--------?----o-?-X-----------E------X-oX?XXB-----BB--o----XB-----XX----oX------------------------XBX-B---B---oE--------E-----X---X-----X---X-
X-----|------o---E-o---?E------MX---M-X-----oBo--E-----?-X---------X----------------X-EX--X---X-------X-----B------X----X-o-?---------X--X-X----B-----X---o-----o--X----o-----X-------X-------?--B-B--o-
---?--|------------------X---X--EX----X-------------X-------o----------------o--?-------------------oX-o-----o-B------oB--------------------X------------------X--X--X----o-----X-----o---------X-------
--X---|--------------E---------------B---------B-BX--?-E--BB---------BX--E-----X--------XE------------------B----o---------?---B-E---o--X-B-oo----X-------------o----Xo--B-------------------------X---o
-oB-B-|--------X---XoX-----XXEX---X---o--o-X--X----X----o-?-----o----o---XB--?--?--------X-----B-oo------X-Xo----o-----X-?B--------?--o----X--------------?o---------M------XXo----X-X--E------X--------
X-B---|-----------B----BBX-----------?--X-X?---X----X-------------B-B-B-X--------------EX--X----E-----X----o---------------XB----B------XX?o-X----X-----?E----X-?o-X-----oo----------------B-o?E--o---EX
-B-B--|----o----------------BX---B---X-----------M-----X-X-XB----?-----XX-----o------------M---BX------oX-----X-X?XX----------X---X----B----X--XE--X-----XB-----E------------o-XX--?------XXX----------v
X-----|------XXX--?----X------o------XX-o--------o--------X---X----X-E---X------X-?---XX---E-E-------------X----o----B-XX-E?-X?------X------X-------B-X-X--XX-?-X---o-----------o----B-X------------B---
--B-X-|?---oM-E---------X-B-------XX--X------X--XE-----X-B--------o--Bo-MB----B-E?---M-----E-----------BEo-?---B?--------------------------------X-oB-?------XXoX?--------------X---B----o--B-X-XB------
B-----|--B----X-----o---o-X-o------M-X--B----o-B---------X-?-o-B-?---X-----o--B---X-----XX------?E---X--BoX--M---X?--X--X---?-----X-B--X--?--o-----B--------o-X----XME----BB-oB-----o--o---------?-----E
-----?|X----------?------X--X-o-XX--------XE---XX---X------------B-------------------X------X-?o-----o---E-X--B-----X----X----X----E--?----------BXB-----X-X-o---o--?X-------B--XX-X-o---------X-?-X---X
-----X|o-T-----X-EXo-o-o------------E-X-----o---E----B----X-----X----B-----E----B---M-----X-------X-?-X--X-B---X?-EXXX----o---X----X--XXX-MBoE----o--B--------EB---E----E-X-------X--X-----B--X--X---X--
-T----|-B|------E-------------o-o--B-o--X?--X---------To---------------oX------XX?----X-------X----EM--------X-?----X?-------------o---E----M--T-----X------XX-----?XX--X---X--X-------------------o--X-
m|---X|--|--MB------B------BX---------X-?--o-o--------|-------------BX-o-------X---X-oB-M-----X---oX--B-XEEE----Xo-X?BX--X-----o---X----X---o--|--o-----o-X---M-----X----?-----oo--------------X------X?
XXXXXXXXXXXXXXXXXXXXXXXXXXXXXXXXXXXXXXXXXXXXXXXXXXXXXXXXXXXXXXXXXXXXXXXXXXXXXXXXXXXXXXXXXXXXXXXXXXXXXXXXXXXXXXXXXXXXXXXXXXXXXXXXXXXXXXXXXXXXXXXXXXXXXXXXXXXXXXXXXXXXXXXXXXXXXXXXXXXXXXXXXXXXXXXXXXXXXXXX
