-----E--Xo------M----o----X-------o----X--X--------?X-X-----o---X--o-----EE-------B------E--o--X?-----------o---Xo---------X--X------------?----XXX----X-B--?-oB----E--------B-o---E-o-----XB---M-------
------B-------------XE-X--Bo---XB--EB-o----X-M-BX--XB-E------M-----------oo---X----X--------X-X--X-?-------XBX-X----------o-----BXXE----o-?XM--X--X----o-M--B?-B-----X--E---Xo--M----X--X--o-X--Xo----B-
--X-------B------------X----o-----XX-M---M--X-------o-------XXXX------X--------oo---X--------EE------------------M----B---Xo--o--M-M-------------X---B--XX-----XX-o--Xo-o--?-----------E---X---MXoXE-BX-
-----X-X-----E---o----o--X-XB-----B---?X--XBB-X---X----o------------X--X--X-E-B----o------X----o--------X-XX-EX-----X-M-?-----------------?M---X-o--o----?--X----------------oB-------X----B---X--M----?
---B------X----X-X---o-----------------X------o-----X--X------------o----XX------X----X-X-X-------M-oo-----XX---?--XM---?Eo-oX-X----------?------o-B-----?o--------X------------B-?----------------X----
--?--X-o------------B----------o-X--B----?---o-X------Bo--?---XX--?-oo-X-o----B------?-------B--o-?---X--------X-----------?---X?XE-XXX---M------?-E--X---B------o---X----X-------------------------X---
----------o----X-?----X----X-oB--------?--B-?-oX---?-----------B-Eo---E-X-------------X-?o--o-X-oX-E----X--oEB---B---o-o---M---X-oB-------X-----o--B?--X-----o-----XB-E------E--EX?-------B-----X---X---
------B------X---X------E--------B------X-----------B---X-X-o-B-------X-oX-?E-----X-------M---------E----X----BB-----Bo---------X-X-----EB-X--B----------XX-------oB---X--B----Bo---X----------XB-X?---v
X?-X-----X----X-?---Mo---M----X?BM-B------X-o-X----X-X---X-----B----?-----X-------------E-X-------B------XX----X---M---X--o--o-------B-B-----o-X--?oo-?------------MX----X---X---X----XB-o----X-----X---
-----------o--B---X----?------M--X----?--XX------E----X-X------XX---X--E-X?-B--X--BX-B------E------XX--X-B----?---X-o--X--BX-B---M---X-B---o------X---BE--------o-----X-----M------B----E?-Bo--o-X-M--XX
-----X-o--B--------XX---?-B----o---X-X-X?-----X--B--X-------E------X--X-B--X---XX------X------X-----B-o-------X-o-------E--X------B---------------X-o----?---BX----------M--------X---?E-XXB--XBB?-B----
--E-----------------XX-----XX-o----?--E----X-------X-------B-?----X--XB-----BX-------------------X--B--Xo-------o------B-X--------------?-X-X--X--------------X---------?---X--XX------X-----------X----
----B--E-----X--------oX----XBM--?------B--------EX---o-------------EX---------?---X---------------B----?-----M--------X----B----?----o--------X------?-X-X--------o----------------XXXX----B---o------o
---E-o-----X---------------X-?-----------o-----o----------X-oX-oo---X---X---X----o--B----------XX-----?----E-?-E-X------------o-o--------MX-X--X-X-?--EoX----BM---------M---XX-B----o-X---o-------X-B--X
m-E-X-X-------T----EE-oo-------XX-X----X----o-X-----X--E---------X-----E--o-----XB-?---------------X?---oX---E--?--X---B--o----B--X-XX--BX----XX----XX------X-------T--?--X-E?--E-----|oX--o--X------|M-
XXXXXXXXXXXXXXXXXXXXXXXXXXXXXXXXXXXXXXXXXXXXXXXXXXXXXXXXXXXXXXXXXXXXXXXXXXXXXXXXXXXXXXXXXXXXXXXXXXXXXXXXXXXXXXXXXXXXXXXXXXXXXXXXXXXXXXXXXXXXXXXXXXXXXXXXXXXXXXXXXXXXXXXXXXXXXXXXXXXXXXXXXXXXXXXXXXXXXXXX
