--------MXX---B---------------------XBM--------BX?MB-XE------XB?-----------B-------BB--o--XXB?XBB--B---------X-------------BB-BMX----?----------MBB?XBM------------BB?BBBB-------------X?B---------MXM--
---XM-------------------------BB?M---oB-----------------B---X--------------------B------------?X----------------B---------------MXBBBB------------?X--?MX-BB----M------------------------?XB-BMB-------M
-B??B?----BB--------BBBBBXBBB-----------X?--X----?BBE---B-BXB?---E-----XX--------------------------BB------XBX-BBB------?BXBB-B------B--XM?MB---B-------------------o---BBB--EXM------------------------
-XX-BB--------M-----------------------------------------BB-oXXX---o?---------------------------X--BBM--------BBXB?X------X---?XX----------XXX?-----?BB-----BBB--------------M?XBMM-XBB------------------
--------------------------------BBX?BB-BB--------------------------------------MBBBB-----------XX------BBB----------o---------BBMBB--XX-------XBBBX?----XX------XB----MB--------------o----------XBX----
-------------------MB?BX----?---B--?MBB----oBBXX-----------------------------------BX--------------X?BX-------------------------------------BB-----------------?---------------BM?X-----------BM??------
---------MBBXXXXX---------XM------------X---B??BX---------?MBBB?----------BMX?------------??M??X----BBMMB?------X-XX-----BMBMXM-----------------------------------------XB--X-?--------B??B-X--BX-------
-------B-----------BB------o----B----B-------BX--------------------MB--B-------------X--BB-----------------Bo--B-o-------??X-------------?BB?--------------X-X-----------BB?BX-------------------------v
--------------------------------M----B--MM?-MX-B-BBX------------------B---------B----------------------BB------X?---------------------------------------------------------BMB----------------------B--Bf
BX----------M-------------------XM--------?-------MMXBoX----BBX--------------XX--------XB-MXXMB----------MBBX-----------BB-------BMXB---------------MBX------------------------------------------------f
--------MBXX---BoBXB------------------X--------??---B--B----XMB--X-------BX-------B?B-MMX--------------?BB------------------------------------------------------B----XBB-------------------------------f
---------------??--XXXXXXXBBB--XXXB------M-----M-------M??X----------------BBBBB----X----------------------B---BBM-----------XX-----o?BXM-----XBBBB--------BBX-------X----?MB---------------------MB---f
------------------ooXXX-oX------------------------------------X?-----------------?XXXB---------------MX-----------B------BB----------------------MBBBXX---------------o-----------------------?BB------f
------------?------------BB--------------------M---------BBB?--------XXX---BBB------------------------------------M-------?oB--------------BBX-----B--XB----?---X------------BXBXBX------------------?Bf
m--------E-------XXXB----?XBXB-----BT?BX?B----B----------------------oB-----M?--------BBXX-?----B--------------B??---------------------------------BB?BBB---BB?------------BXXXBX---B----o?-BXX-----??-X
XBB?B---X--??BXB------------------BM??B?-----------------------E--BX?--------??X-BBX--XMMMB-----------M-----------------o-------XM---------------------------------------------oXXX-----------------BB?X
XX|XXXXXXXXXXXXXXXXX---XXXXXXXXXXXX-XXXX-X|XXXXXXX-X|XXXX-XX-XXXXXXXXX--XXX-XXX|XXXXX---XXX|XXXX-X-X-XXXXXXXXXXXXXXXXXXXXXXXXXXXX-XXXX-X-XXXXXXXXXXXXXXXXXXX-XXXXX|XX-XXXXXXX||-|XX-XXXX-X-XXXXXXXXXX--X
