---------BB-XX--------------------------------------X--o---?------------------oX-----X?-XB---oBM-------------X------X----------------------------MB-------?-B?X--?------oBM--------------BXB----?-----o-
---------o--X-------------------------X-----------------------------oX-------------M-M?---------XB-----------?X--X--MM---BX--MB-BB---------M----------oB---------------------o-o----------B-M-?XMX------
----------------B--o--------?B----?--------------------o-B--XBB-------Bo-------------o----B-----------------B-----------B-------XB-M-----Bo------oBB--X----------------------------EB-EMBEMBBo-----M?---
---BBX--------?B----------------BBB----?-----------?B-XB--------B--B------------X---M---------------------------------------X------o?X-----------------o--------------------------------B---------------
-----------------------------B-B------------MBXX?------BX-------XX------------------------X---------oB-o---------------XXX---------M-X-------------------------------------------------o--X----?MMB-----
------------------------BBBMB-----------------XXXXBBX---------------X?BBBXB-------BB-BB-----------XBX?X-----BXX----BBB---------E-XX-B-M----M?XMX------XBX?XM?BBBE-------------B-o--------------M--------
--BBBBBoBB?-------?-----------o?B---------M---X----------------------B--M--X----oBX------------M-B---XX--o----------------------------------------B----------------o---o-X-------o--X-----B-BBX?-------B
--------------------o-------------------oBB-----?XB--oB---------B------o-BM---------------M--------?--------X-BB---XB-------------------------------MX--BBX-----------XX-------------------------------v
----------------------------------BB-XX---B-----------XX--------X-----B---X-----------------BX-------------------------o--o-X--MBX---------------------oB------oM----------E------M-----o-------BBX---?f
B-----------M------BB---------B--X-----------------------------------------------X----------------------------?--BX-XB-----------------MX--------------X----------------XB---o--o------XBXX-M---oE-----f
-------------------X--?--------E----------------------------XXX----------------------------------XB------B-----------BB--------------BB-B?-----B------------B-?B--X-BB-------X--BX----X-----o----------f
--------MB------------XB--------X--------o-----M----B-------?-------EXB-MB---------------------------------BX?-----B---oX------BX---------------X------M-----------------------------------------------f
------B-------E?----------------X--B--------------?X---BMX??---?-----o--------------oX---------------------B--oBBBB--------------------B----------B--------B--XBB----oXB----------B------BB-------MX---f
-----EXBB-------o---------------?------B--------B?-----------------------------BX-----BB--------??M-------X----------------------oo?B-------X--EB---oBB-------------oXBBB------------------B-----------f
m----------T-------------M-----X-B-----BT------B-X-----?-------------BMX-------------??-------BB------MXMX----------------------X----------------B-------X--------------------------X---X-BB----------XX
--B---?--o-X-----?XMB----------MBBX-----|?B--------------?M------MX-B--X----------------------------M-----BM----------B-M----------B-o-----------X---o-X-------------------oX----?B---------------BX---X
XX-X|XXXXX-XXXXX-XX-XXXXX|XXX-XXXXX-XXXXXXXXXX-XXX-X-X--XXXX-X-XXXX-XXXX---XXXXXX-|XXXXXXXXXXXX-XX-XX-X-X|X-X-XXXXXX-X-XX--X-X----XXXX--XX-XXXXX-XXXXXXX-X-XXXXX-XXXXXXXX-X-XXXXXXXXXXXXXXXXXXXX|XXX--X-
