----oX------M----X------MBXBB-------BBMX--------------BXM---E------------X-B------B---?------X---------X---------------XB----o-----?BB---X------X---------MB--Xo--------------------------------XM------
--B-EB?---------------------------B-----------X---------------------------?o--?---------?--------BBBBX?B?----------------------------------B?---------------------oB--o------------------Bo------M-B----
--------M-X?------X-----------B---o------o-X-----------------o---------B----XXMB--------X-----------------------XM--------------------o--------B-BX--E-B-BB-------M-----------B---------------------M---
--------------------B-------B----?-X--o-----------X--------------------------XX--------------XXBX-X?------------X---B---------B-----------?-----XX-----o---M-------------B-------------B---------?------
-?M--XXXBBB--------------XX?X-----XBBB---M---?X??------MXXX---?XBBXB-----------BX?---M----??BB------------------MBB-----?X-----------------X----------BBXBBB-BBBXBBBBB------------BB----M-MX?B?BM-------
---------------------------XX------X---E----------?-B------------------------XXBB----BB--------B?-X-----??B---------?X------B-M---------------------------------------------B--oX?-----------B--X-------
--MX-----oX---------?----------------?---oB-B-------------?---------o--o--------------E-----EE----B---------------------E--MX-------?----o------oX--------------------B-XE--------------------?---------
X----------------------------B---?-----------?-----------Eo--M----B-MB------------X-------?---?Bo----------------------BB----------?---------BX--MB-------------------------?-----B--------------------v
-o?B----------------B---------B--B--MXB-----------------------------------------B--o---------?B---X-------------X----------X---o------BB--MX------------o----X----?XX-----------------------ME------E--f
?B-XXB----MM----------MXB----------M-X---BM-??B----XX--BX-------X?-??---B-?-------------------?B-----------------o------------X--BBB----?BB-------XBMX-------E--------?--MXB------X------------------M?f
-------------------XB?-----M------B----------------------------------------------------XX-----------X-?-----BM-X--oB---B--------?------B---BMX----?B-------B-------X---------X----------M---oX---------f
-----oM--B---MMB------------B---Xo--------------o---?---------------o---?-------?M-----------B---------------------------B-----oE?-------------------------X?B--------E---MMB------B-B-----------------f
--------------------X--------X---------------XXXX-----BXBB-BXB-?X-----------?BBXX-----o???MM--------------XB-o-BXBB-------?B-----------------o---B?XX-----------------------BB---?---------------------f
-----BBBB---?------------------MB----MB--B------------?--B---?----------X--B??---B----BB-o-----------MXB--------------XBX----B---------------------------B----------------------B--------------------BXf
m----------------------E?-----------------BX------------------T------B--?--?-----MX-----------------XX-B---X-----------X--B----?---------------------?----B----T---------------B-----o----------BB---B-X
X---------------------------o-----------B--oM-----------------XEB-------------?--o--------------MB-------------------X---------------M---------?B--------------|?-------oB---BBX----------B-M----------X
X--XXXX--XXXXXXX--XX-XXXXXXX-XXXX-|XXXXXXX|XX--XXX-XXXX|-X-XX-XX-XXXXXX-XX|-X-X|X-XXXXXXXX-XX-XXXX-XXXXXXXXXX-XXXXXXXXXXXXXX|||XXXXXX-XXX-XXX-XXXXXXXXXXXX-XXXXXXXXXXXXXX-XXX-|XXXX-XXXXX|X--XXXXX--X-X-
