-------oX?--------Xo-B-------B-----------XXXX-------------------MB--------------o---XM-------------------E-?BBBBB----------BXMBB---BBB----------------------XBBBM---------BX---------BMB----------XoB?--
XX-----??--BB?----------------BB--E-------------------EBB---BB------------oB?---------------BX?--------BX------------MB----MMB--------------------------X-B?XXM--------B-------------------MXB??B-BBB?--
ooBXX--------------------BBBXX--------------X-------M------BX-------XM-------------BB?-----------XX-------BBBB----?----------------------MB-BBBX---------------XBX--------------------------EXX---------
--------------BBB--------------------B??-------?----------B------------M????-------------X?B-----------X-----------------B?-?----M-----M--------------XB-------------B?---XX?X-B-------------X----?-----
---o?M--------------BBB------BX-XB--B------oBBBM------XB--------------------MBM-------o-------------BMX?B---------B-------------------------?BX?B---BB-XMMBX---BB-------X--?B??--XXX------------------M-
-----------MXBB--------------BBB-MB-BB--------XB-----XXMB--B-----?XB?BX------------------------------------------X----------XXB-------------------------o---X--???BM--------B-BBX-BX---------------BX--M
-M-------XXMBBB--XXMM-?---------------X------------X--MX--XBB?-------------------oXMB--------?XXX?X----------------X-BBB---------B?X?--XB----X-------------------MB------?B--------------------MB-------
-----------------X---------BBBXBB--?--------------------oM?-----BB----------------M?XX-----?B---------X------------------BBB--------------------BBB---X----------------------XM?BB-BMX-BMBBXB--X?X-----v
--------BX---?--------BB?----------??BoB??BB---------------------MBB?---?BB--------------BB?X---XB?BXX-----------------------------BB------------------------------------------------------------------f
---------------------------------BB--------------------------------ooXBB------B?B?XBX---------XBB----------------oB-----------BXX?XBBB-----BX--------------oX------------------------X-?---------------f
----------B??B-XX------------------B?XB------BXXXBX-----------------o--XB-------------------------------------------------------------------------------------------------------------------------?X---f
------------BBBBo---------------------XBB------o?M-------XM--------------?B--------------------------------?X----------??BB-------B?BX------BoX??-----BBB----------------------------------------------f
-----BB--------------------------------------------XX-------??------X------------------BBBBB--M----------------BB?------------?--------B-------------------B-o--------------------B-?-----------------?f
----------------?BXXBB-----XE?X??X?B--------MXXX----------BX----BB--o----M---------------BB-----X-------------------------------------?BXX------M-----XX--------------------------------?Bo?MM-------X-f
m---------------------------oXXMX?--------XBB--------------------EBBX----------------------------oXXBBBB?--BBBBMB------XX-------------------MXXB--------------BBB----------EB??B------E----------------X
X---XX?------------XXMXBM------------------------------BB------------------MB-BB--------------------------------XM-BM----------------BM-EXBBB?------------XM-?-B---------------------MX----------?MBB--X
XXXXXXXXXXXX-XXX-XXXXXXX|XXXX--XXXX|||XX-XX-XX-|X|XXXXXX-XXX-|XXXXX|XXX-X-XX|XX-X-XXXX-X-XXXX-XXX-X-X|X|XX-|-XX-XX-XX|-|X-X-XXXX-XXX|-X--XX-XX-|XXXX|XXXXX-|XXX-X-XX-|--XXXX-X-XXXXXX--XXX--XXXXX-XXX--X
