------BBX-------X---------------XX--X------------------X?----XXX----------------------------X-BXB-----M-----------o?B-B----M-B??X--------------------B-----o---B-----B------?--------------------------E
-----M---------M?B---------BM-----------------------B----------------X--------------oB------------?X-----------BB----XB------XB------------M-----X----BX------------?M-----X-B?-----E-------------------
-------X?M-------BBM-------------?--------X?B--M-------B----------------o?--------------------MX--------------------------------?M---BBB--------XBXX-------X-??X--------BXBXX?B--MB--BB-----------------
-----B--BB--------E-------B----XX--?----------------------------BBBX----X-X----o--X---------?-------B--------------------------------oXB------------------------XX---o----BB------------B-----------B---
--BB-XXM?---XX---------XX----------M----------------------------------BBBBMXMBB-----------------XXX-------BBB-------??--B--M-----BBBB---------o?B---------------------------oB?B------------------------
-----BX-??----------B?---?BB-----------M--EX?-B-B---X-----------M-B??oBBB?---------------------------------?------------------------X?BB--oMBB------oBBM--B?X-BB----------E-----------------------------
---?X-?-B-BX-----B-----------------------XBB------------X?X?-----o----MX---------------XXB------------------------------XBM------XMBM-------------------E?-?---------XXB--BB---------------------X?B--X-
?B-B----------------------X-----o---------B-BX-----X??------------?X----------MB------BB-o--------X?------?XBX-?X------------------------BBB----------?Xo?-B--------BBXBX---?--------X?MBX-------------v
-------B?-------------------X----------E---------------------------------------------------E-M---------?---------o------X---------------BB?X----o-o-X------o-------------------------------------------f
-----------------?B----------------MBB----M--M------M--------o-------B-------------------BX--?B----?--o--------B----------------oB-------------B-------?XM---o---o---XB--?----B---------X--------------f
---------------?X---------------MX-----ooBX--------------EB-----B?BX---E?BB--------BXM?-B-------------???-M----------------EBXX-----------M?-----B--------XXX------------XB-----XXM------BX?X?MXBBX---Ef
------X-X?BXM--BX-?----------------B------------------------------B--?-XBMXMo--BX?M-----------------------------------M----o?BB----EX----B----BBBBX--oB---MXB--MBB-------------------B-----BoB?--?----?f
---------------------------------------------X-------MX----------BB-------------o---M?---------------oB-----------------X-----------o-------------XB-o----XXB-------oB-----------------BM--------XXXBMBf
---------E-------------XB?-----------o-----------XXBX-XXBB--------------BB--------BX---------------------------M---------------XX-------X?X----BX?-------------?-------MB--B---------------BMXX--------f
m------------------------------------BEX?X-----XB-oBBM-----------E---------------o-----TB-?-----------------------------------------------X-----------------------TX---E-----?B----------BM------------X
---------------?------M??----------------TX------??---------TB------------BB-----------|B---X--M------------------------------B-B-----T----------------E-?----X?--|------------------------------------X
-X-X-X|--XXX--XX-XX-X-X-XXX|XXXXXXX|XX-XX--X|XXXXXX|XXXXX-X-X-XXX-|XX||XXXXXXXXXX-XXX-XXXXXXXXXXXXXXXX-XXXXXX-XXXXXXXXX-XXX-XXX-X-XXXXXXXX-XXX-XXXXX-XXXX-XXXXXX-XXXXXXX--X-X||XX-XXXXXXXX-XX--XX--XXXX-
