---oEEo------o---B----X--X-------------E---o-oXoX-----o---------B----XX----X-------X------o-------|-X--o----E----------------------B--o-----X-o-----?----X---oM---X---X----XX-B------E----o---Eo----X---
X-|---T---X-------E-|-------|-X---?---M--------?M---------XE---XX-----B--X---B-EX-X------E------B-----o----------------------M---MX-o-XX-XB-------------X--------------X---------?--T-------?-----XX?X--
-----X|--Xo|o---XX----------X------X---X-o------?---B--o-oX--?--B---X----?E-------X----------B--X-BX-----X--?X---?------|XX---M--XXX---------------X----X---X-----X----------X------|-X----------B---X--
T-----|-X------o------o----X-X---o---------X-----X---------o---?XB--------------X-?--X-?EX----------X----M-----X---XB----?|----X-?---XX-----X-----------M-----X-o-----X-----XXB---X-|--B-X--E-o------B--
|-----|o---------o--X-------B-----o----|-o----X-X-B--X-|-o-----E-B--X-E-----------EXX------X----?--??X--?------------------------X--B---XXoB--X--X-E-------o------X--?--------X--?--|-B------X--------|-
M----X|X-------o------X----B--X|------MX--?----E--X-----o---X------X-B--X--o-B---o------X--|-o----Xo--oB-----BXXX?-----------X-o-?----X-oX-X---E--o-----EB-M----X----o?-----E------X|------Xo--------E--
-X-X--|E----E----?--------------X----Xo-X----o----X---------------|--X-o-----X---B-X-X------------------------o-XBX-----------E-BM--XX---B----E--X------X--E-----?-----o-X-------B--|B---X-X--------M--X
-X---X|B--o---?--------X-----B-------X---------------E---X--Xo---BBo---|--Eo-----X-------------BX---X-------o------E---BX---------------MXXo----?B-------------?-----E---M---X------|------BX----------v
---EXo|--oX-----------X-o------------XX-o--B-X?--------------X--E-o--Xo--E-----o---------X--E-------?X--o---X-----E--X-o----X---------o-XX--------?--X?-----B-----------------------|-------B-----X-----
X-E-X-|--XXX---E---o----o---MB-X---X-------X---?B--X-----B--TX-X-X-----o-o-?--X|-----EXX-EXB-----XX------------XXXB-X-----o----------------------B-MX---oE-X---------------X-------o|o------X------E----
E-----|--X-------------X-X-o------?o------Xo-X----o-oX---|X-|X--X--EoB--X------X-M--?-XX-o--X-------E--------o----XX-|-----X-------------------X-BX-XX--------B------------------XM-|-------M--E--------
-----X|X-----------X-Xo-----|--------o------XBo--EB?o?----------------o------E----------------------X-X------X---------X----?oB-o----XB----X-B---X------------EX--|--?-o----?B------|-X-----------o-----
--X---|o-?o-------o-----X-------E--XXE---X--X-X-------?X------X-------?E-E--X------X-----ooX-----?-o---XX--------o---E-X---|-----X-B-----X------------------X--BXXE---E----E-X----?o|--------o---X---?--
o---Bo|X---?E--X-?X----oo---------?----BEX-----XM--X----XX-----X---B----------M--X-B-------X--o--?---------X-o--------B-E-o--o---BX-------X---X-------------E-X-X-----|-o-----||XX--|--B--E------X--B---
m--B--|--------X--X---o------------M--EX--X----------o-----X----B-----------?B---Xo----X--------XEB-X-X?--X|-X-?-?X----o----Xo------------o------?---o-------|-|-X--------X---------|----X-------o---M--
XXXXXXXXXXXXXXXXXXXXXXXXXXXXXXXXXXXXXXXXXXXXXXXXXXXXXXXXXXXXXXXXXXXXXXXXXXXXXXXXXXXXXXXXXXXXXXXXXXXXXXXXXXXXXXXXXXXXXXXXXXXXXXXXXXXXXXXXXXXXXXXXXXXXXXXXXXXXXXXXXXXXXXXXXXXXXXXXXXXXXXXXXXXXXXXXXXXXXXXX
