X--?-XE---?-X------BX?----------M--------E-----o--------o----MX--------B-----------o-----X---?--?----------------o-E--------o--B---o-X---------M----o--X---X--------oX-E-------X-------X---X-----X------
M--M-oT----------XXX-----o---X----------E-------E--------o-E-MX-X---?---X--X-----------X-------X------------E--o---X--X--------------------E--M--M----B----E-X--X------X-------------E---X-----Mo---B---
-X-X--|-E-----E-----o--X---XM-ME--X-EX?XMXX---------M-T---X----B---------XXo--E-X-----------------X--X----X------------?----X-o-----E--X---X---?-X------o------B------oX-X---X--o------X---E--X-X------?
------|--X-X----X-------X------X----E-X--o-----------oXX---------o-X-XB------X--------X-EXX-----BBB-------X------X------XX----o-----X------XX-------X-X---------XXX-----oXX------XE----X-X----o---------
-----X|------X----B----X----------X-----E-o-----X-XM-------------XX--X---------X-XX---E-----XM-X-----o-X-E?----X---B--X----XB-------o-X--X-B-----------X-----X--------X---X-X--------o----X---X-o-----X-
--X-BX|---------------?-E-----X-X-------X---B-XB-----B--------B---BXXX-----------XX-------B----o---------X-------?------X--XX--?X----X-------------o---X----------X--------B---B--o-----M--E-----B-----X
-Xo---|-------o------------XXX--------X-------X-----oX-------?-------E------XX--------X--XE---XEXBBo-XBX--X-----X-X--X-----?--EX----------------oM---BE-Xo--o-----?----M----?--E--EX------X-------X--XoX
-M-?--|--B-----o--XoE------------X-X----------X-----?----X----B--M-----------B-X--X-E---BMoX-oX?-E-o-------o-o--X---------M-----B----------B-E----------B----X--M?-------B-X-------E-----B--B---?-X-X--v
----EE|-X-------o--?------X-------X--M--X-----B---X------B-----X-XX--X-------B-X----------XX-----X-----X----o----X-Xo--X-?X--X---X--E---o---X--------X---?----X-------XE--E-?---B----------X------o-X---
---X--|----------Bo-------X-XX----B--M------X-----XB--X----oX-E-----------?-------X--E--X---X-XX------------E-?----XB-------------X-----o----?-Eo--X----X--B---o--o---oX--------------o-o---------------
--X---|-X----------------M--X---------?-------o--o---------X---oX--------------X------X-----X---------XX--E---Xo---?X--B---X?--o----M-X-X----E------B?----X--BX-------------------X------E--------?-----
---X--|----------M--X----o-X--B-X-B--oBX-EX-o-------o---X-o-----------BX-----X--------------B-----X-o----XM------------?----------o--X--B----XMX--B--X-----X-------M-oXo----o-----M--------------X--X---
-B---X|--X---?X-X--EX----------X-------X--M--X----o----X-----E--X----BX--o-----X-X-X--oo---B------B--------E-X-----?-?-----X-----o-------X---------EX-E-------------?--------Xo-XB----------B----X---o--
-----o|------M------o--E----o-X----E-------B---XXB-------o-----XE-XM---XX---B-----------------------oX---oXE-o-------X-----XE---------?X----E---E-X-XoX---oX----X-X---B?-X--M-----X---o-----------X--oB-
m-B?--|-X------X---XX-X---X--|-X--EoX-B---TB?-T---------X---X-------|o-E-----X---B--E-----oX|-?-----X---o-B?-------o---------o------------------X--X-----oEXX?-------------X-------X---|Xo--X-T---?-----
XXXXXXXXXXXXXXXXXXXXXXXXXXXXXXXXXXXXXXXXXXXXXXXXXXXXXXXXXXXXXXXXXXXXXXXXXXXXXXXXXXXXXXXXXXXXXXXXXXXXXXXXXXXXXXXXXXXXXXXXXXXXXXXXXXXXXXXXXXXXXXXXXXXXXXXXXXXXXXXXXXXXXXXXXXXXXXXXXXXXXXXXXXXXXXXXXXXXXXXX
