-----o-------o??---------BEBBX---X-----------------------EB---------X---------B--E?XB-----------BXB--?X---------B--------------------------?--o--------------------XB----BXX-------------------XBB-??X--
-----M-------------------------------?X--------BM----B---------XB--------?----X----------------M------?-B?B------BB-------MX--BXXMB------------?BX-----BBBBB----BBB-------------------EB-XB------B------
---------------------------------------E------------------XBB--------X?----------------------------XX-----------------------------------------------------------------M--------XB--MBX----------X-----X-
-------------X-XM----?-------M--------------------------------------------------o------BBX--B--Xo-------------BM?X---------------------M--------?BB--BX--M----B?------BB-BB?B-------B-XXB---------------
X-----------------------BB?B------B--X-------X--B------?E---------------MB----------------------XXoMMB---M----?-o---X?----o-------------MM----o--B------------------------------------------?--B--B----X
--------------o-X?---------------------------------XBXBB?B------MX----------------------XMB-----XXX-----o--oB--?-------Bo--?------------------------X-----------B----XXBBB------------------------?BX---
------------BMXM-------MXB-------?X------BBB----M------BBB-X----X---?-----------X-------------BXB-------------------------X-----B-------------B------X---X----------BB--MBX?-X----X---------------BB-M--
X-M----XB?BE?B?---B---------------------?MMBXB----------------XBM-BXXB-----o---o------------------XX-B-X--??-EXXB?B---------EB-BBXB-------XM-------------------?------------?--------?X----------------v
BX------------------------------------?-----------o--------------------------X-----EXB-------------------?B-----------------o------------EXB---X-XBBX------MX----B-----BXX--------B---------------M----f
o------XoX?BBBB---?-------------------?M---BB-?BBBB---BBBX------BB------------B?------------------XB-BBBXX-------BB---------------------XBXX--MBB---------------------X?B----------------B-BB------MXMXf
----------------------------------BMXX----X----------B--------B?--------?---?--o-----------------------B-----------------o-------------XB------------?----------------------E--------B-------X---------f
-------BB?X?----???----------?o--M-----------------XX??-B---B-------M?--X------------------------------B-----------------?M---------------X-XX-------------o--------------EXX----B---X--B-B---M?B?-----f
------------------------M-X-B--------------------BX----MMMBX?----X?-?------------------------B-------X--BB?B---B-X---o-------X-----X----------XXB---------------BBBBMBB------------------XX-B-MX-??B---f
------Bo-X----------oXXX-------B-----------------------oB---------------XBX-X--------?B--?-BB--------??-----XB--XB--------------------------------X------------X-BBoXX---------------M----B---------M?-f
m--------------X--------?X-----B--------------o--BX---------------------------BB--------------ooo----------M------------------------X-------B??-M----------------X------------B-------o---BX-----------X
X-------X---BX-----X------B?---?------------B-----------o-----BB----------BB------------------T-----X---------------X----------------?X--------B?B--------??B---TXB------------------?--oo-------------X
X--XXXXXXX-XXX--XXXXXX|XXXXX-XXXXX-XX-XXXXXX-XXXXXXXX-XXX-|XX---XXXXX-XX-XXX-XXXXXXXXXXX--X-X-XX-X-XXX|XXX-XX-XX-XXXXXXXXXXXXXXXX|-X-XX-XXXX|X||XX-XXXXXXXX-|XXXXXX-XXXXX-XXXXX-|XXXXXX-X-X-X-X-XXXXXXX-
