XX--X-------o-X-X---------X-XM--X----o-o-X---B-----o-X--?------X----oo-X-------?---E---------X----X-B---o-E-----BBo---T---?--XB--------B-o---B-?------------------------o------o-----X--?XoXX---------B-
---E-X-o-------o--X----|-X--X-T-X--o-----?----B--------XB----X---B-?--oEo-----T--X-E?--BX---o----|-X?-----BBo-------?--B-X-X-|o-X----?o---------oX----X---o--XX---X--o-----oXB--X-----|-E-X-XB--?-----XB
-X----------B-o-XB--Xo-X--oB--E--X--o------X------o--------|o-------X---M------X---X--X-----XX------X---X------M-X-----X----------------T---B---E--|o---?-o---XE-------X--T--------X---X?----B-BX----?--
--------B-----o----o--X?---E-----X---------X--M----BXX--Xo---o--o-B--?---------|---BX---X-BM-----?-----------T-X-T------X----EX--o-------X-M--XX?X--M--E?X-M--B?-----oX-------------o-------------------
-----X----EX-?---o--------X---X------B---B-----E---------o-E----X----X-----E--X------o--o-|--M--X---------------B-MX-o-X--X----------XX-------X-----X--XB--------E-----XX----X----|----?X-X---X-o------M
M---X------B-TX-------XXXo--T---------XX---------XXXX--|o-XXBX-BT-----B-X-----X|-------o-ET---E-----T---------B------X-M-T-------X----X---X---X-M------?---M---E-X----T-o-E----B---B-o---o--------B-----
-----X--------------X-o------------------|X--X--X--o-oXoX---X---T----X-----o----B------B--------XX--------o-------?------X----X---EX--?-B---X|--X-E---B--------M--o----X----------------?-----T--X----E-
-T|-X-B------B----------------E-M---?------XM---X-XX-------XTBX---X----o----X------X?-E-------oE---o--BX-Xo-X-------B-----X--B-----o---B------B-----X-----------BB------B----X----X----X--------------Ev
X-B-X---E-------------o--o----B----X-X------o----B--B--?--o----XB-o----X-MoXX--XB--oX-----o--X--------X-oX-----?---X--------?-?X-----E---o---X-------X-E---|X---E------------Xo-------X------M----B----|
--X-B-X------E-X-------oM-XB-B--o-----B-----X----------E----E-BTX-X------------XXB|XoXoTX---E---?---|---XE-B-------?o-------X-o----T--?----E---B--X-o---------X-X--M---XM--XX-B--T-X-----B----------?---
X--X--------------------XEX---X--TXX----------X-----T---X--oX--X------B------X-----XX---------?----X--X-----o---------o-o-X------|---MoE---X-?------oE-M----?-XX-----X-----X---X---X---?----X-B?-----X--
|-X---M|--XB-----X--------X-E-----?-E----B-MXE---o-----B--?-X-----o--o-|---M-X-T----Xo---X--T----EX---------XM--X-X-X-----EE---B-Eo--?-XE---?-----E----?---BX-X--E--X----|-X--X--B?----?-E---X--B----X--
--o-?-XX---------------------------?-X----X--------X-----X---E------------X--X----XXo--------------E--oE---X----------o--o?--X--------o--------T-o--EX-MXE-X-o---------X---X-X-----|X--o--B------B--ooX-
X-X---------------B??-----X-----?-------------X-o--o----------o-B--XX-----B---X----X----X--o----X-X-X------o--oM--o-XB---XXM-------XM------B-X------XX-?-oM-----T----XX-?X---B-E-----o----------X-----T-
mT-----------TX----o?X-B-----X---X--X-----X----X-XX------oXT--------oo-X-------B----?-o---X--X---------------X-B--------X-X---XE-?------E-X---B-----E----------B-o?-------|------MX-----X---o----M----XX
XXXXXXXXXXXXXXXXXXXXXXXXXXXXXXXXXXXXXXXXXXXXXXXXXXXXXXXXXXXXXXXXXXXXXXXXXXXXXXXXXXXXXXXXXXXXXXXXXXXXXXXXXXXXXXXXXXXXXXXXXXXXXXXXXXXXXXXXXXXXXXXXXXXXXXXXXXXXXXXXXXXXXXXXXXXXXXXXXXXXXXXXXXXXXXXXXXXXXXXX
