E--X-----X--ooX------oX--o-----?----E??----X-B-X----------X----------o-E------X---E---B----B----o---X-o---?-------------B-oB------o-----B--X--X-o--XX---X--XB----X-X--------EMMX---------E---XXX-----M-o
--o--?T------------BX-o---B----BE---?X---XooE?-------X----o----B----X---o-----------XX--oo?------------|-o----X-E-X-oo?-B----X---oE--X-oo-X------X---X------Xo-o-B?--B---X----------To--E--oX-X-------X-
X---X-|-----X-------B?--------XX--------B-------Xo--B----oB-E-B----o-------?---------X-o---X---BX----XX------o-X--M---X-B----oX-XX------------------X------E-XEXo--X--X-X-B--o-----?|X---X-----------X--
-----E|-X---X-------E---------EX---------X-------B----o---X-E---o---X---Bo------X-----B--?-XB----o--M|X------------o--BX---?-B-------M-------X-XX----XX-------X--B---X-------?--?---|----X---X--------o-
-Xo---|----------?oo----XBB-X-XX--------X-M------B----X----X---o------EB-?-|X---X----------X|---o------------|XX-------E--------XXX---E-?E-----BXoBX-X--o----B----|------X-BM-X----E|---B---------------
------|M--X-------o--------o---------X--------X-------B-|-----X--|-E-X--X-------ooo--X--B---X--BBM--------------o----|X--X-----o----X--o-----------o-Xoo--X-------E--XE--o-----B----|---|------o-----X-?
XX--B-|-X------X---|-X-XX|--B------|-----X------------------XX----o--X------?---?-E-Bo----X------X-B--?-X----B----------o--Mo------?B---X-------------|-------o-o----?--------------|---X----?--------X-
-E----|-------?oX-----X----E-E-X----X----o-B-------X-?----?---o|-X---X---E------MB-------E--------X---X----o--X------ooXX-o------X--------o----B-XXo--X----X--B-------------oo------|---B|---E----X----v
-?XX--|---X--o---X----------X----------?--o-XX----?---X-o------X--X----------B--X----X--E----X-o-------X-?B-----oX--XX-------Xo--XBB--------------B-------?--------------oB---X-?X-o|--B----|---X--X----
|--o--|-o-o-X-M--MX---X---o--------------------X------------M-B--X-------XXX-o-?---o----B--B-X-----BBX?-------------X--?X--o----------?B----o-X--o-----------BX----X--|-XX-----BX-?-|-------B---M------X
?|BX--|B-X--Xo---o-----o------X-----B--M------o----?---?----E-X-----B-----Bo----X---o--XXXX----------XX-X--X-BX-----X----X-o-o----?-?-------B----XX---X---o--o--X----X----o---X----||----------------X--
X-?---|-B------X--o---|B---X---E-o--------X|X--X-X---o---XB-?------X---X-E--X-X-o-------B---o---X-?-----B-----B-----Xo?---X---XX-oB-------X-BX------XoX--X--X--X----?-----B-----|X--|---o--------Xo---?o
|-X---|-X--?---------X----Xo--B|---EB--E---|XX---------------|--Xo--X--|E---X-X-----------------E---B---BX-?-----X---X--B--X-----oX-----------|-------X------------XXM--------------|---XB?-----?--X-B--
----X-|----B---------|X--?-?X--?--X-----M---------XM--------X--?-E------X-------o--X-X-X---X---B-?------------X-----o--?-B-------B--B---|-------BB--B----?B--oX---------------X--X--|---------X--XX-X---
m--XoX|-XB-----X-E-----X----------XX----oM--Bo-E-----B--o-X---X------XX-oXXoMX------|-----?--------Xo-XX----o-XE--X-----|X--X-?--------BE-X----------B-----X--?-XB--X?XB--B----X-Xo-|-X--------X--------
XXXXXXXXXXXXXXXXXXXXXXXXXXXXXXXXXXXXXXXXXXXXXXXXXXXXXXXXXXXXXXXXXXXXXXXXXXXXXXXXXXXXXXXXXXXXXXXXXXXXXXXXXXXXXXXXXXXXXXXXXXXXXXXXXXXXXXXXXXXXXXXXXXXXXXXXXXXXXXXXXXXXXXXXXXXXXXXXXXXXXXXXXXXXXXXXXXXXXXXX
