-o-------------X---X---------B----Xo--------------oo--X----X-o---?-------------X-----Xo---?-----------XX------E---------X-X-------?-EXXX--------X-X-------X-X-----o-------o--------X----Xo---o-X----B-X-
o----oT-----X?------X--X---XBX--o-----?--o-----------------X-oX-----B----B-----X--M---M---B-XX--------X-X---BB?---o------------X-----X-------B--X-XB---XX--X--BXE-----M----------------E-----------X----
XX---X|oE-o-?XE-X----?B-------X-X-o-MMB----oo---X---X-----XX-X------M--X---B--------?----E------B--------X------X----M-X---X--------------X---X-o-----o------X-X--------X----X--------------X---XX-B---B
---XX-|----------E---o----o----?---E---------X-------X--o---?B---oXXE--X----B----XB-M-?o------------------X--X----X-X-o-------X----------B---E--------XB-----------X---------------o--XB--X----oE------o
-?--E-|-XX---------MX---------X--oM----X-XX-E---------B-----B---?----X---X--BE------Eo--------E---M-BX----------X-X-------B---X---X--X-?X---------M-BX-?X-------X-----X--?-X---XX-X---X--Xo---------X---
M-----|----X-X-X-----------BE-o--X--BX----------XXM--?--------X-X--XoX-oB-------X-o-X------?o-X------E----MX-oo--X----E---X-----X--------------------XX--o------B---X-o----o-------X--B--oX-B----Xo---XX
------|--o---XX--------B---X--X---?-----o-------------o------M-----M-o--------XE---B-?---X--o-X----B-XB--BXX---------X-------X----------o----o---o---XX---------------X----------------X-----X??B------X
?---E?|-E---B------B---M-B----MX-X---?---------E---X-X--------B-------X-----o-X---X----X-------X--M-BX-B?----X------o-B-B-----o-X--------E-----------B-X---XE--EE--M-------B--?B---X-X----------XX-----v
B-o-X-|--------?--------?---------------X----o-X-----X---?--?-BX---X----MXX--X-B-----X-----X--X-------X-o-XXX--E-X-------X---EB-----X-?------X--o--------------E----------------X--EX------E------o-X--X
MX----|-X---BX----B----X-------------------X--o-X------o-----------B----X--X-E--E---X-----------B----M---B-----X--------B-oX--------?-?BXX----X----B---Xo--X-o-EoB---X?--B---E-E--X--B--E----X----------
---o-X|XX-B----X-?B--o---------M----XX---------oXo-XB-X------Xo--o------o---o---X---B-X--------------o-o----X?Bo--------------B-o----------X---oo-B----M-----BM--?---BX--XM---------XB---X--B-o---------
----B-|-X-----?---?---?--------B-X---?---Xo--------BB----?----M---oXB------B-----o----BXX--X-------X-----B----E----------?-------------M----------X--EB----Bo--XX---X--BXo---X------X-?--------E--------
XX---B|E-T-B-X---X-EB------B?-M-E-o---X--------X------E--XB----Bo-B--------B-B-----------X-------X-----X---B-o--------?-X------B-----EX-X-M-X------o--?----X------------X---X----------B---------o---XBX
---oo-|--|?-?X--X-B-----X-X--------X---------------E---B--X--------X----------XX--XEX-X-------------B-X-----XB--BX----o--Xo--------X--E-o-X-X----T-----X-------T---B-E--?----X------B-------------------
m---?-|-B|-----------------X-BX-----X-BE-----X------o-----B----XB---X--?o--EoX--------X-----X--X---X--X------Xo---M-o----B-----o-o---o-----X----o|-----X---X---T--E--M--oXB-----X---X--X----X--o--X--XX-
XXXXXXXXXXXXXXXXXXXXXXXXXXXXXXXXXXXXXXXXXXXXXXXXXXXXXXXXXXXXXXXXXXXXXXXXXXXXXXXXXXXXXXXXXXXXXXXXXXXXXXXXXXXXXXXXXXXXXXXXXXXXXXXXXXXXXXXXXXXXXXXXXXXXXXXXXXXXXXXXXXXXXXXXXXXXXXXXXXXXXXXXXXXXXXXXXXXXXXXX
