T-----------X-----X-E-T----X-?-X------B-o-----X-|----?--o---X---X---T----oXo-XEX-?---X---X----T-----?----B----|-----X--Xo--X------T------o----X--XE------X-X-X--o----------------X--XX---------T-------X
MX-X------X?X-----X--X------B-----o-------------T------o--|-X-X----o--M--X-------o-E-------------?----XX-X-?X-X------o------B---------------B---M----E--TM--T------ooBo----X---B---?---MX----------|--E-
--X---X---T--|-XTE------oXBX------------------o--X---XB---B-E-------?--B-X-M--------B--------------E-X-X---X--X------X-X----------X|--------XooE-----oT-E----------X---E----------B---------oM--X-B-o---
--o-------------BX--B--B-----o-T----|-----------?EE-|---o---XXo----EM----B--E--XT----X-MXX-----------B-X--E-X-----E--X-------X-o-XT-X---MX----?-------------X----B----E--E--------X---T------?------X---
-|-BX-B-?---?----XT------------o--------------E----------o----|-----------------XXoM---X--X-BXE-----o--EX--------------------XX--X--------o----o-To--E------------X---X----?---o-XXX----------X---oT----
----------X-----E--------o-X-----E--X-----o-M--X-X-----|------E--BE|-X-M---X---|--?------------|------B--?o---X----------M----MT--o--o-----oX--o--B--X---B-X-M-------X-o-----?-X--M-----X-----?X--------
-XX------B----X-Xo---|-------o---?---M--E|--B---B------B------o-B-----?X-X--B---X--EXE?---X-X-------T-X-----------B---X-----Bo-----X---------o-X---B-M------o--X-X-|--Bo-----------B-------X-----?--X--X
---X-------o--X----o-ME-X------------E--X--oX---o--X-B-----oE---X?-?--|--?-X--oBX--------TXXXoX---o-?oTX?-------|---X--B---EX---E-------BX--B--BX--o-o--E------X------B?------|----------oX-?--B--X----v
-----E-X------------TB?---B--------?----------?-|-----o-----------------XX-----B--T------------oX------X?|-X--EX-XEoE----X--EX?--XX--M--B-------B-X-X----X-------X-B------?-T---------E-------|----X?---
------oE------B-------X----------E-------o-X-MX---oX-------X--------o-------?-X-----XE---|--X---------X------o-----B---X-X---BX---------------X-EB-X-Mo-----M-B-------X---o-X------XX-o-X------XB-X-----
-------X---E--E---EX-------B-----o-----o?-------T-|---XXX------------BXX----E-------XB--X---X-X?-Xo--B----B--XB-?-E----B-o---oB----XX-ET----M-----TX----X-T-----------X-----XX---?B---X-----X-B---X-|XX-
-------|--o----------X-------------X-----X-o-X----------X---X-----o----Xo-M---o-----X--------Bo-MX----X--o-----X---------o--T--X--X---------B--B----|---X--------XX--------X---X--------XX-|------o-o---
-BXE-Xo-----X?----X-----o-----o--EM-?------T--------?------------X--------B------o----E----o------o-?-o---------X-----o----------o-X---------M------------?-?--------------XX|--XX-----------BM-----?o--
-o-X-X--X-----B------o---M--B-?----------------Xo-E-o-------XXXB-X--------X----?----B-X--X----XB---X-XX-X----------?E---------X-----------------o-X-oXB--?--?-X----o--------B---M------X-------X-E--BX--
m|o-oM----X-----------X---oX-----X---------XXB------o-------BB----X--X-------------E-----?-----|--BX---X-----o-X------EX-?-----?B------------o-X---X--------X-o--X-|---XX-------?--X-X-M--B----------|--
XXXXXXXXXXXXXXXXXXXXXXXXXXXXXXXXXXXXXXXXXXXXXXXXXXXXXXXXXXXXXXXXXXXXXXXXXXXXXXXXXXXXXXXXXXXXXXXXXXXXXXXXXXXXXXXXXXXXXXXXXXXXXXXXXXXXXXXXXXXXXXXXXXXXXXXXXXXXXXXXXXXXXXXXXXXXXXXXXXXXXXXXXXXXXXXXXXXXXXXX
