--------------X---------------M---BBM-X?X-----B-?BB-------------------------------MXMM-------------------o-M-----B---------X----BB---oXB-B-----BB--------oX--XBX-XX----?-B------?BBXM-MMB----XX--BXB----
------M-BXX------o----X-------o----------------XB----B-----------------------------B-M-----oBXXX--------------X--X--XM---BXB-----?-BX-------------------?BB--B--BMB-------------------------------------
---BX---------B------X-o----X-?X---M-BMBB---B--BX----------B-----BXMB--------------?M----XB-XX------BBMo-----------BBX-----------------------B-------------------B------------o---XXX-BBM------BB-?-----
----B----------------------M----o-Xo---------oB--------------BBo----X---------------------BBB---------------BB----------oB-------X----------------------------o-----BX--o-E-------X---------------------
----XM-?---------------MB---B-------------XX--------------o??B----M-----------------------oBB-M--------------XBXM------------XX-X------------------------B-X-X------------------------------------------
------?M-----oM------?-------------------X------------X----------------------BB----MoBB------------B-------o-----------B-B------X---------M----X--------------B---o-------------XX----------------------
----oM--BXX----------B----------BXXB--------------------------o--MXX------M----XBBM-------MM----------oM----------MMB---M--??----------BXBMB------------------B------------------------------EBMX--B----
------------M----?X------Bo-------M---------------oXBo?-----------------X-----------X------------------------X-----------X-X-------X---B-E-B--o-----?----------------oX--------------?-BX------?-------v
----B--------?X------------------------------B------XXXX-BMX-------------XX--X--------XXXBXXB-MBB---o?X--B--X-X---BBEX--------------X----------o-BMM-----X----o---------B--B--B--ooBBXB-BMB----------oXf
-X-B---o-BB-----------X------------------------o--?X?-----?----B----------B------B--Bo----X----------M----------------------------?----X----------B-----???--M-B-----------------?B----------X---XX--oBf
------oBBB-B-----------o---------------------------o---------E-BXoXBo-----------?-X--------------------------BM-----------X----------------------B---------------------?X---?BXBXB----------X---o------f
-------M----------------oX-------o---o----------M-------B------------------B?----------------B------------X---------o------------Eo---------?---o-------X-------------------?X--------------MMB----MX-Xf
----------------------------------------BMBB------------EB----XB------MMX---XBBMB-------------------?E???X----X?------------------------------------------BBBB--XB?---X?XX--MBB-------------X--??X-----f
-----------------------------------------------BB?-----------------------------BXXXB---------------------------BBXXBXB----------------------M?BXBBBB--MB?--X??B--------BB---------------------XB-------f
m------BTBM?--------?BBBX--EEB--B-----T-----------X---B-X-------o--------------E-----o-------------MX----E?------X---X-M---------M?-------------------X--------o---B--BBX--B?----------MXX--X--BBXXoM?-X
B-B-----|---TB-----X--X----E----------B---------oMB---B---------E--------------------T---------BB-MXB---?-X------------EB---B-----------------------------------B-oBBB----------BB?--------o-----------X
X-XXXXXXX-|X-XXXXXXXXXX-XXXXX-XXXXXX-XXXXXXXXX-X-X--XXXXXXXXXXXX--XXXX-XXXXXXXXX--X-X-XXXXX-XXX|-X-X||X-XX-XXXXXXXX|XX|XXXX||-|XXXXXXXXXXXX-XXXXXXX-XXX|XXXXXXXX---XXX-|XXXXX-XX--XX--XX-XXX--X-XXXXXXXX
