----oB------------------?BX?X?B-----BoMXX-------------BB-------???---XB--------------------------?--------?---------------XXX---------------X-----------------------X---------------M----------------B--
----E----------------------------BB---------------------------------------MoX--------------------BBBBBB----------------------B--------------???X---------------B-----Xo?-----------------BBM-----BB?----
------------------------BB?--oX--B------M?-----BB---------------o??BBB-----B---------B?XXXB-BX---------o?X--------XMX--------------B--------------XB---------------------------o-?X--------B?X----------
-oMBB-------------BBX----------XBXX-----BB?-MM----MBX-------------MBB---X?XBBMM-X--------?X-E-----??---ME?--------------XX?--BB-BX---B-B----MBB---------------------BBX-o?-----------B----oB------------
-BM--XBXXB-----------------------------BMMXB--------BM-------------------------B----BBX---??--------------------B?B-----E?B-----------------------XX----------------o-----------------------B?MX--------
---X-----------------------XXM-------------------?XBB---oB-------------------XXB---B?----------XXX------??---------XBBXXB---XBB---------------B-----BBB--oo---E---------------M------------?BXMX--------
----?-------------B?---XX?--------o----------------o---M----??-------------------------------------------BBX-------?-------?MM----?X--BB--------------------BX--------o?------------X-o-----------------
-----------------------------?---?----------------------------------BX------------MBX-X--BX---o--------B?B--------------------------B-------------BB?---X?B--------------------XB------?-----?---------v
B-?B-----MB-M-MM--------------------XXBBBB-------------XB-------B-----?-BXXXB?-----?---?--------X-----X-----BB-------?----X-----------BM--------------------------------------BX----BX------?--BBB-----f
?BXXBB----oMBBXB----XX--------------oXBM?BX-BBX----------------BMXBB---BB-?X?X---------------XMXB-----------------------------------?BBB-----------------------X--XBBBB--MB-?---BXX----B---------------f
---------?------------------------B---------o-------------------------------------------------BB?X-XXoBBX--?-----------EBX-----B------B?M-----?--------------------E?oX-------------B----BX-------BM---f
-------o-------------------BXX---------------------B?X---------------------BoMMX-------------BX-------o?--------------------XX-MX?X-----XMX----M---------BB---BB?-----------------B-----B---------?-BM-f
--------------------X--------??--------------?X-------EB??BBXX-B??BX--------?X-XXM-----??-----------------BBMB----------B---?EBBB----------------B-XB----------------------------------B---------------f
-----?BBBB--------------------------BX??--------------BB-M--------------B--?B----?----XXMB?--XXX-----BX-----?-----X---X-----E---MB----XM----------------BBB----------?--BBXX----X-XX-BB-BBB------------f
m-----------------------BBB-XB------------BX?B?--------------?BXB-T--BXM---XB-----TBB-----XX--------X?BBBB?o----------XTBBBBX--?XBB----X?B-----------------BM-----------------------oM--o--------X--T--X
XB---------?X-------BX----------M--------BMB----------------XB----B--X----X----oB--BX-----XB?--------------------B-----BX-----------XM-----------o?------------B-----X?X?---------------------------BB-X
X--XXXX--XXXXXXX--XX-XXXXXXX-XXXX-|XXXXXXX|XX--XXX-XXXX|-X-XX-XX-XXXXXX-XX|-X-X|X-XXXXXXXX-XX-XXXX-XXXXXXXXXX-XXXXXXXXXXXXXX|||XXXXXX-XXX-XXX-XXXXXXXXXXXX-XXXXXXXXXXXXXX-XXX-|XXXX-XXXXX|X--XXXXX--X-X-
