----B-------------------XBXXXM------XoMXX-------------B--------???-------B?-----B?BM?XBX----MB-------BBXXB-------------------------?-----X------XXBM--X-----------B-?-o---------------------------------
----B----------------------------MBX--------------------------------------BoX--------------------BBBX---------------------------------X--------o-??XXXoX?--BM?----X--EXB--BM------M-?--M----------------
------------------------B??--oB--B------X----------------XoB?BX--XX------------------------X--------------?MX-----XM------------------?X----------------------------oB-------------------------EX-------
-oMBB-------------XXX----------XBXX?----BB?-MM----MB?-------------MoX---B?B----------------------------------------------------------------------------------XBBBB-----o--------?BXB-------B------------
-B?--XXXXB------------------------------BB-X------M------XB?--------?B-----B-----BBMXB------------------------?B?X--X----------X-MM-?B------EB?MB-BB----B----?B---BB?---XBX------------------------o----
---M-----------------------XX--------------------??BB---X--------------------XXBX--B?----------XXXX-----??---------X?BBB----B?------oX---------------------------------------M-----X--------------------
----?-------------XM---XXB--------oX?--------------MM------------o--------------------B?M----B-BBB---??----------B?-----------X-?XX?M-BBBBX-----X--E--------------------------------------------------B-
-----------------------------?---M----------------------------------BX??-----------XXBBM?-------------X----------BBX-------------------------BBB-------------MBXB-------?---XX-------------------------v
B-?B-----M--M-B---------------------XBBBBB-------------XB-------?-----XXBMXX-------MXX-?--------B-----X-----BB-------?MB--MB----------BMB-------------M---MM--------o?oB----XBXX?-----------o----------f
?BBXX-----o---M-----XXX-------------BXBM?B--?XX----------------B?XBBB--?B---------BXXB---------------MBB-----B----BE----?------oBB-XX---BB---------------M---MBBBX-------------BB?BB---------M------BB-f
---------?------------------------B?--------oMB-------------------------------B?M----------XB?M---------------------B-----MB-------BX--------M----XB?X---XMB----M--BX------B-?B--------------XBBB------f
-------o-------------------BXX---------------------X?X---------------------BXMM--BB---------BBX------------BM-----------B----MX-------------M?B--------XMBBB?BB---------------------------------B?--X??f
----------------------------------XB---?---------------X------------------o------?--------------B---XB-X---BXMBB-----------------------XM----------------?B--------XoB-------------X---BX-----oXBB-----f
-----?BBBBX-------------------------B??---------------BB-M--------------B--XB----X----XXMB?BBXXX-----oX-----?B----X---B-----E---XB----------------------?-----------------------B----------------BB----f
m-----------------------BBB-MB------------BM?B---------------XXXB-T--BX?---XB-----X-------?B--------XM--------------XBX----------BB---------------X-??X-------o---BXB---MX---X--------?X-----X---------X
XB---------?X-------?-----------oM-------BX-----------------BB----X--X----B?-------BB--------B----?X?--------------------XXB----------???----X------------------XXX-------XXXXXXXXB----BBBX?-X----BBBX?X
X--XXXX--XXXXXXX--XX-XXXXXXX-XXXX-|XXXXXXX|XX--XXX-XXXX|-X-XX-XX-XXXXXX-XX|-X-X|X-XXXXXXXX-XX-XXXX-XXXXXXXXXX-XXXXXXXXXXXXXX|||XXXXXX-XXX-XXX-XXXXXXXXXXXX-XXXXXXXXXXXXXX-XXX-|XXXX-XXXXX|X--XXXXX--X-X-
