-?BBB-----B--------BBBBXBB-B?----------------BBBMB------X-------------------------B---------------------M?----------------XBBXB---------BXBB--BX--oBX-----BX?BBBX----------------------------BBXMBB----o
--------BB-----------------?--B-o---B--------------------EX------------XXX?oXXB---B-B--------------X------o?X---B--XB--------XXB-B--------oBMXEX--------------BBX-------------BX?----XMX-----E----B-----
---------BBB---B----------------o-----XB-B-B---B-B-XEB--B--------------B-XX-------------ooX--X-----o----B------o?BB----XBBB--------B---B?BB-----------XX-----------X-BBB--------------------------------
-------oBB-------------BXX?X----------------MB???BB----------------------------------------------?B----------------------BXB-------BB--------oXXM--------?o?XBB?BB-----XB---------X--------MB---B------o
--------------------X??BB--------BXBB-----o?-BB?---------------o??---------------------BBX?----BXX--??-----------------------------------------XXX---------------------BBB----BBXEBBB---------X---------
--M?XM??MB----BB?---XXM---B--------XX---------M------------MX-----------?-MBX----XB---------------XBX-----B-----------B------------XBX?B-----X----B------X?-----------------o---XXX-----XM--------BB----
-MX------------------BBB?-------MXBB------------X------?BBB--BBXX-X-----M?-------?BB----------------------------B?B------------------------------------o?-----------BXX---E------o-------B-------MBXX?X-
---E-oBB?-X?B------XBX-?M-------------------X---------BXXMB--------------------XB--B---?-------------------------MBBBBB----B---------?XBXB-------------------BBBB--XBB-------------------B-------------v
BMM-------?XBB?BX-----------------BX------------XXBBB----------------------------B-?MMMMB-------X-----BMMB--MM----------??X-------B------o??----------BM------oX------------XX?B--o?E------------------f
X?-----------------BBBXBBB-----XBXBB----------?B?-----------BB-----XBB?B-------?--------------?----B------------XXXXBX---------oB---------?BB?--MMXBBBMM-----------?-------------------EX---B-M---B----f
-------?X---XXXB-------MM?-------------BB-------?-----------XXX-----------X?----BXM--------------------------------BB?MB---B---------------BXX-----MB-----B-------------------------------------?BXX-M?f
---------------------------------------------XXB---BMB---MBBX----------MBB---XBXXBB----------MXBX---BBBXB---B-----------------BB-------B-------------------------?X-------------------------------BB-?Xf
------------------------------------B?---XX-?B-----------XBX?--?--------B-------X-------XX--XX--------X?---M---------EX--B----------o-------------------?----oX-EX--------------------oXM--MBXBX?E----?f
----------MM?----------------------------------?B--------------------XM?M--------------------XX?B----XXX-----?--------BBBXBB------------M-------------BB?XB-BXB---MX-?-----------------------?M--------f
m-----?---------BXBMBXB--??-----?-----------------XX------B-----B-------B---------B---BX?---------MB---------------------B--------------XX---XB------------X--?B-----XXX-----oXB-BEB??----------------?X
XXBBX?------------BX----BX?---------XMM??BBX?---?XB-----oX------------------MB?-------BBBBBBBB-BXXBB------BBoMX-MB---oXBX?--BB?-----------T--o?XX-----M---BX----------------------TX?BBX?B-------------X
XXXXXXXXXXX-XXXXX-X|-XXXXXXX-XXXXXXXX-XXXXXXX--X-XX|XXXXXXXXXXXX-X-X-XXX--X-XXXX-X--XXXX|XX|XX-XX---X-XXXXXX-XXXXXXXXXX|X--|XX-XX-XXXX-XXXXX-X-X-XX-XX-|XXXXX-XX-XXX-X|XXXXX|XX|XXXXX-X-|-XXXXX-X-XX-XX|
