----B----------------------XX--------------------------XBB-BXBoM-----B---------X------------------B?BB-------------MX?-oXB--------EXMX?BX-XXBBBB??BBXBBM----o??EX---X------BMM?------------XXMBB???B----
----B----------------------------MBBM-------------------------------------MBX-------------------------BBBBB?XX----------------------XXB-----oBBXX?-B?--------------XBBMX-XXX--XBBB?MX----------X?----BX-
------------------------BB---XBB-?------M?BB---BB?--------------??-BBB-----XX--------B--XX--BX---------o?X--------BXX---------o-----?B----BBB------------------------------------------X----------------
-oX---------------?MB----------XBXX-----MX?-MXX?X-M?B---------------------------------------B?-?------BXMXX---------------B-?--------------X-----XBB----XBB-------------XXBX---oXBX---------------------
-BMB-XBXXM-----------------------------XMMX---------B--------------------------B----?B----BB?-------------------------?XBBB-----------------------XB----------------o-------XXBB----------------BM------
---X-----------------------XXX-------------------B?XB---o--------------------?XBXB-X?----------XXX------XB---------XBBXBB---X?MB--------------------------XB----------BX----?---BBBX-------XX-----------
----?B------------XBX--X----------o----------------B?X-X----??M------------------------------------------BB--------BB------BMM----?---B---------------------BX-------------B----------B--B--------------
-----------------------------XB--?--------------------------------------BX?-------X-------------------------------------------------B-------------X-?BBMX?B---------------BX---------------------------v
B??BB-------------------------o?-BBB------------o-----------------EB---o?B---?BX-------------------------BX---------XX-------B--------------------E----MX-----XBBXXX-------B?BMB?BB--------M---------MXf
?XXXBBB---oBX-X?X---oXX-------------o?BBBBBXMBXB---------------MMBXB---BB-?X?BB--------------XXXM-----------------------------------?XBBBMXXB----------------------?--XBB----------X?------------------f
---------X?-----------------------BX--------o-------------------------------------------------------------XB----BBBBBXBM---------BXM-----------------------oBM--------?---------B----------------------f
-------oBB-----------------BX------------------?X-------BX------B---B-----XXB-----o-BX--------------------------------------?B?BB??---------------B------XB---BBX--------B---------oXB---XXX-----BBB---f
--------------------B--------X?--------------BBX----XXB---------B------XXBX------------?-------------------XXX-------X?------X?XBX---M--------?---------B--BBB?B?-------B?-----------XBBB---------B----f
-----?BBBB--------------------------??----------------XBXXX-------------XBXB-----BM---XXM----?XX-----BB-----?-----X---M------BB-------BMXB-----BBBoXB-----------XBBBXX-?-------BB-?B-------------------f
m-----------------------MBBBXX?-----------?X??X------------B-----XTB-------X------TB------?B--------MMXBBX-o??B-------?TBBBBB--MXB-----E?MM--?-------------?B---BM----------BX----------------------XXXX
X----------?B-------o-----------o--------XBX----------------XBB?--M--?B---X----BBX-?XB----XM---------------------X-----B------------XBX----------B-------------B-----?X---??MX?------------o?----------X
X--XXXX--XXXXXXX--XX-XXXXXXX-XXXX-|XXXXXXX|XX--XXX-XXXX|-X-XX-XX-XXXXXX-XX|-X-X|X-XXXXXXXX-XX-XXXX-XXXXXXXXXX-XXXXXXXXXXXXXX|||XXXXXX-XXX-XXX-XXXXXXXXXXXX-XXXXXXXXXXXXXX-XXX-|XXXX-XXXXX|X--XXXXX--X-X-
