----EE?----BE---XB--------XB------EB|---X--XX?--X------|-B-T------?-?oX-o------|-------X------?-------XB--------X---o---X-X----E-----|?-T-----B--Xo---X-XX---B---?----B-X--X--X--|---------------o------
------------?----X-X-----?--------E------o---oB---?-B--------M-?-----XM----------X-T---X------?--------------X---------M--X--E-B-------X-X------B------X-------T---------B---XX-----------X--X----E----X
-E----------E----X-----------o---o-B---M-B---XX--------o--X-E----------B------XE---------X----o-X------T--X--o---------------o-X--TX--B---X-M-------X?XX---------------------------------To----X-------E
--XM-------------|--------o-X--X-----XX?------oT------|---X--B---XE-M-----------XB-----|B----XB---------X---XX--o----oX-----X-M--B--X---BX---XEX--o-T---------TXB--M-------B------T-----?-B?-------XXB--
------?--?-----M-------XX?X-------XX--XE-----?-----To-------X--Xo--XXX--------o-----X-o--BE-o----B---?---X--------T-----BX--X-EX-------------------X---------------?o-To-X-------E---o---X--------|-----
-T--------o----X--------X-B---X--X-----E-----X-XX---EB----X---E---M--XXo-X-X---MX-?---B---X-X-------------XX-M------B--------X----XX--------X--X-B----------------X-------X---M--o---X--X--E--------T---
------X----------X-----------X--X---X----o-----XX-XXX-M--?---o----B|---------?-----o---------------X-o----BX-------TX--X-?------o-----X----Eo-B------------XM--M-X--X----?---B-X--X--|-------X--X--X----
----B------X-----BB---XX--M-------XoX-XX-----------T----------?-?------------|---------|?---o-------T---------XoX-o-------XXoX------E?Xo---X--------o-X---------o-XX---X-----B-X---XB|------|---X----Xov
---M-------|?-E-o------o?-?-----X?-----?-XX---M---------X--X------T---o-------B----?-----X-EXX----X---------?--E---------o------X----X-------XEX-------X-X----------E--?------|-o------?------X-X-?-oE-o
-T-E-?o--E-X----o---E----?---|--X--M-------------------|-------?----?--o?---?-----------B-----X--X-o-T-oo--------X-XM--X------BM--X-B----?Boo--------X--?Xo---M---------X----------M-----M-MXX----XX---E
-E-E---------X--E-------X-XoX----X------B---------X----?---oX--X------?----------B|oo-----Xo------X---oo-XB---T---?-------X-------X?-o|-----o---MX-X-M--T----|T--B----o--T-|o-----|X--o---B-X-X---------
--E---X-X-------|-o-----------X----Bo-----?--?---M--X-?M----X-------XB-E--oX?------o----X---E--E-|-|-X-----X-T----X--?BX---X-------T----XX-X--o--BXMXE----------BXEo-o------X-------X--E-oo-----------B-
---oX-oB--o--------X------------------X-----------------?-X-E-----o--?M?--o-oX-X------------------B-oX-X-M--o----M----oE--------------T-XXXT-----E-B--X--E--|-M--T---X----B---XX-BX----X-E-B--------XXB-
oo---X--------ET--E--------X----?-------o-oXo---oX-|-----X--------M---XM---X-------o--B---BX--------o--?X--BX--E------X---T------------X---X--?----X--E--TXE-B--XX-X--|B-X--oX----B-----X--|----Bo--B--T
mX-XM--XX--X------X---------T------XT--?T-T------------------?----XT--------M----X---B|-------------BB---------X--X-o-?XX-----o------ME-X------o--B--?-X----X-------X------X?---?-E-B-o---X-----X----Xo-
XXXXXXXXXXXXXXXXXXXXXXXXXXXXXXXXXXXXXXXXXXXXXXXXXXXXXXXXXXXXXXXXXXXXXXXXXXXXXXXXXXXXXXXXXXXXXXXXXXXXXXXXXXXXXXXXXXXXXXXXXXXXXXXXXXXXXXXXXXXXXXXXXXXXXXXXXXXXXXXXXXXXXXXXXXXXXXXXXXXXXXXXXXXXXXXXXXXXXXXX
