oXB---------------------------M-------B---------------?o?BBM-----------------oXB---------BXX-B----------BXM------------BB?X--BB-MM------?B------------------X--------B-------MBB----------------XXM-----
---BBM-?X-----------------MBBM-----------B---------------------MB------BX------B-----M-------------XB--------------X-------------------------------B------XB--------B?------------------------BBB?---B--
oB-----E----?B-----------?BM--------oXB-----------------XB--------BBBXM---------XMB-XBX--------------X----------------------------------------XBXXB-----------------------BB------------B?X---MB-------X
o-B----------MBB-----------XB-----------BB?----------------------oBB--------MBBBBBX-----B----------------------------------?XMX--MBX----------------?B-o------o??BBB--B-------------------------------X-
---------------------XBB---------------------------------B--------------?B-----BBBM----X-o?B--B-X-----XXB-----E?MoXX---------------------MB------------------XX---------XMX-----------------------------
EXo?X--BXX----B---MB----------------?X--BBB--------------------B?B?------------------------------------------oB?MX?-----------------------BBB-------------------XB-----BBB------------------------o-----
-BXB--?XMM-------------------XBX-------------XB---------XX-----B------------------XXXB---------??XB?B---XM---X?-------B--B?-----EXXB-------------EMBB---?B-BBBBB-------XX------X?BBXXB-BBBB--M------?o--
--------B---------o-------------------XMMB------------B--------MXXXXXX------------------XMB-BMXXXXBo?BX?M--------X----------------B--------X------------------?----------B---------------E?XXBXB-X?XB-Xv
--o---BBX---------------oBB-----MBBBM----------B-------------XX----------MX--------BB----------------XX------EBXXX--------------------------B?M?XM----X------------oB-----------BMB--------------X--MXXf
---------------------------XB--MB----------------------------------------------------XBB?---------------------XXBBB---------B---B--MB??BB------XM---BX---?XXXBXX---B------------------?XXBB------------f
-----------------------------------XXBBBB?-----oX----XBXB-------XB?X--------------------B------XX-------------------BXB-------BX--MMXBM---------------------BXXMM----BB--MB-----XXXX------BB?MBBBM----Xf
-----------X-------------BB---MXB---------XBX---?X------??-----------------EBX----------o-X---------XBMX------------------XE-XX----------------------------EB-MXM---------------X----MBX-o-------------f
-----------------BMXBX--------X---------XB?B?B-------EBBB--BBBB------BB?---B------------------------------------B?BX-BBBBB-----------------BX----------------B?-B---------------------MB-?------MBB----f
------M--------------------B-----------------------------------------X?-XB------------------BXB-----------------oMB---?----B----------------------------E--XX---XB-XXX---------?--BMBXB----------B-----f
m-------------------M--------o?X------XBB----------------T?X----BB--MBX?XB-------------------------MXBBXX--?X?----BT---oB----------------BXXXX--------------TT------------------------MB-------TX------X
X---------------XX--------------------------------XBBB---|XBB-----------XXBM------------oM---------X---------------|--?XXBBEX-----??X------------------XXX--||BB----------M---------------XBBBX|BXX----X
---XXXX-XXXXX-XXX-XXX--X-XX-X-XXXXXXX-XXXXXXXX-X-X-XXXXXX-XXXX|X--XXXXXX-XXX--XXXX|XX-X-XXXX|XXX-X--X-XXXXXXXXXXXXXXXX-XXX-XXXX--X|XXXXXXXX-XXX-XX-XX-|XXXXXXXXX--XXXXXX-XXX-XX-XXXX-X-XXXXXX-XXXX---X-X
