------o---------MEo-Mo---?--?-------?-----??-------o------------BB---------E-------EB-o----E------------X-------B?-------M------T----------M---X--------o----------------------M----E--?----------------
------BM?-M--------B--|-X?-X-----?----------E-?------?-----B---?--BB------------------B---------E-------B-------o--------------------X------T-T------o-------------?-----------------------oEE----B-----
------|----------M--M-----------------o---o---------------------------------------------E--o-------o-----B--------------B-------oT-----E---?E------B?--------------EB----------------?------M----?------
T----E-----------o--------------E-----------M--TE--------------oT---M--?----E-----T-o---------TE---------------|--o-?B-X-------B---------------------o----o--o--o-----BEM--------|-E--------?----------B
-T---B-?---MX?-T-----------BB--o|---------|B--------B----E------o-----M---E---------?--?--B------------T----B---|----T------------X-?E----o--B--TB-----?--BB---B-------------Bo---------------T---------
---B---o-----B-------|B-------o---------M--B-------T-B--E----B|----------------B-----?------?------B-E----|B-B-------?---------M------------T-----X?--T---B-|-E-----------------?--X--o-------B-------X-
--|---------?o-----------T---------------------B---B----------Eo-----------M|--X-----X---o--o-----------------X------E------------------------BM--T----X---|------------M-------------------------?-----
---|----o---E----?---oX-o------------EB---?-----T------B-----------BB---B------B---------o-B-----------------o---?E-B---------T--------B-----------B-?--T|-B-oB-----------------T-|-----Bo-------T-----v
---?-----------B-----o----|-------o---oX------B-----E------------o-----B-M--B--------M------------B-E-B----------E-------?----E--------------B----------|-B----------------M---?-------B--E----BM--B----
-------|--------?----E-------?X--o---------------o----------?---------------o-----------------?-M----------o-------B-------B--B--B---------oo-o--------------E-------T---E-o-----E-E--------E-E--Xo-----
-----|----------|------------?E-------oB---|------------M--------------B-------------------B---------B------E?E-----o---------------T-----o----B---M----------X-----oB---------o-E--E-------------------
---------------B----o|------------------o--------------------?-?--------------------E-T---------o--------?-E-M?---------T-----------------------TB--?-------------------?----B?---M----o---X------------
--------------------?--o------------------?----------E-E-----------X---X--B---T----B-B-o------B---------------?--Mo---T--o-----------------|------------E-----------o-----------o----B---------------?X-
-----o-----X---BB----E----------M---B---o------------------Mo---?-----------o-----o-----------o--X-----------B---------------------------------------E----T---?-E-----B-----?----o----------X---B--E?---
m-----T-------?----------|----B---------o-o-----------------------------B--E-----?--?E-T---E--------------B------B|-----E----------EM----?---------?------------------------|-?-?--------------TM----|X-
XXXXXXXXXXXXXXXXXXXXXXXXXXXXXXXXXXXXXXXXXXXXXXXXXXXXXXXXXXXXXXXXXXXXXXXXXXXXXXXXXXXXXXXXXXXXXXXXXXXXXXXXXXXXXXXXXXXXXXXXXXXXXXXXXXXXXXXXXXXXXXXXXXXXXXXXXXXXXXXXXXXXXXXXXXXXXXXXXXXXXXXXXXXXXXXXXXXXXXXX
