-XBB-------------------BBBM-B--------?------B--------MX------MM-B?BBM----------BBM?----o-------------------------------XB----BB?------B-X-------B-------B----MBBB--------B?B----------------------------
------------------------------------M------------------XX-------XX---M?--------------X---X---?XBB-------------------o----------X-------XXoBB-X--------------BX-----?B----------?X-----?B-------?------M-
E-o?X--------XX--------------M---------M--EBB-B-----------------------------------MBXBBBMM-------------------------B-----BB--------?-??-XX--------BMBBBMBXB-------------------------BX------------------
-B--------------------o------oo----------?X--------M-----------------------?BB----------------------X-B?----oX??BBMMBB----oX-------X?BX--------------------?-----------------BMoB-------BB--------------
-----XBX--?X?-----oX-------X-----------BX--MX------X?BoX?B?----------------?B-------------XBBB-------B------------------MXX-------EBXM------------------oX--o-------------B-------------BM-------------o
--------------XX------?------------XBBBX-BEX?----------o--BBB----X----X?---XB?B-------------------------------------------o-----------------------BM----BBBX--XB---------?XXB------------------------XB-
----------------------X---------?X----------------?M?B??B---------------------BB?-------X------------------------B------MX----------o??X---------------------------B----------MBX--------XB--XXBBBBX----
-----?XXBXB-----------XB-oB---------XB-?-X----BXB---------?X----------XXX------B----------------------------B---------------------BB-oMB--------XXBX-?----------o?-----EBBM?------------XB---M?-----BB-v
---------------BXBB-------------------------------?B----------------------B?--------------?----------------BXBX-------B------------BMMXXM----------------------oMMBBMMXB-------ooXB-?------MBX---------f
--XX---------BBB------XX------B------B-----MBB---BX-X------BB------------XBBB-------------------------?B------X?X-------B?---------X?--------M?XXX--------B--------------------------------B-----BBX---f
--B--------------?B---B---------BB-MB?-------------------X------------BB?B----??------------------XXMXBMB-------------BXX--BXX---BB------B?-M?--MBXBXBBB--------X----B---------XMXB-----XX?-Xo---------f
------------------------BB-----?X-BB-----oB----------------M?X--BM--XX--X?BB-----XBX--------------------o--------------BB-?BX------B--------------------------------BB----------BXB?--------MM---------f
-----XBB--------BBXB---------?X?-----------BM----------------------------------------------------------B--?BBXX--------B------------BX------------------------BBB-------------X?B---------------BXX----f
-------B-BBB------TB---XB--------------BB-------o------MXX-MBB------------------------------XBXX----------------?----oX----------B?B-----------B-X--E--BB?B-?XB?--BX---?XXBXBB--X?MMXBB---X-MBB--------f
mMB---B-T----------BBB----------TBB--XBBB---B?B---------?M-TX---------EX?X---------------BBBBMMBBTBB-----TB?------------------------XXXXX?--X--------------TX----TXXM--o-----T------?BB?-----XB--BXB---X
XXXXXXXX|BXXXXXX-XXB-BXXXX-BXXXX|XXX--MXXXXXXXXX-X-MXXXXXXXXXBBBBXXXXXMXXXXXXXXXXXXXX?B?XXXXXXXXX|?XBXXBXX---BXX-MXXXXX?MXX-XXXXXXXXMXXB--B?--XXXXXXXXXBBXXXXXB--?XXX-MXXXBBBBXXXXXXXX--M-BB--XXXXX-XX?X
