----X-----X--------B-----------XX-------EB--B-X--B---X-o-X-----oE--X--------B-----B---X---------X------XXo---X---------o-----X----B--oBoX-M---X---EB-o----X-o----------X----M--X-----B--B-E--BM---------
--BX----XXE--X--XX-----X------------o---X-------------X-X-X----Xo-B-M----------------------o------o--X--------X-E-------------X-X-M----?-X-X-M---o--X?--E-o--------X---X----X------X-----XX-B-----------
------X------Xo------E--o---------B-------E--X---o-------------o----?--B-E--X----o-B----?o-----------X------?----E-X---------X---?-------XB-------XM-------BM-----?B--X?-X---------B---X----------X--B--
----------X----o--------XX---------?----X--B-----B---------oo-o-X---o-------------oX-------X---X---X-------X----X-B--------------X--------X----M--X-EXX--X-o-----o-XX-----XE----?-M------o--XX-o--X-----
X-----B----XX---X-XB----o--------B?-----??-------------------M---X--X-----X--------------------------------oX-----?X--o-----BXo------E---BX------------B-----X--M--o------X---------o-M---X-B?---o------
-----X---X----XXo-XX-B--ME----X--Xo--?-----o----o----B--XX--o--B-X----o-M-------------o----X----o------B------BXX-----?oo-B----BX-X--------X--X?----------------------X--XXoXXX-------------?--XX--?-X--
----------X---ME---E---------X--X---M---o--------B-M---X---------E------E-X----X---X----------o--XX---------X-E---B--X-?--------o-M--o----E--B---XE-------oX-----?X-o--E----?----X---o--?-X------o-----o
------?EE-?XX--X?-?------X-X----o------------------------EM--X---X-----o------X-----oX---X---X-Xo------??-------X-----X--X-----o----o-X---B--X--M----o--?---X---?-E---?---M-X------o------X--X------?-ov
---XX---X-----X-------------X-o-o-------------------------B------E--------?---X------X------Xo----B-------------XX-o--X??X----?X---B----------ooB---o-------------------X---?o-X--X-----E---X-X--X----o-
-?o---B--------------X-----X--X--------B---------X-------X------X----X---------Xo---B--o------o--XXX-X-----X-E--o--------------------------B------?----B---------------M--X---XMX--X?-B----------XX--X-B
---o-E------X---X---------X-X-E-E------B-------?--o--XX----X-X----M------o-------------------oE-------o--------------o------X-X?-X--?-B--X----?-----o--------------X-------X---B?X-B-------o--?X---X----
BM-X----------X?---X-X---E---oX-Xo-X----X------BoXo-X-XB??-----X-X-X----XM----E----XX-------?-------E-o----X--------M---------o---B---MX--X---X-E--X----B--X--------?-X-X-----------o------------------X
----oX--E--X----E--X-----o-----------X--X--------MM------------------o----?B-X---Bo-XX---X---E--X---X--X--?-------XX--X-X--BX-----X-----o-X---X-E--B-------------EX---------?-------?o-?--XX-EX-X----B--
-----X------oM-E-------E------E---------X--o-----------o--------------X------B------XX-o-X-------------?------------X---B-X--------Bo----XoBX---BM---------X-------X-X---------BB---X--o--oX---------oX-
mX----|-------------E--X----------|-|B-XM-X-----X---T-----------E-M-----X---X--------------|-X-----------X--MXM--o--------X----o------?----------------?---X--------X---------X-X---X-X--o-X----B--?---X
XXXXXXXXXXXXXXXXXXXXXXXXXXXXXXXXXXXXXXXXXXXXXXXXXXXXXXXXXXXXXXXXXXXXXXXXXXXXXXXXXXXXXXXXXXXXXXXXXXXXXXXXXXXXXXXXXXXXXXXXXXXXXXXXXXXXXXXXXXXXXXXXXXXXXXXXXXXXXXXXXXXXXXXXXXXXXXXXXXXXXXXXXXXXXXXXXXXXXXXX
