-oo----o-o-XX----------------?X-------------X-----Bo--M---X-B-----o--X-X---?-oX---B------X--o---oX------------------B--XXo--X-----?B----M----------------------B-EX--------M----------X-------Xo--------
---B-XT--B---X-------X--o-------------X----oX---X----X-XXX-----XXo---?-X-o---o----BB|-X-----B---X------X---X----X------------------B----oM--E-----MM--------XX---X----X-?-X---o--EX--X----E-oE----X--X--
---o--|X--------o-------B------|--XX--X-X--?X----XX--M|--------------|---o--X----o-X----E------?---X--------X---B---o------------------XX-o----E-X------------------B-?X------B------------o----B-X-----
------|-X-M-------------|E--------X---XE-B-o---?---XoX--o------?X---|-X----B-X-----E------------------X-?-o-?-----EEB----X--o----X-E--X---X-|---oX-------o---X--o------X--X----X---Xo--------------o-X--
------|----oB---oX---------B------XoB--X---E---X--?-BEX-------?X------X------------E---X---XX-------------B-----E--X---E-XX-------------------B-?--------X-?--oX---------X--X-X-------B-o?---X---X------
---X--|M----?---|--B----B--X-o---------o-B-------X--BE-----XX-X---X-ooE-XM---?---X-B--X-|---B----B----?------B-----X--X-BX-XX---?---o-EB---E--o--B-X-X---X---X--?---------------------B---X-----X---BX|-
------|----ooE--X----------------XX---?X--X--------B--o----oB---B-------------------------------X------E---------o----------X---X-XX-o--Xo---X-E--X---Xo------X-----o-oX-------------------B------------
----XM|X--|--B---Xo--?---X--X---------X----------B-------X-|--E--o----M--------XB--B-------E-------X----X--EB-E-E---X----Mo--------o--X---o----B-X-------------X---MoX-M--------o-B-----o-X----X-X-----v
------|----------------|-X-----o---E?-X----B-----X----?BXX-----X-B-B-----BB--X--?X---E-------?-----M-B--------o--------B-B-E--X--B-----E-XX---|-B--|--X----B----o--E----B--X---X-----------E-X---X---X--
-X----|--X---BX---o------X------o-----X--E---E---X--X-------BE--B----X---------------------X---------X---oX--X----X-----o---o-------B--?-oEX-----B-X---?E-X-E-X---X----Eo---Bo----------M--X|--X--oo----
-----B||--BX-----o------X|----?--X-------------X--------?--------X-----X------?---?X---B--o--------------E-------X----o-X----X-----?-E-------X---------E--------------o---X|------------E------X--------
-M----|------X----X--?----X-----o-M---M-------X--------|-------o--o---BX--X--------E---?-o-X-----B---X-------------------X----XXE-------?--?-B--Xo---X-|o---|-------B------B--X--o-----B-----X--o-X--X-B
-X----|B-------XX--X------E---o--E-B-X-X----?-----X-EX-X-o-E----?--B----M----E------X---X-------------M--B--------X--B---B--X--------|X---X----X-o-X--o---X-----X----XB-----oE--|----X-B-----------BB---
o-M-X-|X---XMM---M-X-XX-E-----X---|---X-oX|--------B-E------o------o---XM----o-----X---X------X-?X---o---MX-----X-----Xo-----X-X-X-XXo----XX--X---B-E--------------------?XX------E-|---X--------B-E--B-
m---?-|o-XX--?-----XXXXB-------XX-----XX-B-----E----E--o---o-B----B-----X-X---X---oX-XE--X-?----B--------X--------------X-Xo----M---X--|-?--o-----?--E--------X---X-B---X-----?-----B--------o-----BX--|
XXXXXXXXXXXXXXXXXXXXXXXXXXXXXXXXXXXXXXXXXXXXXXXXXXXXXXXXXXXXXXXXXXXXXXXXXXXXXXXXXXXXXXXXXXXXXXXXXXXXXXXXXXXXXXXXXXXXXXXXXXXXXXXXXXXXXXXXXXXXXXXXXXXXXXXXXXXXXXXXXXXXXXXXXXXXXXXXXXXXXXXXXXXXXXXXXXXXXXXX
