--o-----B------?-----------o-----o--|-oE--M-------M----------------|---B------------B-o--------E--------E----o?----------o----E--------------B------------------?--B-------B-T--Eo-----B--------?------M
-----------o-?----T?T--?--B|--------------M----o---|-----o----------B--EB|---------------o-B------M----o----------TooM---------B----------X-o--o--o--o--o-----T--MT-----------------o-----------------?-
--------?-B-----o------B----o-Bo--E--o---B-|--o---E-o-E----T-----M?------------o---------E--------?------------|-----------------E-B-B----------o---------ME----------------|-?--?--o-B----E------------
-M--------?-------------E?E----E--o------------B---o----B------------------------M-------------------o|X----------?--------X-------E--?----------T---oo----?----M---E--------E--|-E--------------------o
------o----B-------EBE--X----o----T-----o-----------o-E------E--------------?----------Eo--?-----|--------X------EM----------?--------------o-B------------------------M?------oB------BX---E-----------
------------------E------------|-------?------------E---------------o--TX----X----MX----|-B---T-----|--|---M------T-----------------B------oB-o-o--------Bo---------E------------------?-------T-?------
----o-----------?---B--?----------------------B-E|-------oX-------o------o--X--o-X----------o------------------------------------------------------B--E---------------T-----------E------Eo-------------
----Bo---------B----------------------o-----B---?-E----B----B--------------------------T-----------------o?-B-?-----E-XB-------------------|------E--------o---------------------------M------------T|-v
----------E----B------------------------B----------oE|---M--------E-----------o--------|?----E---B---------o------------------o-T--o-------------------T---------E-M-oo-------B----------M----B----E----
-------------|T---X-Bo?--------------B-------B--E------------B------E---o-X--o---B--E--------?E?-----E------------|--|-----E----o------------------------------B-?-o------?---|--B-E-|-----B-----E----o-
-B---?--E-B-T-------o----------------------B----B?-----o-----E-----oE---B---E-E--?----------E-------o---X---E-----------BME--------------o----------?B-B-----------------|-----------o----B-?-----------
-----------B--------------B---o----B-----B------B----M---?---------------B----E---------------B--X----------B-----------------?BX-----------?-------B---------?---------E--E-E--------------|-----------
-|---o------E--------o---B------------B--------X----------X--B-----------------------|-E------M------E------------ME------------------M------------------?-o---o-------------oB---------------------|M--
E-o-------?----B---------E-BE------------------------------?----X------------oo-------------------?--------o--?X---M-E---------B----------------------M---------------?--o---------B---------B---E-----o
m-----?----?--X-o---oX-M--------BE--------|--?-----E---------T-----M--------------?---E-------o-------o-M------E-|B-E-?-----------------------E--------o-B-----B--o-T----B--------M-o-----T--o--E-----B-
----------|---------BT-----M-----------?----------------o----M--?-|E--B----------------------------B----------B------T---|-E-------o-------T-----B--T---BX--------------------------------BB------------
