-----oX-X--Xo---E-B-o---B------oo-X-----M-X-------XX--XX----------EEEB-X----X--X--B---B---------?--------------??---BX---?----------o-----XX--X-XX-XX-------o--XXX-----M--X-------B-X-X-X-B-XX---------o
XX-E--------------o-o-B------X-E---B---X--------Bo----?----XX-------X--B---XXE--------X----E--------------X------------X--X---Xo-----M-----------------X-----X--X-X---XX---?oX----------X-X-X-X--B-----M
----o------------B---o-X--BX-----------?------?X------?---o------E--X--o--o----oB-----------X-------??-BX-----X?--X---------XX----B----X-----------X---X-X-------X---X-----o--X-----X------?-E-X?-Eo----
M---E--?-o----------X-X-----X--------B?E-----M--------------------------X--B-------?----------------?----------------X-Bo----X-X-----X---XoX---B-----?--B-------------E-B-B----E----?----X--------Xo----
-B-B-E--o------Bo--X-----X-BX-E--B-X--o-o--X-Xo--------BX------E-Xo-------BX---o-------E-E---X--oX--X---X--M-?-B----------?---X-----------X------E-?-o-X--M------B---------B-X----B-B---M-E--X--XX-?----
---XBo--X---X-?X-o-----X--------Mo-X-M---EX-E-----?---X----X-XX---------XX---X--------B--------X--------B--------B----------X-----------X----Xo-E---B----X-X---o-------X------BXXX---X?E-----M------X---
EX--B-oX----------E-X----------XX----------o---o-----B-----E-X----X---X---------X---BE-B-o-?----X------------XX---E--------MX--------o---------------B-----o-------------------X---M------------------B-
-X------------------E-X---XoX--------X------B-o---------?-----BX--------Xo---B--?--B-----------E-Xo--o-X---B-X----?---------X-B--XX---------E-X------------o----------M--------E--B-----M-----XX-X-----v
-E--X-o-----------?-X----X----X---------------X-----X-------?----------X---XBo-B---------B?-------M---B---------M--?---o---X---------?B-o----E-?----X-------E-MBX--B----------Bo-----------o---B----X---
---X-E---X---X-E-------B----X---------X-X--X---o?--X-X------------o------B------o-X---------------------XBX---X------X----XX---X----------?X---X-X----------oX-o----oE---------X-----E-----?--------oE--
-E---o------------------X---------MX--?o-E-?---X-X----B--o-o----------oXX--oo-----X------B---EX----?X---o--BBB-B----X------EX--o---X--M------------M-o---B----X---X------X----X---------------E--XXX-oX-
---o-M--E--o------------M-B----------EXX--X---o----B---X---BXo-------E-?--?---o-E-X----?------------oo------?----XB-XX---B----X---X--o--------X---o----------X-X-oX?-------?--E-X---X-X--o--X--------X--
--X---XX-ooX--X---B-----X------o-------X-------------------?-E----------------B---B----B-----Xo-------oo-------------EB-X-o----o-X-Eo----XX-M---------?-----------X-X---------o--E-X-?o----B----X--E--o-
---X------Mo-------------EX------X-X-----E----BX-----------------X------X----X--X?-------XX-B---o-----oB--------o----Xo--oMX-?-------E---------------------X------?---X-----X-B-X--?---E-----?---X--XX-B
m-E---T-----X-------------o-----?-------X--E---------X-?--X-?----B-----XoX-o----X---------?---|--B--|B-X--XX--X-----E-----BB-?X-X---X---------X---o--------E---o---X----B-B----X---o?-?-M---T--X-X---X--
XXXXXXXXXXXXXXXXXXXXXXXXXXXXXXXXXXXXXXXXXXXXXXXXXXXXXXXXXXXXXXXXXXXXXXXXXXXXXXXXXXXXXXXXXXXXXXXXXXXXXXXXXXXXXXXXXXXXXXXXXXXXXXXXXXXXXXXXXXXXXXXXXXXXXXXXXXXXXXXXXXXXXXXXXXXXXXXXXXXXXXXXXXXXXXXXXXXXXXXX
