---------------T-M-?M--M----------------B---------EB-----------o---B------------|T--------M--X?------o--------------M---------E--T-------B----------?---------B------------B-T-------------E-----M-o----
-----oX---?----------E--E------B-------------------------?--------|---B------------o-X-o---B-M-X------MT---------E-oE---o-?---o------o---------------?-M-----B---------o-----B---?-----M-o-------?------
---?------------------------------E--------E----E--o-------E-o-----------o--------B-B-------T----------B---o---------E---------E-M--Mo----------B-----------B---E------------BB-------B--BX-E---|---?---
---------------------------------------------------------E--|----------------------E----------------B--------T------T----?B?-------B--?-----?X--B-?|--T--------E---B-------?o-------B----B------o?BB---E
--------E-T------E-----------------X----o---------M----------|-B----?-----B--o-B--------B-----------o-M------?----?---E----------BMoo-B?-------M-T---oo-----------------E---o--------B|----------o------
-?---EB--------------?--B----o----E------B--------|---o-----EE----M-o---------o----o--o-------o-----E-o----o-X---------B--------------------------B---------?-----?----------o--|----------T-?-B--------
---oX--------------T-------E---------------M--E------------B---------E---?---------o-----o?----?--------------M-M-B--------o-o---oE---?---------------?----------EB---B----B-------------E-------------?
-----------o----------------E-X-----M--|----|B---B----------B--------|----o--B---E------------|----E-----X---M---------E------E----B---?-B-|-----E--o-----o----T----o--B?------M--?--------B-----------v
----------------?--X-----------------------------?----B-----------------o--?-------o--o----B----------------o------E-------?---T---------E-----B--E---T---------------E-E-X--?--------------M-|---------
------?-----?---o----------B---------?----E--M-------T----B--M-o--------o------M--?------?-B--------------E--|---|-----------M-------------E--B----Mo------o---B-E---o-----M--------------------?------o
-----B-?o------------B-----o------|---B-------?--------------E----------oX------------------T---M------B--B--o-----Eo?-----------?-?-o-----------?------o--?----------------|---------------oM-----E----
--|------X-o-------------B--------o---------o------------B----B---M-------o------------------------------M--|--------B?o------------o-----------------------------B------BB---??-----T--------M--B-|--T-
----------------?---XoB---|---------------E--------o---------B-------B---X-?----------------X--------------o--------------------o--?--------M------------o-------------------?--o-M-?-B---o----E--------
--------------?-Mo-B-?E-----M------o--B-------?---E-----------E---oo-B----XoX?-----B-----?o------M---------o----M-B--------------------o--------------------E------E--o-E----------------B--------------
m-o-----B-----B----o---B-------------------T--oo--------o-BE-------------------------?-----------|T------|----?------B---B-----------E------T-----------------?-------B----M-----T-----B-o------?-B-----
XXXXXXXXXXXXXXXXXXXXXXXXXXXXXXXXXXXXXXXXXXXXXXXXXXXXXXXXXXXXXXXXXXXXXXXXXXXXXXXXXXXXXXXXXXXXXXXXXXXXXXXXXXXXXXXXXXXXXXXXXXXXXXXXXXXXXXXXXXXXXXXXXXXXXXXXXXXXXXXXXXXXXXXXXXXXXXXXXXXXXXXXXXXXXXXXXXXXXXXX
