-----BBX----oB?---X---------BX--BXMXB-X-----B------XB---B----MX?-----------B-M?B---------------------BBXXBM--?X??-------------M---------XB------M--XMBXB----------------XBBB----------------------oB---E
---------------BX------BB---oMBBB----XX---EB?-M----?------------------------BXB--MXM------?B-------BXM----------------------------------B?BBXBBX------XXX--------BBBB-------oXX?-----MMXX??B-X----------
--o?---BB--------------------MXBM-------X-----------BXBX--?BX-BBBB----------oX-------oBB?B----------BoXMX--------------BBB----BB?--X------------------B--------------?XXX?------X-oX--------------------
-----------------B------MBB--?BX---??-------------------------------------------XB-----------XXB--X-----------BBBBBBB--------------MBB---------------MB-------------------XBM?-----------M--------------
XM---B?------------XXXB---o?----BXXXBBBXBX---------EB-------------MXB-------------------------?B-------------B-------------XX----------------M-M-------------BB----?M--------BX-----------B-------------
------------------oBBB------------------------M?--------oBB-----X------?B---------X---------BBB-------XB----------------XBBXXXM------------XB----XB------------------o??B------------X--?XM-X-B------?B-
--------X-X-----------------------BoBXBB?----o-----------?BB-M?XM-BBM?BX-----B--XBM-----------------BBB--XXBM--------------o?X----------BB-oM------B-------oBBBX-BX?-----B?---------------?-oBM---------
---------B-----------XMM?---BBB??-----X-------BB--------BBBBXXM----------------------M---MoBB-----MBM----------------------------BBBX----X------------------------BX---------B----------------oX----BBXv
BXM-------------------------------------oXXXX---?M-XBX???-BMB---oBX------------X?---------------E?---------B-------------------------------?MBB-----------------------------XXX?--------------X?X------f
E---------XM--------B--------------------------XXBB----------------BXB-----------------------------Xo----------BX--E?-BXBBBX----------XBBBB----------------------?B-----------------E?BX----?BoXX-----?f
-----------oX--XX-----------BM----BB-BB-------MX-------------------------oB-------oX---------------------------------------X?--oB-------------------XXX------BX-XBX-----------X?MX---o??-----BMBMXMBX-Bf
--------M--BBXMo--B?XXX--------------B--XBMM-----------------?B-----XBBB--------------oX?XXB?------XX?---B-B----X---------?-----------oBBB?--------------------o-XX-----MXX------B?-----------BB---BB--f
--------------?-------XB--------XBXB---?--B--BBB-----B?------------------BBB--o?X-----X-----------------XXXBXB---X?XX---------BM---BBB-----------------XB-MBBXBXB------------?B------------MBB---------f
-------------------------------XX?-----------------------X----oB----XBBB----------------------------------------------B----------------------------XXBX-------------------M-------------?--------------f
m------?BBBoM--------------------XXX----------------------BXB------T--XB?MB---------TB--M-E--XM-M-------------oB-----X?MBo-T?BXB--BMB------TX------o---X--------------------MXXXXX-----BX-------------EX
--------BB----MM?oX--------oX-BMM--??XB----------------------------BB--------------BBB---BB?X-------------X----------BX?---------MBX--------M?B----------BXX---------------X-----B-----X-B-------------X
-X-X-X|--XXX--XX-XX-X-X-XXX|XXXXXXX|XX-XX--X|XXXXXX|XXXXX-X-X-XXX-|XX||XXXXXXXXXX-XXX-XXXXXXXXXXXXXXXX-XXXXXX-XXXXXXXXX-XXX-XXX-X-XXXXXXXX-XXX-XXXXX-XXXX-XXXXXX-XXXXXXX--X-X||XX-XXXXXXXX-XX--XX--XXXX-
