-----------??---------o--------?-EB-----X-X----o-------o------B----B----o-----Xo--X-o--B--E--------o-----------XE---E----X--B--E----oo----X-----X--X-X---B-X----X--o--o---?------B-M-B-XB---------------
-o---MT---------E---E------------------o--oX-----o----------X---------X--oX---X-X-o-----X-X--X-------E------------XE---MX?-o------X----X-------X--X-------XB--o--o--E--?-----?---o----M--EB-oM------o---
-----B|-o--------XX----XX-------o-X--o-----EX-------X-----B----X-----B-------o-B--X----------M---------------o-X-X-------B--------M-----o-o-----------------------X----XB-----------X--X-----B-----o---X
--X---|---------EX-----XX----------o---??o--XE-X-o------?--oX----BX------X--X-------o--M--------X---------?X----B----X----o---o-oX------------X-----oX-----B?-X--X-----o-------oX-------X---X-XM--XoB-Mo
------|-E--B----B----------B-----X--?---?------------E-BBBXE--------B--------Xo-?-----X--X?------E----M--X?o-X--o-?-----M?----o--X---B----X------?--o----E-E--B----B-------?-----------------E-o-M--XM--
-X----|B--X--X--X---X-X-M---M---oX----------X-X-X--------o-X------------o-X-X-----X---X-------X-------Xo-o--o--o--------o--B-BX------o-o?-----X-----------X-o-------o-?-B--?--X-----X-X-E----X----------
o----X|---o---B------E------X--MX-B--------XX-------XB-----?B-------M---EX--X--X---------B---E-X--------------EB---X------X--o--------------o------X--oX------------X-o--XXX--X-----X---o-X?-------E-?-E
XM----|-B---------------o-X---X--MXX--------B--------------------------o---------------E--------o-----o--X---X--E--?----?--X--------?Xo-Xo-X--------X---o-?------o----------E-o-X------E-X---BX---EX---v
-B---o|--X---X--?-X-M-?X---------------oE-o-----------X--X-X-E-MX------?---------E---------EE------X---------XE-o-X--XX?---X-o--?-----o-X---X?------XE----oX--o-------Xo----o---X---o-----------B----B--
X----X|--XX-X----E-------X--X---B-XXX-X---------B----------E-E--------X---B----------XX--o-E--?-X---o---X--o-?--------X--Xo------X-----?--B-X-X--------------B--------------?------Xo-XX-----E--------X-
----o-|-B--X---X-o-Xo-o-E-?-------?--o-X---B-Xo---X---o----B--M-----?X----XB---X-o----B-----o-o------X-----X-------?--X-?-X------------M--------X-------M-------o----B-----B-X-X-----------X-B--X---?---
----X-|-----?-------?-o?--------X---o-B--B-XXX----X------ME----E-------------X?-----?X-X--M---o----B----------X-XX-XXX---BE-o------B-----X------B---M-----X-----X-X----------------X?X-B-B------X-------
----X-|-XT---o----------------X-X---------X---o-?---------o-X-X-X--XB------o----o?--------E----E-B----o-------------------?E-Xo----X--------X----BE-Xo-----XBo-----X---?-------XX--------o---E-----E---X
--X---|XX|--?------EX-oXX--------------X-----X-X-------EX-EB-X---------o---Xo----o----?X----XX-X-X---------X---X------B--B-------E--X----o----X----X-XE---------?-oE---------------XX-X--BX-----X---B---
mM----|--|--------X--X--X----X-o-?-X---X?-X-o---B---o--E----E----E?---------X---oo--B-----------------X---?o----X----o------X?-X----X-----X-B-BB-?-------X-o-E---BX---X-B---------X---X-------o--o---Bo-
XXXXXXXXXXXXXXXXXXXXXXXXXXXXXXXXXXXXXXXXXXXXXXXXXXXXXXXXXXXXXXXXXXXXXXXXXXXXXXXXXXXXXXXXXXXXXXXXXXXXXXXXXXXXXXXXXXXXXXXXXXXXXXXXXXXXXXXXXXXXXXXXXXXXXXXXXXXXXXXXXXXXXXXXXXXXXXXXXXXXXXXXXXXXXXXXXXXXXXXX
