----------B-----?--o-oT------o-B------------------------|-Mo---------M-----E-----E---o-------------B--o--o-oB---o---o----X---?-------------------?-----T-----------------M--T|---o----------------------
---?------------o----------------------------------------?-B-E------------------------M-----o-------X----M-------o-------------------o-------X---o-----?---B---E---o-----?-MT----------------BB-----B---
---?-----?-----??---oB------?|------------------B---o-----------?---X--?----------X---------------?-------E----------?--------------X---------------E------------------|--o---|-----------X--B-?------B-
B------------------B--------------------X---o-----?-T-B|--------o?-------B------------T----T-o--B----E--------B--MT--------o-B-----------------X--?-o-------------MEE-------o---------------------------
-------|--?---M--B-------o--------BX---T--?--ET?-------B-----B-E-----o-------T---------------o--------------------------------------E---T-------M-----------o-B------o---------------o-o----------------
---?-B---?o---M-----X------B------------------------------------?----------------T-----T---------------------------------M--o---?-------B----o--------------------M-?-?----?-o---o----o-----------------
-----o--------EM-----------MoM--M------------------E-------------------o-----------------------o-----------B------------------B-----------o--------------o----B--o-----To-M---------X-------B-----------
-----o-------B-----o-X|----------------o-----B-------M------?------------------------------------o----Bo-??--------B---B-B---------------o------------B----------BT?----------------?-----o-------X--X-v
----------?---B---M--------o---------------|---------------------------X-----------M--------EX-----?-T-------------------------------E----E--T----?--------------------------E-------------E-X---E------
---------M--------M--BX-------B-B--------o----BM-----o------------o----------------------?-|---------oBo-------|-----------E-Xo-----M--|-?-------------M-----B---------T------B-------------o-M---E-----
-----M-T--?--M------M---o---|-------o-----------------B-?E-----------E----o-------------E----------?X----B--B---o--B----------------------o---------------------------B----?-o--?-----B-?--o-?----------
--EoBB-------EB------?---X---------o-----B--E---E-B-o|-------E-T-M-o---------|---E----------E-------------BT----B---M-----------------B--M---o----------B-------------|---------------X--------o-----T--
-----T------------------ME--?---------o------------o-----oo-------o---T------o--?o-E----?---M-------E---------|-----To-----o-------------------------B--E-T----------------B?|-----o--------B----------?
?----|------B----B-------o-X------?----T------o---------------E--Eo-------B------------oX--?o--M----o------------M----------M-E-----o---------T-------E-B----------?----B-B-X--------------o---------?BB
m---------?-T-?-----E--M---X-------E----------------X---?--o-oE--------------------------B-----------X-------------B----E---E----B?-------------B------------X--o-----------B----------o----------------
Eo-|ooo-o--|---------Eo------M---------M--o--o--E-?---o---------M--|------?--------------------B-------------------------------------------------o----o?------T---------o-----------|---------B--|o-----
