-o-------?--------X---M--o-?----EB------?BB-o----------------?-X-----o------T-----------oT---B---------------o------M---|o-?--|----E----------------B---------Bo-o----E-?--------------B---------?-E----
--------M---?----E-------|--T-------------X?-Bo----MT--------o---?------|---------------------B------------------E------------------|------o-------M----E--?----o---o------E--------------o------B------
--------o-----------oEE------B-E-------------X---?---------o---M--------------------------X-------X---------B-----------------------------M----XB-B-----------------X---o------T-------E----------------
--T--T------------------o-----------o-----X------------------T-o----------o-|-----X---------MT-------E-------------------?------o--------?-------------------X---------o---------o------------B-o-------
-------B---o--T?--?---XBo--------BX-M---------------Too-------------------|-----|----Xo------------?--?----T-----B---------M------|----?---------oo-------------------------X?---T----o-|---------|----X
----|---|-B---X-----E-----B----o----------oE-oE---------X-T--E-------------X-------o---------o----o----EE-----B-----------------------o---Eo--|-E-X--------------BE-----B-------B---------B----|--------
|-Xo------o-----------o-X----?-To--M-E--B---o------B----?o-B------X--B-------B----T---T--?----------------o-----------?---o-----B-------oE?-o-----E|-------E---?----o--B------E---------T-------B-------
-------------o------B---o-------o-----X-------------------------T-o?-----------Mo-E?---------------B----M---B-------E----------T--------BB--o-o?---------X---ME--?-----oX----------T-----E----------E--v
-T---?-?-------------M-B-------------------E---------------E---|?---------------E--------B--------|-------EE-|---|---------------------B---------|-----?---B-o-B--B----------------T----------?--o---E-B
----------B---B-?-o----E-----?-------------|-o--E-----------------------|B-----Eo----B-----B---------E--------?-------?o----------------------------------M---------E---o----------------------------B|-
|---o---M----------------E----T-T------------o--B-----------------------E-------o------?------E-----------------------------------------T---B-------M----------o----B-----B---------------X-----------|-
B|----------------------M-X--B-------o----M--?-------------------------------E--M----------B-----------o------|----E---------B------B---------?-B---o----|-??-------o-----------|---T-------------T--T--
----------M------o--|?-----MB----------------?----o-------------oB-?-E---E--------------------E-------X---o--------------o--X-X-?---B--T-----------o-------X---?Eo|----E-EM--------------Bo--B----------
--------B-----o----------B---------------o-E-----------o----------T--------------------------------o-------?--?----------------B-B---------o------M--------|---?----o-o-M--o--------------------------?-
m----E--|--------o----o--------------------E-------------------|-o---------------------o-----?-------?----B--E-----?-B-----B?------T--------o------B-------------------------B----Bo--B---M--B-o------M-
-----?---------o----B-----------------?----??--------BX------------------?----|--?---M----|-oE----------------M----E?---------Mo------B------o-----------------|------------B---------X-----------------
