-----T-----o--o------o-------------M-----------B------o-----------B-?----Bo-X----o---------T------T---------X---B--?-------E-----X--?-X--M---X-?-B---E--------------------------X--|------M----B-----o--
------------M---oT-----T--E-M-------E----------------M-----------------?------B-----------------X-------o----B---o--?-----o-------------E-B------M-------------------?----------?--Bo---------?--------E
----o------M-------?-Xo---|-X---E-B------X-----o-----o----o-----------|E-EoT------o---------X--------E-o-B------o-----|---------------------o------o--o--|----E--o-?------o----T------B-?---------------
------B----o------E-------oB?-----Xo-|--------TT--------------------o-----X--------B--------|?----------?E----?--------B--------?--B-M-----o---B---------E-EE---E------o-------------------M--o-?o---?--
EB-----o--?-------------T?------T--------------B-------MBo-------EB----?--o-------o-----B-----|-----M------------------------o--B-o-------o-------------?-?---XMB-----B----X----B----E---E------------M-
---X?-----------------------------oBX----E-------------|---?-----------------------X----E--------------E?----------M-----?-------?----Bo------------------E---?-------E----?-----?-----------o-?--------
-----------o-------MT---ooX---------|----------B?--|---------E?------|---X--o------?-|----------------X-----|X-M-----B---o--oo-o-----o------B----oM--o---------E------o-o-------------------------?-B---
--o-M-----------o----o---o?---------E-----------------------?B-----|-------o---------------E?----------M-------o----E----o--T----------------o-----------------------------|--E-----E--B----------B----v
E---o-----E-----M-M--M---------------B----E---B--------E---B--B-----T----------------------o--------B--B-------------?--------o---o-----B----??|--------------------------B----M----B-o?o---E-EX-T---oo-
----o----|-------o-------|---?--------X-----|o-------------o---------o----E--X--MM-----o----------E---ooE----------------?-?-----B-----------------------o--------B------EX-?---------------------M-?-o-
----B------M---|----------------o-----|-------o---------T-----BB-----------------------B----o---------E?------------B----T---X-XB-----B------------E-----o------E------------o-o--E-B---------------B-B-
----T---------|--EXo---------?----------------B---------E-?--B--------o-X--------T---------?----??---E----o|-E-E-o---------X-----------B-------E--X----------E-------?--??---o-----B----TB--------------
--------o-----?---------------------M-B?----M-------?------------------------?--?-------------X-----B---B------------X--o--------B----B----Bo-------M--------------------o--B---------------|-------o---
B---------B-E-----------------------BB-----------?--|----?--oM----X--------M-T---?B-----o---??B-T--------------oM------------------T----------------M----M---|-M------T-----M-?E-|-?B---------oo--------
m--------o---E-------T---X--|-----------------B-----B-------------B-------------------X--E--------B--------------M---T-E-----------E-----M-B--o-o-?------------------o-----------oB---------------------
-B-------B--?-E----E-E-----B------B------------------------X-----B-o----?--o-Mo-----------------EB-------o------T-----E----------------------E-------B-----EE--------E---------B---------o---M-oT-------
