----B---------E-o-----E-----?---------X------------o---------------------ooB----------B---BM--X---|---------BXX-----XX-X-oo---------X-X-----X--X-M-X----oB------T?-----o-----X-T-------------X----X-T---
---E--T-----B-X--X--------X------B-------X-EX-----BBo-E-o-X-----|-X--?----X--B--X---o---------X---B-o--X-o-B-E---?--T--------E------------------X-M-B-----E----------o-------X----B-----o--------|-B--X-
------|?--T-----o--M-o------X----X--X---?-X----?----B-----BE------------o--X-|-X-----??--EB--X--X-----X-----?---X---X-------E---XX-XX--B---?--?-X-----X----?------XX----M--B--?--B-EB?-----oM--TX----oB-
-B--oX|---X--------------X--o---------o--E?--?B---X-------X---M-----X---XXT-o-X---X-------X-X---o--EE------B---Xo----T-X---o----o--E------------------------X-------------X----T-----EE-----------X-----
---|--|---oX------X-o--------?-X-----------B-------Xo--XX----X------------E--XXX-X-----oE---|-X----?--------------------------XXo----------o--X---X---------------o----o-------M----M---BXX---oE--B-----
T-X--o|---BE---?-|---B---X------B----X---B---------X----X--XB--X---o---------XT-BXX-o----X-----?------o-?----?---X--X-X--o----X-----?---X-M---T----------------------XB--X--X----------B-XBX-E---o------
X-----|---X----B---|-------XXEBX---oMXX-B-B--o--M----X--M--T--E-----------T-E--o-------B---o-------Xo--o-----o-EE--B-----o----|X-------?E--o--X----X------|---X-?--------------X-o??B-----|-X---X----XXo
X--X-||--------X-----------?--X--X----------X-----o---T--|---TX--B--X-o----------X-------XBo--------?X-------B-o-o----------o-|X--------X-------------------B------o---o-X--B---M-o-X---o----M-----X---v
------|----X-B-X---B---TB-X-------oX----o--E-?----------X---B-----X-XX--XXX----X-X-B-----------------E---T-?-?X-----E-----------X--------X|o-----X-X-----X--B----?X-----o--B--X--o--X--XX-X----B--E-E---
------|--o----?-o-TX--X-B------XX------E-------X---o-M---B---X-?---------B---B-------B---M-------X--BX-X-?------TXXX--ooX---X-o------TX---X-T-----o-||---X-o-X----?--|----------M-X-E--|-o--X---X?--X---
X-----|-----X-----X-------------oX--XB----X-------X----Eo--------B-X-----X-B-----X-EX----|---B--E--o-o----X---XT--------T-----B-----E--------X---X-------X-TX--MX--TB--------EX----X---X---E-----X-B----
o--o--|-X---X-?------|-X-TX---Xo--X-|-X--o-E------|----MBo--EX?--?--M---------------o--X-T-----XEX-X--X--X--------X---o------o---T--o------------X--X-----oX------EB-------B--X--X---X---o---X--XXX-----
X-----|-T----X----------X-B----B-MB--------X--B|o--------E----X|------o----------------B-o-----X--------o--------B-T-------o-------X--X-XoX----------X-T----------oX---X-X--B-----T----?--------E--E---X
---X--|---o-B------X-------o-oE----X?--o-X--X---|---o--XE--------------MX-------------B-o---------X----E-?---E----X------------X----E---------------BX-oX|--------M----X----Xo---B-----EX----?Bo-X--?XoX
m-X|--|-----o----o---o---------|--EX---M---------?--X----------o--E----MM-------------------XE------X--o---------E--B---X-X-XE-------------ET---o--o--B-----------B-T---------B-------------M--------X--
X-----XXo------?B-|-X--X---?TX---E--X--B----X-XM------B----X---------?---X------B------?B------X|--------X--X-----X----B-------------M---B---------------E----?-X?-E---B---EB--?----o-o-------E--o------
