----------MBB??B----------X------------------?oX?XM------------------XX------?B-BXBBXX-----------XBB-------?BB?---------------------?---MB-----B-------------------------------------ooo-BB-oBBB----XB--
-ooB?BB-------------------------------XX?BB?BBXM-------------------------------oBXX----XXM-----XXB---XX---XXBBBX------?B--------?B--------------------------------X??X----------BXBBXM-----------oX-----
oX----------?BX--------------EM--------XB-BB--E-----------------------------------BBX-BBX-----------?B?XoBXX--------BBo?X-??XX---oB---------------------X--------------------------------------XXB------
-------XBBB----B----------X------------------------X------------------BM?XXM?------------?-------------E-------o----?MMB-----------?BB---------------------B----------X?XBB----------------BB??B?BB-----
------------B----------B------BB------------X-----------MBMB?--------------------------X----------?--E?---o-----M-------------XB--X?--------------BB-----------------------------------------oX---------
-----------?X---XXX--------B----------BB-----------BM----------------------------------------BB--------XM--B--------------------EMB-?BB----?B----------BB?-------BB--BX--------EXB---------X-----------o
-----?M--------------------------------------XX---B-MXoBB--?X-----------MXB-----------------------------------------X---oX----------------MX--BBBX-----?BB----------------------------------------?XBB--
-----------------MBB---XXB-----------------------------X?--------------BM-------------B---------------------?X?o----------------------------B??----------X------oX-----MB-BXX-----------X---BBB--------v
-------------------------------BB?M---------------------o-------BX---------------?BX---BB?----------X--------BM-----------XM-----X-----------X?B-X------------XXXX---XXB---BB--M-M------o---------X-M--f
-----M--BX----BB-------------BXB------o?---------------E----?-o------?BB---M------XXX----------oXMM-----------BM--------XBXX-------BXB?---BB?BB?BBB-----oBX--B?BBB----E-B?o---?XX-------------B--XBXB--f
-------------XBB?B----B------------------X-------BB-------M----MX---------X-----------------Xo?-------------------MBB-B?B----BX--E-------o?X?----------MB------?-o------B---BBXB------------BBB--------f
---------------XoM-M-XM---------------BBBX------------------B------BBMBB-----------------?M---------------------------------------------------------------------BB---------B---------------------------f
------BX------------------------------------------------BB----MB------MBB------X?B--------------------------MBBX------------XX--------X-----------------------BBXX------------BB------------------M----f
---------------XXB-----------------XB------X-----------?M----BX------BBX-----------BB------oX-------MBMB-----BBB----------------------------------XBoB----------------------------o?XX-----------------f
m-TX----------??TB-o------------MXBBBB--------X--BB-------T---------------------------------XBB------T-----B--oB--------------------XXBBX---TBM-------B?B--TB----------------------BM-T--------T-------X
X-|BXBBXXXXBX??X|XXXXXXXXXXXXXXXXXXXBX-B?-XXXXXXXBXXXXXXXXXXXMBXXXXXX?XXXXB-----XXX--XXBBXXX?BBXXXXXXBXXXB??XXXXXXXXXBBBBXX-BMXXXXXX-?XXXXXXXXXXXXBXXXXXXXXM?XXM?BBBXXXBM--BXXXXXXXXXXXBXX-BBBXXXXX-BXBX
