-X?--------------------------------BX-------------o----E-----------?--XX--oB-Mo---o-?----?BB---------------B--------??--------------oo-E--------------------B--E-----X-----------M--o-MB-----------o----
---------------------------M---------XMB----------o-----------------------MB-----B---X--------------------X----------?--------------------MX--BBB----BEX------BB--------------------BM---BBB-----X------
-o-----------------B-X--------o--------------XX-XM---------------XB------XB-----B?-----B---------o----------o------------------B--X----------------BB---B--------Mo--??E-------BB-------B-----o---------
-------------X--B------E?-B--B-----M----??B--M---?-----------X-BX-----------------?B-MB------M-----------X-------------o----------E-----oB?B----E-----oX-----------?---BX-o--------------XX?------------
-------------------MBoX---------------??----------X--?--------------------------?XB?---o---------------------M-XX----------------------------------B-------------MXoB-E-------oX?------------------E----
-------BBXX-----------------------B--------?M-------oB-?-B----------B---BB-B---B-----MM--------------------M----X--?--BMo?-B-B--o-------BB---------------XXB-----------X--------------------------------
oBMM--X--oB----M--BBX--o------------XXBMB----------------------------------------M?X-----X---------B-BBX-----BXXMXXM----BB---------X------XB-------------------oXX-M-----------X---------------------EB-
--o-XBB-------------BBoX?------------------MXXX?-MBB-----?M-----------B------X----XBXBo-oB----X-XXXBB---MB--XM-------------XX------------MX---BXB------B?--E-BB-----------------B------------------B---v
---?XBBX------BX-------EXXBB---------X-------------M----------------B-B--------MXB---o-------------------------X-------??---B?B----?----B-----------------X----------X-X-----MX--?---------BX----------f
--------XM-----------------XX--------X-------------BB--?BM-BXM--------BB-----M-----?MBXBMBBXM?BBBXB------------------B-------BXBB------------oX--------------B------BXXMMB--------XB?X--------XB-------f
----------------B-------------XB-XBX-----X-X-----------MM---------------XB-XBBBXB-MBB-BMB-------------M?---------------------------B---------M-----------------B-------?-------------------------------f
-----BX?EX-----------------XX---XXBMBBBBX-----------BXB---XB-----X-o-X--BBM-------------XBXX--oo---------------------?---------XX-X-----------oX----------XB----------------------------XMBB-----------f
-----MBB---B---X----------------------------M?---------B--BB---------------------------BBB?--------------B---------------------------XBBBX--------------?-----------B---------------B?X---BB------BB---f
----------BB-XX?-----------------------------?BM----XMB?-----X-------?M----oXB----------B----MX--------------------------------------XB-------X?---X---X----------?-M-----------o---BBB-??-----------BBf
m----------------------------------B-----------MM---------------------o?BX------EB-oX--BBBX-??B------M-MM---------------X------------M?--X?----XXB---------XB---XBT-oX----X--o-----X-----XoB-----------X
X--B----X--XBBEBX-o-X------M--B--B---BX--------M-BB-------------B--------o----------------------o--------MB-X---M-BB-------MBMBBX--------BBBB-----------B?B-------|---------M------?--------X----------X
-XXXXXXXX-XXXXXXXXXXXX-|X--XXXX-XX-X-X-XX-XXXXXXXXX-X-XXXXXXXXX--XXXXX-XXXX-|XX-XXXXXXXXX---XX|XXX|-XXX-X-XXXXXX-XXXXXXX-XXXX-XX-X--XXXXXXX-|X|-X-XX|XXXXXXXXX--XXXXXXXXXXXXXX--XXX-XXXXX-XXX|XXX|XXXX-X
