-----?XB--------------------------XBBBB----BMBMMXX---M?--------MBBXX------------B-oo----X----------?X------------------------oX---------------------------B----X-----X------------BX-MBBXMBB?B?---------
---------B-------------------------??-----EX---------------oM-----------------BBXoXBX-------XM--XBBMBB-M-----------------MoBB---------XB---------------------------------MXM------------X?XB----------M-
--------------BB-BBB------------X--------BX-BXXXXX---------------?XBBBB-MXXBBBX---o-------------------------------XXB-M?BXXMXB------------?BM----------X-------M------BBX---B----------XBX---BB-MB---B-B
XMB--o---------B--------?-------------------------B?B----------------X?-----------B?XXB?BBX---?B-----------------------B-?XXX----------X------XXXXBB-----------B--------------?B?-----------XMXM-------o
-----BBX-----------X------BXB---------MBB-----M--XB---------XBX----------BBB----------BX------BB?BBBB--------MBBX-----BBB---------------------------------BBXX------X-----------------BBB??-------------
-----------B-----------------M-----------EB--oB------XB-------B---------B----E-------------------------------X----------------------XBBBX---------B----------?X?X---X------------------------oBXXM------
-----------M---------??-------X?------XX---XB-------?M?----------XBMXB-----XX?X------BXX--------EMMBBBB------MM----------XB----------XMXX--?BX----------------------------MX--B-------B-----------------
------------MB----------------BXX--BB---?X-----o---------------B?BB----X-----------------------oB---B?B-------------BXB---------MBXXM----------B--------BX-------------------EX---------B-BB-----------v
---X-------BBBBBB?B-----?B-XBBM---MB----------------MBXBBEBBBMB---------------------MB-----XMBBX-X-------------MBBMo-?-------?BX-------?X?------------XX----------B----B-------oBBB--------------------f
---BXX----?XX---------------?----o??-B-XXX------X?-----BXB-------??M----------?---B-----?-XXBX-----------------?-----------oB-oB-?X---------BB?M---BBBXB--MMX-------------BoB-------?---------XXXX-----f
----------------------BBXXB-----?XX?--BX---------MMBM-----------BX-XXXXB-X?--------BM--------------B-------------------------------------------?X--BXB------B----X---?MXBX-------------------BXBB------f
--------?BB------------------o--oM?BB----XXBX----X??------------??B------------B?-----XXoB-----------X-BBB---------BB------ooMXB----------------?---------------------------------------------?--------f
----------------------------------XoBBBB---------oXXXXM----BBM----------------?BBXX?BB--------X-BBBX---------------BBBB------XMBBB?BB-------BBB--BXX---------XX-----------------XBMB--?XB---?X---------f
-----------------------XB----BX----------BB----------------?X---------------BB--B---------MXB------?BXBB-BB---B--------------BBXoBB-----------------M----------BBB----------------B---BXXMBB-----------f
m----------------------------BB?------------B-----B---------------B?X-------------------------BBB-M------X-----XBB----------MB---------------------XXBB---------------------------BXBB-----------?BBB--X
---------------BX---o--------------XXBB-------BBB-BB--------X-------------BBBB-----------------------??--BBMM---?--XB?MX--X--BXXBB--X-----X--------?MBBB?--B--------X??----?-BBMoXBXB-----MBM-------XXXX
XXXX-XXXXXX-X|XX-XXX|XXX-X-XX|X|XX-||||X--XX-XXXXX---X|-X-|XX|XX--XX-|XX-XXXXX-|-XXX--X-X--XXXXXXXXXXXXX-X-||X--XXX-XXXXX-X-XXXX-XXX--X|X-XX|-|XXXX--X|XXX|X-XXXXX|XXXXXXXXXXXX-XXX|XXXXXXX-XX-X-XXX|-X-
