-X--B-----o--X--B--------B-X--X-----o--Bo-E------B----EX-----M--X---------------------X------?-o-E?XXX--------oX-E---------B-B---X----BX------X-?----X-?-----------o--------B?X--XXB--X--X---B---B--X---
----B-TE-o--X-------oo---E-------o-?-o----o-------X-----o-M----o--B----------------B-----?--X--------X----o-X-oo---X-EX-oX-X-----o----X-X---------------------------------------X-X-o------XX-E------X--
-X----|-------M--B--X--------------------XB------------X----------------M-?-B-------B-B----o?------X-XX----B------------X---------Bo------?X------Bo---------XX--X--o-X------------------B-E----o-X-----
------|-------M-B-----?---BoX-o--E----o?--X-----------o--------------?------X----X----?--X-----X---X--X-----------X----M-XX--Xo---X-Bo---X-XB---BX-----E---B------X-----X------------X-XB---o--X--------
E-E---|---EB---------B?--------B---X----o-X-oX----o-o---X-----X----?----X--B--EX---X---X-------X------------?----o------------Xo--------X---------Bo----------E----o------XB-B-----X------------------B-
X---BX|-----MB-oM-o------X-------Xo-B----?---X--X-o--XXX---------X-o?------E----X-----------oX-------?-B----o---X----?-----X-----X-X-------X----------M---XXM------M--B-X---X----?-----?--X---X---------
-B---E|-XXEXX-------o---------------X-----B-XX------------Xo-----------o--BoX-----o-?-------o--XX--X-----------MB---?----X--X-------X--oE------o----Mo----X----o-----X--E-oX-------o--------X----------X
B-?--X|--E?X-----X-X----E---B-X-o---X----------X---o?--E---X---M-o-?--XBoE------M---------------o--------------------o------oX-----oB-E----X-----X--XB----------oX-----M-B--M----X--------X--?---X--?--v
--?-B-|-EX---------o-----E---XX---EM-------X--o-X------XX--X--Mo-------?X---------E------------------Xo-o--X-BX----X-BX----------X-B--X-X--X--------XX-XX-M---------M-o----B--o--X-----X-o---X----X--X-B
-E----|-------B--o---o-X---?------B------o---------E--X-----M--X-----------B-----------X--Bo-----------B-------X----------------o-X--X-B--o-----M-o---------E------------o--------X------X-X-E-?M--oX---
----oX|--B-E----oE---X----B--X--X------------XX-------------o-----------?-X-X---X--X--Bo----X----B-Xo--X?------oB----X----BB------------o------X--E-X---o----------X-XXB---MXoo----X-----E-X------X--E--
------|X--X---E-------?B-----Xo--------X---------X--X---?-----B-----ooo-X-o--M--X-----X-----------o--o-X----------E--XXoXo---X--XB-M-----------X--o------------?XX----X-o------XX------X------------XXXo
M--?-o|--T--E-----------X---X----------X---X-X----------X---oE--------M-------XoE-------X-Xo-o-----E-------E-----X---------E-----X-o---------------M-----------B----o------X--B--------E-X-?----B-------
----EX|X-|X-------X-----X-X----T---o-------XX----XX-------------X--Xo--------M------------------B---X-o-o--o-----o--------?--------X-BoX--------T---X---B--o--------X----------X----B--?----------o---X-
m----X|--|-E----o---X-----o--M-|------------X--X---X-EX---BX---?-o---o--X--X-----E---X---------------o---X?--M------B?-BX-B----?---------E------|-??--o-?-o---oX--B---------X?-X----------X--X----X-----
XXXXXXXXXXXXXXXXXXXXXXXXXXXXXXXXXXXXXXXXXXXXXXXXXXXXXXXXXXXXXXXXXXXXXXXXXXXXXXXXXXXXXXXXXXXXXXXXXXXXXXXXXXXXXXXXXXXXXXXXXXXXXXXXXXXXXXXXXXXXXXXXXXXXXXXXXXXXXXXXXXXXXXXXXXXXXXXXXXXXXXXXXXXXXXXXXXXXXXXX
