--B----------MM---------B-----XXX-XXXBB------BBM--------------------MXB?-M------------------?X--------B--X--------------???BX---------------------------X-XM-----o?B-------MX-E---oXB-----X-------------
--------------XBB---?-----------M-------------------B?----------B------B-----------B----XBXB----------X-----B---------------------MBB-----o-B?---B-----------------------BB??BB----------XBX-------XXBM-
------BXB------M?X-------------------------B-----BXB--BBB?-----------XBBX------XM--------oX--------B-X---oBB---------------------------XXX---------------------------------------------XM-XM------------
--XB------BBXX-----------B--------------XB-----------------------XX?--------EBXXB-------M-----------------------------------------XXB---------MMX------------X-----------------X-B--oB??----?-----------
-----XBB-------------XBBX-------------------BMB----------B--------------XB-----BBBM----BBo?---?-BB----X-------B--BXB-----XX?-------------BXBBB----?B?-oB--------?B?BBM-----------------------------XB-B-
--MB?BB------X----------------?-----?X--XB---------------------BB----------------------------------------------X?B------------o---XB----?oBB--------------------B-oXB-----------------------BB----------
-----------------MBX---XBBB--XX---------------------?X----------------MBMBM-------EBBBBB-------XBXB-----oXBB----------XXB-----------BBX---------------MB--BBMBB-------------BB--------BX----------------
-BBB---B----------XBXB--------------?MBX----------------------------------------X-------------X-BM?-----------------------X-----o?-----BXB---------------------------------oB------MB--------E-------MBv
---?M--------------------------BBBB---------X----------B?-----------X?-----E---------------X?--------oBX-----B-XXXXXB-----------------------E?XX------XB?B---------oM---------------BB--XB----M?-------f
--X---------------------------------o---------------BM?---B?-------------BX----X---BX---XXXXBX----------------------------XX-----o?------X-BBBXXX?XB?------X------------------?B-----------------------f
-------------------------X--oB?-XB-----XBXoB---B--------------X--------------------X-M---X-B-----oB-----XB-----------BXXXBX----------------------------------------MX--------XMB--------XXX--B?--------f
-----------------X---------------?MXB-----XBXB--oXB-----?-------XX--------------X--B-----XB-----BXXB----MX-----BB----------------------?---------------------------------------?M------XB----------MBBBf
-------------MB---------XX--??-XXXXB----?BB----------X-----M??-------B-----B?B----------------------------------B----BBXX------------------?X----------------M--B------------------o-------BXX---------f
-----?--------------------XB?----EX---B-------BX---M-----X----M---BB--------X?XBBM?XBB-B----M------------XB---------?BB?---BBXX-------------------------------XM--------------------MXB----BB--BX------f
m---------------XXX--BBXB---------XM-BBBXX---------------------------------------XX------------E-MX?B-------------o---------------------XM?-----------------XBBo----------------MMX??BBB--XXB?XXX-----BX
XXBM-----?---------BXX?-----B---------???---------BMBMM--X?-------X-------------------?BB?BX--------------------------M?BXoBB------------??B----?X-------?X--------XBB?--?X?X?X?----------B----XoXBB-?-X
XXXXX-XXXXXX|XXX-|X|XXXXX|XX-XXXX-XXXX|XXXXXXXXXXXXXX--XXXXX|-XXXXX-XX-XXXXXXXX-XX-XX-XXX-XXXX|X-XX||XXXX--XXXXX-X-XXXXXXXX|X-XXX|XX--XX--X-X-X---XXXXXXXXXX-XXXX-XXXXXXXX-XXXXXXXX-XXXXXXXX-XXX-XXXXX-X
