------------------Xo-BMB?M---X-----------XXX--------------------BBXBB------------X-------------BX----XBX--------------------------------------B-------------BXX?--------------------B--------------BXBX-
-------XXB---------BBBB--------------------------------------------BX?----------------------BBBBBB-----B-------------MB----XB??------------BXB--------B---------------B-------------------------------XX
--X?X------------oBBMXX----------oX-----X-------M--?B?---MX-----------MBXMB----X-----B?B----B--------??-----------??-----X-BXB------XB-------------------------MBBBM--------M--------oB-------------?X--
E--BoX---oX------------B-oB-----------MBM------------------------------BBBB-----------------B------------XB---------XXXXXBXBBXEBBBXoBXX--------------XXB----BB-----BBXX--------------------BB-----------
---------------BBX------XBBMX?---BBB----B---XMX-------B---------------------B---------oB------------M-oBX?B-------B---------BM------------------------?-------?X----XX----BM?BBX?---------------BX--?-B-
------------------BXXX-------------BX---------------BX-------BX-------------------XM-------------------------?BMB?--------?-----------------MBB?------------MM--------------BXMM-----?--M-----MXB-------
---------BMBX?-BXX------------------oX----------------?BBB--------------------------------MXM-------------------------XBBBB-------------------BBB------B-----------------------------------------------X
--XBB?-----M?B?XB-B?-----M-----B----------?MXBB-------BBB-----------BBB--------------XX--------------------------------------------X-B------------------------------------BB-------------------------BXv
----------------B---------BM---------BXXX------------------------------------------?BBBB-XXXBB--BB?B??-----------------------------BX------X----------E??B------BXXXXoBB----------B------------X-?B----f
-----?-----------B----X-MBMMB-----X-------------oXBX-----------B------B---XMBXXX--------------B??----------------oX-----------B---XX--B----------------------X?-------BX--------XBBX-------------------f
----------------BXX-----oX?M-?X----BBB-------XXB-------------X?B-----oX-X----------BB---BXB-----------------XM--------------------------oX-B----BM------------XBX---BBX-----B??M-------------?BXX----X-f
-----------X?------BMXM--E-----------------------------BB--------------------XBMX------E-----------B-------------------?-?B---B-BB--------------??BBoB?XB---------------BB----------BB?---BBB----------f
------------------------M--------B----------------------------------------------------------------------------BE------------------------o---------------------------------?B------oM-------------------f
------XBB---------------------XBXB?--------XoX--------------?X--?X?Mo?MMBM?--------------XXX----MXXB--------------------------------------------------------------------X------------------------------f
m-----------------B-------------------BBBXBMBB----------------BBBM------??--------------------------XB-------------------T---------------------------M??-----------o---------------BXB-------BXBX--X---X
X-----------------------------oo?o?---o----BBoB----B-----------------------BB-B?B-------------------------------oX-----B?-----------B?BXB----------BB----B---MX----------------------------------------X
X-X-XXXXX-X-XXX-X|XXXX|X|XXXXXX-XXXX--XX||XXX-XXXXXXXXXXXX-XX-XXXXXX-XX-XXXXX-XX-X-XXXXX|XX--X||X|XXXX-XX|X-XX|XXX-XXXXXXX-X-|XXXXXX-XXXXX-XXXXXXXXXX-|XXX---XXX-XX--X-XXX--XXXXX-XXXXX|XXXXXX|X-XX-X-XX
