---------BBBXX-----------------------------------------X---EX?B-------MX-------------------X-?B-----MX---B---X--o?---?B??-BBXX?-------?XM-oX---EB---------------------------------------------X---o?BXX-
---------o--X?------------------------X-----------------------------B--------------M-M?---------E------------B---X--M----X---M--BB---------M---B-X----X----------------------?-----------------oM---XB--
----------------B--o--------BB----?--------------------o-X--X---------?o?------------XB---X-----------------B-----------B-------X----------------------------------------------------------B--BMB?------
---BBX--------?BX---------------BBBB---B----------------X--------------?---------Xo-------------------------BB?B----------------------------X-----M----X--------------------------B----o----o-BXBXBBBB--
-----------------------------B-M------------BBXX-------BXMM-----X-------------------------X---------o--o---------------B-----------M-M--------B-XooXB----------------X--X---------------E---------------
------------------------BBBM------------------MXXXBBB---------------XoBBBX?------XB------?-----------------B-------?BBM---M---X---------B---------o-----M-BBB------------------------oM-----------------
--oBBBBMBB--------?-----------X?----------M---X----------------------X--BB?-------XX-------B-oMB--o-----------o--X-----EBBM---------B---------M---------?XB-----------------oBB?---------------------B-B
--------------------o??-----------------oBB-----?X---MB-------o-B------o-E?M----------------------X?X-------X?oX-B--XBM------Bo-------XX------oE-----------------------X-------XX---o-B------B----B----v
----------------------------------XB-XX---B-----------Xo--------XBBX--?---X-----------------BX----------------------XBB--------XXBXX------------??--------M-------M??X---B-XXB---M------------B--------f
B-----------M------?X---------o--X-----------------------------------------------M----------------------------?--o--B----------------------E-B-------X--X--------MB---?--------X-----------------------f
-------------------?--X--------EBB?-------------------------XXX----------------------------------X----------oXBBXBMB----o---B----------------------?----XMB?XB-------B-E--X--------?B------------------f
--------EBX-----------XBX-------X--------o-----B----X-------BX------BBBBB---X----------------------XB---------------BB----M?-------E-----------BX-------M-B-----BB----------BB---X---X----M-BB--o----?Bf
------B-------XB----------------E--B-----------o---------B?BB--o----------X-----X----EX--XB-------------X--------oB---B------BB-----BXMB----------------------------------?XX-----BBX-X---------XE-----f
-----EBBB-------o---------------?------B--------BM-----------------------------B?-----B---------??M------?-----------------X--XM------B----------M----X---?BB--X?--------------------------------------f
m----------T-------------??B--X----X----TM-------B--------B-M------X-?---B?-----------?-X--------MBX--------T--?-??---BBX-EB--------B-----B--------------o?----E---------------------------B-----------X
--EBM-?B-o-|--------------------TBX----------------------XXX-----?X--o?XM--TB--------o-BX---------------X-------------B----XM-------------?BB---------XB---BBBX------Mo--------------------B--X--------X
XX-X|XXXXX-XXXXX-XX-XXXXX|XXX-XXXXX-XXXXXXXXXX-XXX-X-X--XXXX-X-XXXX-XXXX---XXXXXX-|XXXXXXXXXXXX-XX-XX-X-X|X-X-XXXXXX-X-XX--X-X----XXXX--XX-XXXXX-XXXXXXX-X-XXXXX-XXXXXXXX-X-XXXXXXXXXXXXXXXXXXXX|XXX--X-
