----o----?--?---oX----o-X----X--------o---------------X--B----M--X----MX------?T----X----X--X|----X----o-oX--B--oo-XE--Mo------|-X----o-----Xo------T---B|--X---------o--B-----o-------X------XXX-M--X--
-------X------E----X--Xo-----M---XX-------------X|-----------oo-----X-o-X-------------X---T----o-----------X-B------XBX---X----B--XX---o---X--o-o-X--o----E----M---M----X-E---------X--X|-----ME---E-X--
-------------o-BX---X--o------------Bo--B--X---------X-X-----X----X-X---------X-X-------------EE---------X-XMM-|-M---oE-----?--X---o------X-----XX--X-B---------EXX----------XTo-B---------B----X--X----
---------------X-To---------X--TBT-E-X-------X---X--X---X--X-----X---------o-o------B--o------X--------------T---X--?--X---X-X---o----------X---------T--X--------------T----M----X------------XX---T-?-
---X---o-XX-XX--o-E-----------o----|---Eo-----B----------B-------Xo-----X---EoX---B---X---XB--------M-|-X-----X--------o------B--X-EoX----B-X-o------o-------o-X---X----?----XBX--E------o-X--------oTXX
----B---X--X----B---XX-X------X?T--E-TXXX---------XB--X--o--------o------X---X--|----E---B-----o------------o---X-----?-Eo---X-----B----XB----X--T--o--?---X------?B---T-XX---X----?----X-?--oX-o-------
X-------XX---EXX---X-------B--?-----o---E-X--o-o-E---?B--?-E-------------X------o-----o-----?------XXo--X-?-M----------XB--X-BX-----X------BXX----------X---------B---X-----X--E--X?-o--X----------E---X
-|o--X---X-XX----X----X--------B--X-X--XoX-------?---------X------?-X--------o----------B---M----EM----X--XX---XB-o-o--B-X----E-----X----M-----E------o----E-oX------o---------------B--X--?---Xo---o--v
-----E-------?-B--X-M?------------B------XXX-----B----------?--X------o------X--X-X--?-?-o-X?X-------------X---X--X-----X---X-------X----o--------X-X?---------Xo-X--B--X-----X---X-BX--T-----X---Too---
EX-X----X-oXXB----?-----?------------X-oX-|---o------B-----oX---o------X--X-To--B----o---oEXX--------------X-------B--X-----o-X?-------------o--BM---------E-----o----X----------B-X-------o------o-----
-----X--?--X--?----X-o-X---------o-----|oX|X-------Bo-?--B--------------------o-X-?------B--?E-X-------o---------X|X-X---X-Xo--|B-----o--XT--B--------X----------|------o--M--E-------oX-X----?-X------T
--E---o-------------X---B----?B--X-----o---------?-----B---BoM----B------E----------X-T--o-X----?----X-Xo------EX--XX----X---X|------------E-Xo---XX----o-------?X--X-?----X-B--XX---X--X-oXXBX--XTE-X--
---------X----B---B--------X-B---------T----o---oX--XX---B-?-Xo-----------?-X-X---B----o-------Eo---E--------X---X--X------------T--X---X-----------o-----EB-----o---------------------X-||-B---X-----EB
----|-?-E--------B---o-X---o-X-o---X-|-X-X------?--X-X------X--X-T--?---------|-------------------T----X---T--X------X-----?--X--?---T---E-----oX-------------oo---?--XEX---X--o---------X-o---X-ToB-?o-
m|o---E|-o---?X-o|--------B---E--------|-XXB--?TX--------X---X--X----?oMX-----TX---o--o------?-XX--??-----oX------oo----o---X-X-X---EBB--------B----X-oX--|-X?-o--X----M-T-----X---------------X-X----X-
XXXXXXXXXXXXXXXXXXXXXXXXXXXXXXXXXXXXXXXXXXXXXXXXXXXXXXXXXXXXXXXXXXXXXXXXXXXXXXXXXXXXXXXXXXXXXXXXXXXXXXXXXXXXXXXXXXXXXXXXXXXXXXXXXXXXXXXXXXXXXXXXXXXXXXXXXXXXXXXXXXXXXXXXXXXXXXXXXXXXXXXXXXXXXXXXXXXXXXXX
