B------------M---------M-E-X--X---E----X------------------B----o----?------X---X---------XB-?----B--E-------E-EXX--o--------B-BE--?E-----o-o---EB-----?-----o---oX?---oo---Bo------E--o----E--X---XE--o-
--------M--------o-?----X--o?--------------B-M-o----------X-------X-----?-----------------------------------------o---B-E?--------o-------------?------E----------------X--M------------B---X--??---X---
---oE---X--B----M-----B-o----Mo---------M-o----X--------------------------M--M-XX-XX---------?---M-----?-o--------?------?------------X-----?-M---X-X--B-------E-oE---------?---XX-------------X--------
--o-----M-------X--BX-----E-E-------o-----o--------MX------------B-o---X--E--E----o----B--------oB--X---o---X---E--------------?--------X-----X-B--EX--o-------o---------o--E---ooE---------------E-M---
----B---------------B-----------B-o---o-----X----E-----------?----o------B-E--X--X--o------B-----------Bo--------X-----B--------------B---X-XX------------------------------E-----------X----E----M-----
-------E----X--B-B-----EX-----------------------X-X-o---------?----------?--------?---------E---X----------XE---?--------XBX----o--o----------o-----XB-----?-------------M-------o---E--------E--E------
----X----o-----------------o-----M-EE------o-----------------X-----------------------X?-X--X--------------------------X------E--B---B------X-----o--B----??--X-?-X---X----------------------E--o-----oE-
--?----------o-----B-----------------o-------------B----------XM---------------B------------B--------B-------X--X--------------------E-------------------------E---E----------X?---B---B--B----B-----M-v
-----E---X-------o----------o--?-X------o----X---M-------------B------o--E-------------E--------------------X-X----------------B----M-------o-------X------X-o-----E-----E----E-------------B-------X---
--B----X------------o--------X--BX--o-B-E----X-o-----X-X-----------B--------X-----X-o-------------M-----------M--------?----o-----------B-------------o--E-E--------------------------oo-------X----X---
-------------Xo-o----------------E-----------B----------------B-o--X-----------------------B---------X------M--M-------E---B-T---------oE-------B---X--E--M----X----o--X----B------E---------B-------?o-
oM---------------B---B--------oB--B---M-o---E-B----X----o-----?B-XX------------------?-----o---B--o--X-----X?---------------o|----------------B---?----X---BB-------?-------o----o---------o-BXM---E----
-----X--------XT----------T--B--------E------X?--------TXT------MM----T-B--X--------T-X------o-T-o-XMo---X-----------E-oo----|X--M------EX---------------E------------X--------M---B-------Xo----?-X--?-
--TB---X----TM-|----T---T-|--TTT----TBX-X--TM--T-?-X---|B|----B--T----|-X-ET-o--TT-T|-TXEX---T-|T----o--X-oT-E-T-----T-----o-|-T--------TTXT-------TT---TT---?T-------o--T--BMX-----X----o-BT------E--T-
m-|M-----o-M|o-|-o-?|-X-|-|--|||X-E-|X--B--|---|-E-E---|-|-------|----|X---|----||-||-|---X-X|o||E----X-o-X|---|--BoE|X-?--X-|-|--------||-|-B---M-||o--||--oo|-X-?----EE|---X--X----o-----E|?--------|-
XXXXXXXXXXXXXXXXXXXXXXXXXXXXXXXXXXXXXXXXXXXXXXXXXXXXXXXXXXXXXXXXXXXXXXXXXXXXXXXXXXXXXXXXXXXXXXXXXXXXXXXXXXXXXXXXXXXXXXXXXXXXXXXXXXXXXXXXXXXXXXXXXXXXXXXXXXXXXXXXXXXXXXXXXXXXXXXXXXXXXXXXXXXXXXXXXXXXXXXX
