B--------o-B-X----o-X------X-------X-----E?-o-X--B----------X-------X----B----------X--Bo--ooX--X---X--?EX-MooX--X--X----o-Xo-o-XX--X--?X----Xo-X-B-o------o-------X------o---BE------BB-------E-----X--
?-----T-----------------------M-------X----------------X---BB-X------------B---XB--------?---XX--------B-X-B--BXXX---------M---o------o--??----M-----BX-------------X-oooB--?-----oX--------------------
-E-oXB|-MX---------X---------------XX----XX-------B-o----o--------o----------X---M---BM----o----?--B?-------?--------?---X---X--------------M---XE-------------B------XX---X-------o---o----X----X-X----
---o--|----X-oB---X-Xo-o-----B-----XEXXo-----Mo----?------------MX---XX---X------E----o-X----o--BXX-X--X------X-o-----M-----X-----------EX-B-----X---X--o--X-------o---BE---------X-M-?---X-E--oB-------
-M--X-|--------B-----X--X------------------X--XX---B-X----?----X-X----X------X-B?X-X------B-X--X---X--X-----X---X----X---B------X?o--X--X-B------------X-----B-------XXX-------B-X---o---E------X-X-----
------|----BX----X--X-?o----X--XX-----o--?-----X?----X----X-X--X---------------E-o--X----------B----------M-?o--------------------X-M--B--X--X--X-?----X---B-o-----B------E------X-X-B---E--------X-----
-o----|-----o--------------X----------oXX-X---------XE-XX---------X-?--Eo---X--X?--XX----oX--oX----X---o--XX---o---Xo---o-----XE-----------------BB-XB--X-M-------X-X---------XBX-------------------X--M
XE--X-|-------?-X-------B--X-E-B--B------X-----------o-------X-E-------B--------BE-X-o-M--X--------------------M------B---E-----------X---X----M-----------X-----B-------X-o--XM-XBX-oBoo-E----X-------v
------|--M--BX-o---X-X-----------?---o--------X--X-X-------o-BX---M--o--X------?--o----------------------E-X-----B-------BXBX-----X------X-E------------?-----o?----X----B----------X-E-X--X----Xo------
-o----|-----------M-----oX--?----E-X---------X-----XX---------?-E----------X-EXo-------------?-----X-X--------X-X-B-o---XX--------?-X--------B-M--B-----------------oo-XE------X----X---B-----o-----o-Xo
---XE-|--------------M---X-B--XX-X-E--X---------o--------B-?------X-X--X?----XB----XX-----E----BB---------X-------XX-X----X-------B?-E----------EX--X-B--XE-------?---o-------X-------E-----X--------X--
------|---?X---X----B----X--------E--B---------------o--BX------X----B-----XX-----XB-X------X--------E-X-----?-------XoX--B----E--------X--------X----oo---------X-X--Xo----X--oX--------B------------B-
---X-B|--TX-B-X--XX-----B-M----M----------X-------X-?-------E------M?--X---X-X---------------o--------XBM----M--B----X----o-X-----X-------XX-----?o-X----X--------?XX-X-B-------------M----X?XoX-?----X-
------|-o|T---o----X-----Xo-------------B-----X--------------------oXo---B--X--------o----EX-X----X-XXE--------?X-o--oX--------------X----X--X--X-------T-----------------X--X--o-----oo---T--?---T-----
m---B-|X-||-o-X--o-XX----XXo--o------oX----BE-Xo-----------B----------X----E-E--X--------B------o--X-------------------B-----------X-X-E--X-----?-------|--MX------X--o----X-X--Eo--BX-X--E|--EX--|--X-o
XXXXXXXXXXXXXXXXXXXXXXXXXXXXXXXXXXXXXXXXXXXXXXXXXXXXXXXXXXXXXXXXXXXXXXXXXXXXXXXXXXXXXXXXXXXXXXXXXXXXXXXXXXXXXXXXXXXXXXXXXXXXXXXXXXXXXXXXXXXXXXXXXXXXXXXXXXXXXXXXXXXXXXXXXXXXXXXXXXXXXXXXXXXXXXXXXXXXXXXX
