--X--------X---B--o--------------------X------oX--BTo-ooX---------X---o----------X-Xo-----o---X-----------E----T--B----o-----?--BT----X-EX-Xo-T--XMX-T------------------------|-----X-----B?E------o-oT-
oX----TX--?o---E-XX------|-X--X--------XoXXE----|XX-X-XM-X-X-------------B-X--|----X--------E-?E-o------X--o--------XoX---X?-------o--oX-X--------------X--o--------o---BX------------?----B----------BB
-oBX--|--X-----X-X---XE------TX-----X-?--X----B-------------T--------o--X----E-o-------------X-o---oX----E------X---X--------|X-o--------X----M-------oXoE--o----o--X--X-X--o--BX---X-o-------X-X-X---X-
--X---|------o-|-----X----o----X-------XX-?--------o---X-----o-----o---M-oX-------?-?--------o-------?----o------X--X-XX---X----Bo--------o-----X-------X--E-E---E--B-------X-X--o-o-X-X---E------TX---X
--XX?-|-----M---X--------X-X------E-X----------?X-?----?---------o---E-----------XB----o?E-o----X---------|----BX----o-X-?oMo------X-|-BX--B--?--TBoE-o--X------B-------X--------X?-B-T------?-MX-Xo----
----X-|-o-------Xo--T---o----X--?------o-X--------X---o---------?-------X----X---------B-|--XX-o-X--B----o----X-M-X-M--XX----EXX--o-BX---o--E-X--|-T----o-X------X-?----oo-X--Eo----------T-E----XX-----
------|--o?-----------?Xo---------X--E---X-------X----------X---------XE--|--?----?XX--?----|-----X----------o----B---?----M-o---X-----------X-X---X----oX--M--E--B--T--------------o-----o-X-------oT-T
X----o|-X-X------?-----X---------E-o----------------XX--------?|---X-X----?-X---E-----?B----------X-X---B-X---o-XT-----oB-X------------B---------o---------T-----o---ME---M--T-X---BX-X-E-----oX--X----v
X--ooX|-B--XX----XoE-------X--B------XoX--B-------X-X---|------XX-o-----B------XX--X--o-----|-X-|-X-|-----------X-------?----B------------o-----X--|--BB-o---XBE----X-------------X-------------B----X-B
------|---------------X-----o-XXo---B---EE----X?--T---X----?---M--X----X?---XM------E------?--?-o----------------------?-----o-X----B----------X-X---X-E--X-----X-T------X----X-----X---o------------B--
----X-|------X-o-------|--X--X--M-----X-B----E------T-X-------X---?-T-----------?------X--X----X-----?-M----X------------X-----o---X-----X----X----|---X--------M--X-?-----X---T-X-X-oBo-------X-B--X---
------|------B-X?-------------X----EEB---X---------X?--X----X---------|--X--|-TX------X-oX-----X-|--XXXo--o---B--B----o----------X--X-----X-X-|--------B-o-------X------X-X--E---------------X--?----?--
M-----|--?-X-B--X-------X--?X-----o----o---------oE---X--T-----|o-X-----T-------o--X-E-X---X-?-T----------|?--X-o------------B-M----------o--------?---X-oM----BX---X-X-EE-TX---X---X-o-B----?-?----T-B-
---E--|X-|-X---X---------o----T---------X-X--------------M-X--XM-----?---B---X--|-M-|o-B--MBX----M-X-----X----X----------E------X-----Eo---XXMB----X--T-----?T-X--X--------X----M---X------------XEX-X--
m-----|-B|-X-X-----o------X------?o---o------XoBX-X-----------X?--M--E---------------M-----?---------------XX--?---X--E-X--B-X--o--M--X--EBE-X|--X-----------?-----X---X-X--|?--X--oBBX-X--?---?-----o--
XXXXXXXXXXXXXXXXXXXXXXXXXXXXXXXXXXXXXXXXXXXXXXXXXXXXXXXXXXXXXXXXXXXXXXXXXXXXXXXXXXXXXXXXXXXXXXXXXXXXXXXXXXXXXXXXXXXXXXXXXXXXXXXXXXXXXXXXXXXXXXXXXXXXXXXXXXXXXXXXXXXXXXXXXXXXXXXXXXXXXXXXXXXXXXXXXXXXXXXX
