X--------|----M-B----E---------------------------B--B-o--XB--?---------o--B----T------B--B-----T------------------o---EB--------?o----------B-B-?--o-B-----------------oo------?--------E----E---------E
X---T--?-------E--?--EB-----E-----------|B-------------B|-------------------------------E-----|------------o-o-o-o--------BT----o----------T-E----X-X--E-------------------o--M---EE-----E--------------
M------o-----------------Xo---E----oT-Bo-oB-----?----------------?----E-----------------------M------B----------E--------M-------------o--E-----------E--------------------E------B------o---?---B------
------o-Bo-oM-----------o-o----o--------B----o-------------E-M-------B-------X---------------T--------------------o-----o-X-----------B----------------------------------------------|-------T---X------
-X-M--?---E-----------------------E-----X--------------|-------?o--o---X-oX----|--?--------------E---E--------?-E--E---?--------------E-o------X-E---------o?----X-E----E---o--T-|-------------B----?---
----?BT----o--------|------------?------------------?-o-----E---|--------?-----TE------o---E-B-?----?------------------?----Bo-M--------M-----B----B--------E---o------B--B----o---E---EB-E---|?---o-o--
---------o---o|-Mo--?T--?-o-------X---------------X------------o----------E-----------B---o-------o--------o-B-----------?-----------B------------?---------B---E----M?---B--|T---o--o-|-EB---o---T-----
------------|---M-----------------------X-M--------------------------?---o--M--B----Bo---------------o----?------o----------------?-----------------------M---------B-----o-----|-------B-------B------v
---?--------|-?---------E-------------?---E-B------------X------X-----o-------B-----B-E----B-----o--?-------o---B---M--o-?TE-------o----E----------B---------o------Mo----------------------B-B-------Mo
--?|B------------------o--T-T-----------------------?---?----------E--|----------M----X-----o-------M-----------T---------oX---------------B--------E-B---------?-----?---B-o---------------------B-----
-----|?-----------o------------B-----B-|-----------------B------?-------B-|--?---|---------------------E---------X--M-----B--?|-----|------------?-M--------?------T-B-X--------------X--E------o----oX-
------------------------E----------------------B--------------------------o----XB--------T-o--?--------------E------X---------------------------------B---M--X-M--Bo--B---E------|-----o-----o----E-----
--------------M-------------------------?----X----X-?----------o-o--B------X---------------TEB-------B------------o-B------B----------------------------B-------o----E----------E-B---M-----------------
-----------------------o-----o---------B-----E---------|-Eo---o----------------?-E------------------B-----|--MB---Bo---oE-----------M---------------------------------E-----oME----------E---T------B---
m-----E-----B------E-------o--o-----E-----------o--?----Bo-----MM-----E--oo------------------M-----E---------E---?----------------E-----B?|--Bo------------|-----X----E------------------E----o---------
---BB-----M------B------------------Mo------o?-E----oB-----BE----o-B----o--o---o-------------------------------------B----M---E-------X---B----|-M----o-----------------------T-----------B---------?---
