?-o-XE---o--B---X-MX------XBXX--B----o------------E-----B--o-----X------------Xo---------X-------B------X-X-E-oXX-X-----B-------XM--XE--o---Xo--X--o-BX-------B?--------------------B-------X---?---X---
--XBX---------X--X---------------B-------B----------?------o-----Xo-------X----------X----------E----X---B-----------------------X------X---X-E-oEo--o--------o-X-----o----MX-----XB--MX--------o---Xo--
--X-X---XM----XX----B---X----------------o----X---BB-X---X-----o-X--B-X------E--B----?-oXE-----------o--------?o-?--XB-------B----?--XBX-------o-X---------o----X----------------?------X?-?---B-X--B---
---------B----------X--?----------B?---oBoX-XX-------?-B--X-EEM?-B-X-------X-----X-----?----X--M------E--?-E--o----X-X-----------------B---M-B-X--------o-?-----o---E--------X---X---------X--?-oo---X--
------------o-X-o-B---------?-------------X-X-o------E-M---B-----?---X--X--X--------------?------X-o---?-X-----E------o----X-o---------?--B-----oX---B----------B-B-------XB--------X--oB--X------------
----oX?-------------------X-M---X-----B--------------E------X-XX-XX----M-----o-B-----X----------o---oEMo-----X-?------X-------------B---B--------X-X?o--E-B-X---o----XBX---X------o---------------X-----
BB?----------o----o?-X--------------------E--o-----E----------o-X------------B---o---X------X?--------X-----B-B-------------B---E---oB----------X------------o-E-----o--X----o-M-------?oo----XX-------X
-X-----B-X--------------X-------o------------Eo----?--XBB---------?-----XXXo-------------X-----------------------------E---X----X-o---X----oB-----E--X-----o--------------E--B----?X------------BXX----v
-?----------o----o------o--B-----?---E-?o--XX---------X--M-o-X--X---X--------X---------X--X-o-----X--X----o---------------------------X--X------M----o-----oX--o---B---E--------------B-----------------
----X-M------E-X--o--X--X------------X--B---XX--X--X---Bo-----XX---X------XX---o--X-----X-----XX--X---X----X-E---------?------?-------oX-------B---o-----B-M------?-B-X--o-X--------o--------X-?-----X--
-----XX--B-X--XXX--------E-X--X---?-?----------X--XB--B-?---X--E---XXX--E------X--------o---?--X-B------BX-------X-B-----X-X-X-----------------X--------------o-?o------X-------------E-X-----X-------X-
-----M------o----XXE-X-----Xo-X--X---oE-----B------------o--E-?-----X-?B--BX------------X----B---B-----X--?------B------X-----XB--M---oX-----------B---B?E?----X-X----X--?o---XX------?------X--X-------
?-----XX----EM--o-X--X------XXB-X------------E------------oX-B---------XX-E---------XB-B---X--X-----Eo-o---oX-B?--?X--o---------------X--------------XX-----X-----X-E----o-----X-X-----T--o-B--X-------X
-EoBX-----X----M-oX----o-----BX----T---B-o?---X--------BE---ooXX-----E-E-------------XT----------------X------o?-?X---X--X-T----------T-o-----B-X--X-----M----X--o--?--X---X--X----X---|--BX-o-BM-------
m--X-X?------------X---X---oX-X-?-X|--Xo---o-Xo----------MM-E---------Eo----o--X?o----|XX----?E--X-X--?----X--X-------X--B-|--------X-|-X----o-X--------------X----------------?X--X---|--X----B-----?X?
XXXXXXXXXXXXXXXXXXXXXXXXXXXXXXXXXXXXXXXXXXXXXXXXXXXXXXXXXXXXXXXXXXXXXXXXXXXXXXXXXXXXXXXXXXXXXXXXXXXXXXXXXXXXXXXXXXXXXXXXXXXXXXXXXXXXXXXXXXXXXXXXXXXXXXXXXXXXXXXXXXXXXXXXXXXXXXXXXXXXXXXXXXXXXXXXXXXXXXXX
