X-----XXE------M-----E-----T--E-?-----------------------?--?-----B----------------------M-----?---------------|----?--------?-------?-?---?----E------E-B-----------------------------------E-----------
-------X----------o-o------B----------|o-B--------------E---?--E----------X-B--o-------E----o------------X------------------------|----------B------------E----------------------------------------?B-B-
---?----?----o----?-----------------?-----------B|--------------o---E---------B?---------o----------B---?---------E-----------------?M----E---E-----T------------|--o--M-------o------o--------E-E|--?--
-------o-M-o-----------|------T---B---------E---o-EE-------------------T-E--------|-------------X-B----o-------------M-|E---B-----XB----o----M----o------|--E---?--------BX-------E-M-----------M--B----
E--------------E--EXM?----------?--B-----o?----------|----------------?--X-----|-------------o--E--|----TE----o-----------E-------M-----------o----B-----------X-?---------o--------|o--B-------------o-
-------------------------?--?----------B---|-------B|-?----M----BB--------B----------T-oE--------X---|-o---------XE---------o-B---?-M-|--|-X---o--?-B-M-----E-T---------------------?---B--Bo?---E---E--
-------E-------?--?---------------?EEB--------------?------o-------------o-----o-----T---------B-----BB------------o-----------B-Mo------------B------B-o---------B-----o------------|------|-----------
----?o------EB-?-?--------------o-----?--------------T--X----------------------B--B-?---X------------E|--?----o-----|--M--B--------|--------------B--o?---------B------o---T---B----E-o---E|-----?B----v
-----?-----?-?------o--B------B-BM-?-----o---o---M---BE-----B-M--|X------?|-----------?---o--B-------BE-B--?-o------------------?-------------To-----------------E-------------------E--------E-----E---
-----?-----------M-B------------------?---------------------B------o------TB----B-B------E--X-o---------------------B-B--------------------------EX-------?--------T--o-BB--------------------?---------
--T----o------o---E-----E--------M?-----o---------MEE---------?----------o---E---E---T-E-------o------oo----------B-MX-------|--?----------------------E-----E------------------------E-E--M------X-----
-------o?BM--M-----?----------------EE--M----------B-o------Xo--------------B--------------B-----------?---?-T-------------|-o--|?---------o-----------------|------B----B------------E---?------oo-|---
-------------------?--?-B?|--B--E-----B--------o--B--B----|--?-EX-------o---o-------B-----------o---------E-------o--B--------E---------?----o----o--X--------o-----E-----o---|----B?--o--------BB------
------E-?---|----------?o-----------------X--------B--o--------------M-------------MB---?----?-B----------------------E----|------M--------------------o------------MB-------o---M---------X-------B----
m-----E------B--------------B---------T------o--------|---oX--------o----------------T?----o-------B---T---E-B----X------E--|----E----------o----o-?E------|X---------E-----------?---T-----?-X-E--B-o-X
XXXXXXXXXXXXXXXXXXXXXXXXXXXXXXXXXXXXXXXXXXXXXXXXXXXXXXXXXXXXXXXXXXXXXXXXXXXXXXXXXXXXXXXXXXXXXXXXXXXXXXXXXXXXXXXXXXXXXXXXXXXXXXXXXXXXXXXXXXXXXXXXXXXXXXXXXXXXXXXXXXXXXXXXXXXXXXXXXXXXXXXXXXXXXXXXXXXXXXXX
