--?-|X----XBX---X------------B----------o--------M---X--X--B--B--X-X--X---XT-----M----------------o----BX-----o-o----oo?X-XM|-----o------B-------T---?-T-B-------o---?TX-------X-o--X------B---------?X-
-----X--X|----oB-B----M-E---X--X-------------|---X---X-------TX--X----X--o----EE-X----TBoX--X-------X----o----X-----o------X-----o--BB-B--o------------XX-o-X----------M---XB-B--X--B--B---X-----o-X---X
o-T--o-------X--M-------E---B--EB--------?X---B------|---EX------XX-------X-----------B-------XB--XX------o--oX-------------X---X--B----------------XEE-XX--M-?--E--o-XX--o--B------ET---|--o-BX--X---X-
---XoXX--oX-----X-X--XBE-Mo--------X-E---B-?--X-X------M----------------X--X-----X----E-X---X-----ME------EX--X-o-oX-----T---E----oB-X-------X-o-E---------B----?----oM--------o--X--------X-------|X---
X--B---M------?-?B---M-X----X------EX---ET---XB-Mo?X?---T-------B-------X-E---E-X-B--B----|----E-E--Xo---------B-------XX-----------B--T--o---X--XX-|---ooBX---X-XX----------X--?----B---X-X---o-XBX----
X-X---oo--o--E----X-----oT----X-E--?--X-B--X-----|-?----B-------o---oXo---XX----M?---XB|B-----Xo-----oE----?-oX--Xo-----T-o-B-X-T---XX----T---?-X-BXE---------X-|-------?------o---X--T--?--o---------X-
-X-X----X----------E--------X---B-X-----|-o-X---X-----|------------X---oBBX---X-B--TXo-----------oM------X-o-E-----XB-M--X---XX----o-X----------XX-----o-------X-X-----------|X---X-----------E------X?-
?-X-----X-X-M-----oX--E-----X--oX?--X--X-------X-o-?-E-XM-----X-----X------XX----oXX-------XX----XMXXXM-------XE-X-M-------------M--M--X---B----EE--X--o----?--E----X----X------M-?X---?--X---------Xo-v
X-----XB---X--TX--------M---------X------B---oXE--------B-------E--------X---M--------X-----------X--XBX-X---X-X--------X-o--------XT-?-------B|----oX--oX--oE-o-----B----X--B----?--?--X---B----E-M----
-----------------B---------|-?B-------X-------XMXB--X--------X-----MX-------X-oooXX-----X------------X--o--o-X-----B------------B-X--X-X-?-------------M---------------E-----X-X-------X-X-?-M---X------
-------B-X---o-X------X-X-X--XB--oXX------X----------------XX----X---?-o---M-----------|-oM----E----B---X--oX--E-X?----BX-------------------------T-XX-----XX--o----o-M---------BXX?---E----?----E----E-
-B---X------?-X--o---X----------------B--X-|-o-X--------|---B--XX--?----XX--o--B-XX----------------X-X-X--o-----o-T-M-?---X--T---E------------------EX-X-X-M----X----Xo----o-BB--B--oB---o---E-----T-B--
---X--X---X----XX----X-XXX---M---T---B---M---------M----T------E---|EX-------E---T------?--------B----B---XE--oX--X----------?--X---X--oX-o-----------------X---X------B--X--X-------M----X--|-?BTX-----
X-------Eo----o-X-B-o---X-----X------o---E-X-------------??XT-B------------X----XoB-------X?----X----oo?-------X---X-------o--X-?----T----X--o-E-o------B--------X-----Eo-------o--X-----XE-o--|------E-
m-|--B-----X------?X--o|---X-?-----|-?--------?------X-------EX---------X-------?---X---XE---M--X---------B------|------X----------------X------E-----XXE----E--M----o------X-?-EX-X---X------TX-X-XT---
XXXXXXXXXXXXXXXXXXXXXXXXXXXXXXXXXXXXXXXXXXXXXXXXXXXXXXXXXXXXXXXXXXXXXXXXXXXXXXXXXXXXXXXXXXXXXXXXXXXXXXXXXXXXXXXXXXXXXXXXXXXXXXXXXXXXXXXXXXXXXXXXXXXXXXXXXXXXXXXXXXXXXXXXXXXXXXXXXXXXXXXXXXXXXXXXXXXXXXXX
