B----------o--------M--B--?------------B----MX?---------M?-----oXXo---B--E?---X-------------------BBB-----------------BXX----------------------oXoX-X-----------B-----?-------E-------oXB-X------MB----o
--------X----------------?B-------B----------o---o----X------------o-----B-------------M--oM------B-------XB---------?MB---o?B--------o--oBX------B----?------------o--------?B-----X-------------------
--------------------B?BB----------------------------------X-----------------B-E------------X---BX--?B?----X-------X?--------BBXXMMB------------?X------------?o------------------M?-BBBXB---------------
---------------------------------XMM----------oM--------------------------B---B------B-------XX----------------B--------XM----X--E--MXB------o--o-----------?------BB--o-------------BBX---------------o
--------------------XX-----------BBB------BX?-X-B---------------------BB------------??B-----------XB----M?MM?BXX?--------B-----------------------------MX-B-X----------X------------------?X----------?-
--??--B?B-----B?X------XX--BB?X------E-----------------------MBX-M--?------------------M-------------B-E?X?----?---B-----oBXB----B---------------M?-----M-----------M-o---XM---o------------------------
-X---M-----------------?XX--------o-----EX------BX-------------------o----oB------------------------------------------M----M-----------------------------------------X----X-----?-oB------XXB-----------
M-------------oMX------E---------B---------o---E-o---------------o-----?-----XB---------------o--------?----Mo-------o--M---------------------X-B------------------?BB--oX----------------X-----------Xv
------------------------BM----------o----------?B?-X-----------X---------X-?-----------------M------------------BB-XB------B---X---------BX-------?BM-------XX--------BBB---------E----X----M----------f
-EB--------------------------BBB---------------B--------X-----------XXB---XXB-----?X---oM--XX--------------MB--X-----------?--BXBMB----X-B------------BXB------?BBB-----XB??----B----BB------?---------f
------------------------------oBMBB--EB--------------------------?X------XB--------Bo?-------------B-----------B--X--B-B---B---X----------X?BXBBX-----oXB-?----B-----oXM-XXXB--------XB?-------E----B-Bf
-----------------------------Bo-------------------------------X--------------B-BB---BM-----BB---------------------------------?X---XX-----X--------X---------BB----------------------------------?BB---f
-----------EX-----XBMo-M-----------------------------------oB-------X-----------X-----X?-B-?X-----o-------------------?BBB---------------B-X----X?B-MM--------------BX?B?BB-E--------X---XMB?B-B?----B-f
----------------X----------------oB-------------EMXB------------------------------------------MX------------X------X---X--------X-----?-----------------B----T--------------X------------------o-------f
m------BB--X----BB---BB?-X------------------------XXM------B--B-----M---------B----------------------------BXB--X----T---?--------------B-----------B---o----B?-----B--o------T------B-----M-----------X
X-----------o?---oX-X---------------------B---------B---------B-----E---o-----------?E----X-----X--T-----------------|?B--------------X---?------------M----------------------|-------EX----M?B--------X
XXXXXXXXXXX-XXXXX-X|-XXXXXXX-XXXXXXXX-XXXXXXX--X-XX|XXXXXXXXXXXX-X-X-XXX--X-XXXX-X--XXXX|XX|XX-XX---X-XXXXXX-XXXXXXXXXX|X--|XX-XX-XXXX-XXXXX-X-X-XX-XX-|XXXXX-XX-XXX-X|XXXXX|XX|XXXXX-X-|-XXXXX-X-XX-XX|
