--------M-----BB--------------------XB---------BXXMX-XE------BB?-----------BBM-BXB------XBX---------XXXXB--------------B----------------oXMo---------------X---------------------o----------X-----------
---XB-------------------------BBXMBM?XB-----------------B---XX-------------------o------------X-----------------B--------B---------XX?-------------------------------------------BXX-B------------XMBBXM
-B??B?----BB--------BBBB?XX-------------B---B----XMBE---X-BXBM---E-----XX--------------------------B-------XXB-BBBXX-X---------M?oB?BB----------------------------X---o----------------------------BX---
-XX-BB--------M-------------------------------------------------------MB?-------B---?B----------X--------------------X-----XBB---B---M---------???--B-----?---?BX----------------B--------o?------------
--------------------------------BXXMXB-BB---------------XB------------------------B---XXB-----???XM-------oXB-X---------------------X-BX----------X-----X?B-------B----?BX-X---?X-BM--------------------
-------------------MB?BX----?---XX-??BB----oM-------------------------MB--XBXo?BM-----------------oX--------------o------------EMXB-------------X-------------------BBBBB--------M----------X-----------
---------MXBXXXXX---------?M------------X---B??XX---------?M--B--?-----------EBXBBB----?BM?---------BXBX-----oX-BB-------------------------------------------------?-----------BB?-----------------X----
-------B-----------EBB-------XoXB-BXX----------M---------------------MBM--------------------o-------------BB---------------X-----------------oXB----B----------------------?---------------------o-----v
--------------------------------B----BXBMM?XMX-B-BBX-----------------BMXB--------???------B---XX---oBMBXB----MMBB-BB?---MX-----XXM-E-----------------------------------------B--------------MM------X--f
B??---------M-------------------X?B-------?-------MMXBo-----MB---------------?X--------XXBMBXB-----------BBBXM----------BX-------XMXX---BBX-X--XX-----------B------M-B?--B------------B----X??---BB--XXf
--------MX-----B?BXBXM----------------X--------XX---oX-XB---oX--------------------BoBXXEB---------------BB------BBMo-oB---?-XB-----BB-----------------B-BBM-?------------XE--oMMB----------oXX-oB?-----f
---------------X?B-BXXXX??BB---XBBBM-----M?----M-------M?XMB?--------------BBBBB---------??X-B--------------------------M-------------MB---------XB-----------------------------------MMXM-------------f
------------------ooX?--o-------------------B-------------------BB--------------M-?B?X-XX------------------------EB?----------?---BBBBBBBX-----------------------oXB-----------------------------------f
------------?------------BB--------------------B---------BBB?--------XXX---XXB------------------------------------B-------?oX--------------BB---------BBB-----------------XXB?-------------BBB---------f
m--------X--------BBBB?---X?B------BX--B-----MX----BBB---------------------X-----B-BBMM----BXM---------BX-------BBB---B----M---M?---B-B-----MBBX------?MBXX--------------------------------------XBB?BXX
XXBX----X--EXB--------------------MMMB?--B?MM------?-----------MXBBB?---?-------------M--------------XXBB--B?BB----------BB---X-?BX-MoM--------------------?--XX---X--?BBMXB-------------?---X-XMX-----X
XX|XXXXXXXXXXXXXXXXX---XXXXXXXXXXXX-XXXX-X|XXXXXXX-X|XXXX-XX-XXXXXXXXX--XXX-XXX|XXXXX---XXX|XXXX-X-X-XXXXXXXXXXXXXXXXXXXXXXXXXXXX-XXXX-X-XXXXXXXXXXXXXXXXXXX-XXXXX|XX-XXXXXXX||-|XX-XXXX-X-XXXXXXXXXX--X
