----------------BB----------B-----o?X-----------MB----?------o--X?---?oX----------------------MT?-BB----M-----BMBX-XM----------XX------?------------------X-----BB------B?--?----E----------------------
-----------------BoX------T------------E-----X-----B--------------------?--XXX-o------BB-------BXBMB?-BM--------E--------o---o-------X----B---?------------------------------BXXX-----XM---?X-------X---
-----X-B---------XB??-----B-BB------------------T-----------M-------------T---M----M----------------------------E---M-------XB------EX-----------------------B----oB-B?---------------------XTX-X-------
-----------------------T-T-X-B------o------EX--------------?------?XX-----X-------M?-------------------B---BB---------------------------------------XXB-----------------B--?-----------BoXBB-?XXXXX-----
--o------BB---BBXBBo?-----------------T------------------------------------------T---------------?---------XT--------------------------?B----------oB-------------oBX------MM-----------XBB---------BX--
X---M------------o---------o--------BB-------BB-----BB---BMX---BX--XBB-----------|---------o---X?-----------------XX----------B--BBX------------TX--BXX----------?BBT-EX--------EX--------EBX--MM-------
-----------?--MB------------TB---------------XTXB-----B-B----------------B--------------B--T-------------B--------o?------oB-------XE----o------|------oX---------------------X---------------------X---
-----------------T--------T-----------BB-----B------------BXX--BXB------------------B---o---MBXX-----------------------X-----oBo-----------------BB-B-o-BB---------------T---------BBXXB--X?-----MMMX--v
-----------------|?-------|BX-----X--------------------B------------B-MXB-B----BX-------M---------??B----------XBBB---BXX------?B---B-----X--B--?BT---------XXX-MBXM?--XB-XTB-------M--BM----BX-------Bf
-XXBBB-----XBM?B--------------------------B--XoX--------oX-----BM-BXE------o?XBXBB--------------------o-------------T-----XX-BB-TB----------------|XX?--XBBB---T-----MBB---XX--B-oXoB-BXB---------o?B?-f
----------------?---T--------E---B------MB-----------------MX-----------------------------------MB-----------------XBBXX----------------X------------M-M-------B-------------o----BM-----EM-----B?-----f
------XX-----X--oX--|BXX---BB-oo----------X-------------------XXB--------o---TTT------XB-----X?---B---------------X?-----------------o---XB-----o----XBB-BXXB-?----o--B--XB------MBXB------------------f
------------X-------XB?MM------XBB-----------X------------------o--T--------E|||M?--oMX?---------X--XMBX?B---------oBX--------------------------B?------B------X?B------------TXB-----E?X-BX-----------f
---------BB---E--------?------oBX----B------------------------oX---|----BM--T----------?X--------X--------------------------ToB--T----------------BBB?--X---------TBX-------------B----B--T?-----------f
m--------BBT?---B?---X---------oMM-B-BoXX-----BX-----BB--XMB-BB?M------MBB-?BM----------------BXB--MB----------BB----XXMBX--XBTX-XB--------------?BXXBB-----------|BBB---------MX---------|-T--X-------X
--------------------------------X-B?BXX--BB?X--------------X---B-BB-----EoB------------BB-BBB---------------------------------|----------?----------------BB--------BXXXXXXXX---XXXXXMX-XXXXXXX--BX--XXX
XXXXX-|X--XX-XX-XX-XX-X-|X-XXX--XXXXXXXXXXX-|XXXXXXX-XXXXXXXXXXX|XXXX-XXXXX--XXX-XXXX|-XXXX--XX-XXXXXX-XXXXXXXX--XXXXX-XXXXX--X--XXXXX-XXXXXXX|XXXXXXXXXXXXXXX-XXXXXX-XXX-X-X-----X-|XXX-|XXX|XXXXXX---X
