--------------------------------------------BX-------XXB-----MMBB-?B----------BXXXB?-------------M---------X-----------o?-----XXX?-------------XM-----?MMXM----------------------XXM------------------X-
--BBXXB----BB---------------------??X------------------?B-------B----?---------------?XXBBBBXMX?X------------------XBB--oB-XX--------?-------M?XooX---BX------------------------------------BB-----XBX--
--------oB-----BXXX-XM-----------BX--------------------M-------?----XXX--------------B------X-----XXX----------?------------?B?----------------BBoMXXX-----X------------------------?B?B---------B-o----
---------BB----XM------B----------X---------XB?BB-------------B--B--EB-----------?BX----------X-----------------------------------------X-----?B----BB-X?B--?-------------------------BBBXB-B-BB----oB--
-XMMB?B----------------------------------X?BBB------X-BXXB?----------------MB-------------BBBMX------X------------------XXXB------?XXM------------------oB--oBM-----------?---------oBBB----------------
-------B------X?----------------X?------X----------o------------------BBX--oB---------------------------------------------X-----------------------BBB---M?X??-XBB---------B----------M------------------
--X--BBB---------------------------BBB---MBXX-------oBBBB-------------B-E?-------------------X---------XX--BBBBXMX--XX-------------------------X-----XB----MXB?BBB--BB------B------------------X-X------
---B--------------------XM-----BB--MX---X-M------------M?--XX------------B------------BB---B----?BB----------XXX-----------------------???XB------------------B?BB--------XBBM----------------X?XB-----v
--XM-------XXM--------XX------------BX----------XBB?-------------??--------------XoBX-------B-------X--------X------------???------------------------B-------------------------BBBB--BBB-------XB------f
o-----BBM---------------B?X---?XBBB--XBXB--MB----o--------------BBX-----------------------MM-------?BBB----------E?------B------------------BM------------XXXX----------B---------------o---B-----X-X--f
----XX--XBB-XBB?B--X------B---?XXB---BB-----------B-----------------X-----------M----E-BBBB?--------------------------------------------------BBBX-----------------------BBBB----------XBB---?BBX?-----f
-E---------------XXX-------------MXB------------o-----??M--oXB-------------?X------MXBBM------X----X---BB-----------?X?B-?----------------------------------?--------------------------B?B--BXEBE?B-o?-f
-----------XMBMB-------?--------------------------------BB?X--?B------MBBBBX--------MoB-------MX??-B??------------?B-------------------o-B?---------M----------------?B-------MXXB-------------XBBB?X--f
-------------o?X-----BBBMX---------------B?-MBXX----------X----E?-------TB?B------------X-----------B--------------------XBBBB----------X----B?---XBXMBB-----------------------M--T------------BB-M----f
m----XT-XXTX?BX----XB-------T----XBBTBB-----TBX----X----B--X?---------E?----------X------XMM--MB?T----B-----------XB--T?----TXXB-XTX----TXXXT?--XBBM---o---T--------?B----BB-BB---|---T-----B---BX-----X
X?BXXX?XXXXXX--XXXBBBXXXBBBBB?BXX?XX|BXXXBBXXXXXXXXBXBBXXXXXXXX-?XXXXXX-BB--XXXXXXXXXXXXXXXXXXXXXB?BXXX-XB-MBXXXXXXXXXXXMBXXXXXXBXXXXMXXXXXX|XXBXXXXXXXXXXXXXXX-BXBXXXX-BB-XXXXXXXX-XXBBBXXX-?-XBXXXXXXX
