---B---|-BXo----E-Xo------X------Xo----X-----M---|--B------M-X----o-X--------E--o-X------E------BMXXB------------X--X--X---B-T------B-------T-?-X-B-X--X-X-----X-----------X---X-------XT----X-B-------X
-o---X-----E-------o--X-----X---X-X---XEE-o----oB-----?---------------B---------X---o-----E-------X----XX----X?----------B---X-----X-----o-o--ME-----E--------------X-BX--------------E--B---?-------X--
o--------o?-M------o-----M-----o------?-?---X-E-X-------E?E-o----M--Xo-X-o------XX------------X-----Bo----X-------oB---X---X--X?---X--------BXX---X---B--?-X----XX----X---X----E--------------X-o-------
M-X-X-X-?-----o-o---------B--------------???----------o----oX---XXo-B------XX--X---X-o---B-----?--?B-----o-X-----X-------XX---------X----------------------?---E---XE-------M-M-E------o---EB-o-----X---
---------o---o-----E-X-----E-------M--B-XX--X-?MX-----X--?------B-?-X-------?E-M---EX---oB-----o-E-?----------B--oX-X--------X----E-X-X--X?-E-----B?X-?o---B----X----X---------X------------o-X?-----o-B
?----X--o--EEBX---X--?X--E--X-X-------X--------X--Xo--oX----X----------B----X-----B----X---?---o-X-X----E-oX-----E---oX---------Xo--X----X------o-X---------X------X-X-X---X------B--X-X-------------X-?
-------------------X--?---X----o----o---E----M--?---o----B---------E---o----X-B---XEo-----------o---X-------B---o-------o-----X--EXB----o-?X--------X-------B---?-----M-------?ME?---X----------------X-
-XX-B----M-BEB----------------E--XB--E-------X--X-E-M---MXXo-X-X-E--o-EXo---X------X-X-X----------MM-o--X-----------o--?-----------------X-B------------XE------------XX--------X--E------B--------oB--v
-X----B?--X----------------------o---------o-B----------X-X----BB-----XX---XB--------X--X---E-X-------E----X--------------XXX--------------oX-----E--------?----------B-------X----X--X-----XB---E--BXX-
-X---X-----?--------X----o-B--------------X-------X-B--B------BB---------X---X-XX---?------B----X-X---------?Xo?-EB------E-?-B---X---X-?-----X-----------X------X-X-----oX---XX-?-------M--X---X----X---
------------------------------X---o-X---------o--o-----E----o-----------?X---------X--?-o--------------E-----B---?MB-E-o---?---o--E---B---E-------M-B--E---o-M----B-----X---o----oo-------X?-X-o--------
----o-X--E-o------------XoE-B----X?---XX-X---X-----o---------X-B--E---BMX-X----X-----o-----?----BX--o-X?M---X--M-----X---X----X--------o-----X---------M-o----B-X--X------X--X?X---M------------X---?---
---X------XXo---E--------------X---X-X?------X-X-o----BB----X-BX------BX----E---------X-------------X-X---X--------o-----?-X-----X--------------o-XE----------B--------------XX------X-?-B-----------X?-
o----o-----X--X------------X--o-------------X?-X----E-M--X--E----------------XX-E-----XBo?------oX-----BE------------B-------X--X---M-----------X-X----B----E--X-X-------?-X-----------------X----?-XXXX
mo---|----B----X-oX-B-----o-B----------T-o---X--------X--X----M?--Xo---|-X--o-Boo-------------------X---oE-----X-XX-B---oo---B--B-??-?-------E---|---X----XX----X---X----o----XX-X----?--B--X---X----B--
XXXXXXXXXXXXXXXXXXXXXXXXXXXXXXXXXXXXXXXXXXXXXXXXXXXXXXXXXXXXXXXXXXXXXXXXXXXXXXXXXXXXXXXXXXXXXXXXXXXXXXXXXXXXXXXXXXXXXXXXXXXXXXXXXXXXXXXXXXXXXXXXXXXXXXXXXXXXXXXXXXXXXXXXXXXXXXXXXXXXXXXXXXXXXXXXXXXXXXXX
