oB---------o--o---?------------X-----X-----Mo---XX-------------X-X---B-----M---B-------XX----X-X---M-o?-o-----E-M---X--M---o---o-----o---X-o----------X-X----|----B----X--X--X-XB--o---o-X----X-----B---
-----ET-?oX-------?-----------|-B---------------X-?--E---X------XX---Xo----o-------oX--E---------?--X---------------------------o----o-X--------------o-X--X--?-o-B------|-------X---o--------o-----o---
---B-----B--B--B-E--X-X---------oX-----------B-X------X-----B-------X---X--X--------o---------E-----o-------?----oo--Xo---E---o-----oXX-EBo-|X---X-----E--XB-o-oXB-X---Eo---------?----X-|XXXX------X--X
-----B-----X---------B---XX-E-------TXB------?--X--X-X-o-----o---X---------oE-o------X-----X--X---?B--XX----------------------?o--XoM-----X------------X---E--o-----B-MX--B----o----B-----E-?-X--------M
----X----------------------------------B-X---------------|-?XX-o----X---?--?------------E------B-B-X--------B--o----X-o--E----------X----------o--X----BXB---------|---X---M--X--?------oo-o---|o-X-----
--X-X-------M----XXXo---X-B----o------X-X-------B---|-X-BX--XX-----Mo--XB--------BM-B--|-X-X----X------X--oTX-----XXo----?--X-o-?Xo-----------?--X-XB--X----BX-X|-X-T-M--XX--------To-E-------X----o----
---XX------o-----------------XB-----MoE-o-E--X-?--o-o--B?E-------|----------oE-XX-oEE--?XoX--XX-X-X-|------X-X----X--------------o----------?---o-T-BM--E----------X-oo----X---------X--B-----oBB--X----
--B---------o----?---?-----E--?----|E-|---X--E----X--oB----|--X--|-------E-oX----X-BB---------BE-------|------B-----|?---------------------XB---------XT----X------X----o------X-----T------XoX------o-v
X-------T-X------X----B----?T-X---X------Xo--B--X-B--B--E----o---X-B-X---------------?----------------------X-----M----E---------X--X-BE---XX---o-M--?-----TX-X--------E--B----B----XX---|-XXX?EX--B----
-----------X---T--X-X-------X-X------B------X--------X-----?-----X--X--B--------M-o--------XoBX--------o-----TB--X----o-X--o----oMo------------?---------EE|---X-Eo--X-E-X-XXB----E---E-------E|---|--X-
-------oo-B|---------XB-X-?--X--E-|--?-------------B----X----XX-o------------?----TX-----------B--T---X-?B----X-X-----E------------o--E--?-X--------------X?------X--BX-----?--X--B--o---B--T-X----Xo-T?
--X--------------?----oXo--X--------?-------X-X----E------?-B------X------XoE----Xo-----X--o--E--o-|----X-XE--X------o--------------oBM-----------X---|X-XE-B-?---X----X----MXX---M---|---XX-----X----oX
-X-------BXXXM----X---?X-X------B---BE------------X------?X------Xo---X----|XX-B-------oo--------X---o-------XB-----B----XX-------X--o--X------TM---??---------o-X---X-------X-X--?-X?--B---M-X-|TB-X---
-?-X-------------|----?M-Xo---X------B-----oX-B-----------E---?XB---o-------X---B-X---------o-------XX-X-E-----EEBXT-----X-----X--------B-X-?T--XMX-EX-?|----X--XX--XXE----o-o----X-----B-------X-E-o---
m|||||||||||||||||||||||||||||||||||||||||||||||||||||||||||||||||||||||||||||||||||||||||||||||||||||||||||||||||||||||||||||||||||||||||||||||||||||||||||||||||||||||||||||||||||||||||||||||||||||||
XXXXXXXXXXXXXXXXXXXXXXXXXXXXXXXXXXXXXXXXXXXXXXXXXXXXXXXXXXXXXXXXXXXXXXXXXXXXXXXXXXXXXXXXXXXXXXXXXXXXXXXXXXXXXXXXXXXXXXXXXXXXXXXXXXXXXXXXXXXXXXXXXXXXXXXXXXXXXXXXXXXXXXXXXXXXXXXXXXXXXXXXXXXXXXXXXXXXXXXX
