--XBMXBB-------------------------------------------------?---------XB-----??BX-------------XXB----------------------B------------------------------------------XXXX-BB------------BXB---------------M---
-----B?----------MB---XXXX-----------------oBBB?XXB?B------------------------BBBBB?MBBBMMBB-------------oMMXMXB--o----------X-------------?BX------oB---BX-------B-----BBBX-----M?-----------------B---B
------------?B------------BoBBX------BB-XB?------------------------------------------XM----------------X---------MX-------BMBB---------------B--B-XXX-----------?-----MXB--MXB----X?XX---------------MX-
X----------------------------------B-----BMB?--BMBM----XXXB---?X--BBBXX------?BBBBXX-BBBB-?XB----XBXBX-----------?MBX----BBB---?XB?-----BBB--------------------------BBMBM-----XM-BBBBB-XXXB--?---BB?---
-XX----------MB----------B---------------------EBB-?MBXBX---------------------------?B----------------------------XXB-?-------------------------?BB-----?B?---------XX?BB----------?BX?B----------?B----
-----XXBM--------------XX--BB?--BB----E---MMX?B-?----MBB---MMBB--------------------------------------MM--------oB------------------------------MB--------MBBB----?----------------------------BB--------
-------E?-------MX?------------------------------------BEB----------------------------------------------------BB?----X-------M?MBX-------?XX------------------X?X------BXM----BXBXX---MBXXB-oB----------
-------------------?-----------XX?----------------B----?BB------------------------?B--------------XBBBXBBM------B----------B---------------------?M-------------------------------XX??-X----BXXBMX-M?EBv
------X?X--------XB?--------BBBBMM-----------B----------B-----B-------MBB---oB-------------------------BBBB-------------B?----?XXX---------------------oB------------?------XMXXBXB---BB----------XBM---
BB-?BMMBB--------------o-------B-------?-----------------------?BX--------XMX-------------------------------?-----------------------------------------BBB?B-----BBB------MB?--------MX------B-----------
------X?XM--------------?B----o?XB---------??XBXM---------------?X?E--------------------BXB----------X?BX------------BM----------------------XX--------------XBBB?--------------XoBM--------------------
--------------------------B?M----------------------oB?--------M-----?---MBB-----------------XXB---------------------??Bo-----XBBMB---oXXX----------------?B?B---BXB?-X-------B--BB---------------BBXXBX-
------?MXXMB---X------B?---------------------------------------------oX-----o-----XBXXM---------XX----------------XBBXM------------------------?M------------X-X----------------------------------------
----------------B--?B-------------?---MBX-------------------------B--BBBB---------?---------??X---oB------?--------------------------BB--MX-------------------?---?----------------X?-----TB-----------E
m-?--B?--MXX?XB---BBBB-----------T---------TXBBXTBBXBMX------B----------------TX?---BTT--T-----------------T--TM-----?----XBBX-----MB----B?-----?BBX----XX?-BMBBB--?BBB---?MB-XX-----EBBBX--EBT---XXXB?-
XXXM-BBM-XXXXXXXXX-BMM?BBBBBXXXB-|BBXXXXXXBBX?XXXXXBBXB-BBXXXXXXXXX?BBXXBB?XXXXX?XXMB||B?-?BBX-XXXMBBXBMM-BXBXXXXXXXBXXM-?BX?-BBMXXXXXXXXXXXXXXBBM?BBXXXX-XXXXXBBBXXXXXXXBB?XXXXXXXXXXXXXXXBBX|XBBBBXXX-
