E--------Bo-----E-oB----T----------?------------B---------o-------B-B--------E---------o---------------o----------?---E--E----o-B--E?----EE----?--o------------|------B-B-BMMo------E-------T-M---B---B-
-----------------------T---T-----B-----X----B--o----------T-------------B-------------------o--?o-B--------?-------?-----XB-------------|---------------M------------M-E----B-------------T-----------M-
E-o---T-----B-T|-------------?---------oB----B----o---------------E-----E-------o------T---------E---?|---------B-T-------M--o----E--B-------------?---o|--??------|------------|Xo---------------------
---X------------E--M-TB---------X--------B----X-?-oM----?-------------------o?---B-------------------------------------------B--------B--EE-T-------------B--------------BB------TE---X------------E----
--------------------------E-----|XM-----?---------------E-?------------T--E-----X--------T-----M------X------?---------X---------B-------M------E-------B---------------E----------o-----Bo-B-----------
-?--------Bo---E--M-------XM--?---E----o------------------------------------o-----------B--T--|------BEB-----X----------ET-B-||-----------------|-----?-------------BX-|----------?---------------B|-|o-
E----------E------?-------X---?-----o-------E-----------------M----------?-----o--------------------------------X----------------------B--------------?-----?------------------------?-B----------B-----
-----------o---------?-------------?E--T-|-----------o----|--------X-EXo-M--|----M------------oBE------EEE------Bo-------------B-----?---o--------o--------T--??E-T---MB-----E-|----T-----------oo-----v
-----X-----o---?--------------o-M---------------?-----o----X-B-----?-----B-------|------B------------T-----E-BB---B-------o---------E----o------o-?--------o---------------B-------o--B------E----------
-M--X---o-------E---?----------B----?-------?------------?----E----?--B--------T---E-T-------------X-----X-B---------|B-----------?-M--|----------o-----?--------M--------E-------B----B---B-----XE-----
-----------------M-------------?--------M-E----------------?-?--X----B------------o---------?---T----?-------------------X-T----|--|-----MB-----|--E---------------oB-------E-----X-B-----------------T-
------------------B---o-----E?-------X---|-E----o?-E--B------------------o-------T---------------?--o-------o----------B--------------?---------E----------E-o-B--M--------T-------------------------T--
T-B----------X---------------------------E-----?-------------------B-X-M---?---o--------B-----------------------E--?o-------------------X--------B----------?--X-----B---E-o-----|------BBX----B---E----
-E--E|----|-B----?---o---------|-------------B--------|--o---------------------?----E-?----?-?--X--TE----------------------------------|----T---E-----------------M--------------------B-----?----------
m------X------o---------------X---o-T---------B----E--E-------------------E---------B----------o-----------------|-----M-----E-o-----------------B-----------------MoB--X---?----------|B------M---BE---
----E----------B---------------o-B-------?-B---E--------------M----o-------o-----------------------o-------B---o---------o----|-B-------------------------------o|--T-?----------E--------?------o------
