----------B--X-B------?BB-------X----X--------------B---------o--------X-------------------XB--------------X?BBX-------------------------X-------------E?----------------------------------o--M---------
-B------------BM--------------?---------------------M--BX?--------------------o---B------------BM?--MM--------------oB-------------X---o---B---X---oM-B--oo--oB--------------BB----BXB------------------
---MM-----------X---?------XB----------------?-----------------------------oX----B-?---------oX---E--------------------XB-----MX-----?------B--------o---------o---------o-----XBB-------X-----------Xo-
---------X-B-------M?--B---X-------------------XXX----------o-------o----o--?------X----X-----BBB-------------X---------------MoBB--???------X--------------------?---------?X---------------------XBM--
--B?B----------------------------M-------?------BXX------BMMBM----B-----------B--------------X-X-------------------o-B-------------E?--------M------XBB------------------?BB-B-------M-X--X?----X-------
o---------BBB-------B-----------o--?---------------------?BX??------------------------o--XBB----------------------ooB----o-------oB----------------------XX-------------M?BM--XXB-X---------?X---MX-----
----oX------------------------------------------MBB--------------------o--X----B-----------B---X----------------------------------------------------oM------------------------------B-------------------
-------------------B--B----B-X?B------------BXXB?---------?------XX--X-----X----------------XB----XB--------------------------------------------XBMBB-X---MB--E---------------------MX-----------------v
---BX-------B--X-XX---------XM-----------???-E--------M-----B----------------------------------------------------------------------o-------------------------?-----------------------------------XMX---f
------BX--------oB---------------MM----------BB---------------------B----------o-----BBX--MXB------E--B--oX--------?M------------?----------------------------M--------X-------------oB------B---------f
----------B-----------E----B----------E----o-----o-------B---B----------X?BX---o---X------------------------o-------------------------M---------------------?------------------------E---?B-----------of
-----B-------------------MBX---------------B-------X-----BM-X---------------Mo--B-------------------B--------BXB-X---?-------BB-------?-------BX---------------------------------o---------?-----------f
-----------MX-------------X-----------------------------BX----B---?------BXo---?---------?-X-------------o---XXXX-----------------B---X----------------------------------X----BM------XB-----EXB----oXBf
-------------B---------------M-------------------------o------BB?---------Bo-------o---X-XBX------BX?----M---------------------?BB---------------------------------------BXB----?X--X-------------?B---f
m-----X-------To-?-B--------------------?---B----o--------------B--------XBX---------?----T--XB---X-----------TXB-X---------------------------EM--------------------BXXX--------------------------M----X
-X-XB------?B?|---------------BBB---?-E--M------BXB----?---X--X---BXMX---TBB----BB--TBB---M-----o-oTX-----B-B-|------B-----------------------------??---oX--XM---------TBB-------B---------------------X
XXX-X-XXX|X-XX-|-XX-XXXX-XX-XXXXXXXXXXX-XXXXXXX-XXXX-XX-XX-XX-X-XX|XXXXXXXXXXXXX---XXXXX|X--XXXXXXXX-XXXX-X-XXXX-X--X-XXX-XXXX--|XXXX-XXXXXX-XXXXX|XXXXXXX-XX|X--X|XX|X|X-X|XXX-XX-XXXXX|XXXXX--XXXX-XXX
