-----------B--BBX------------------B-MB------B-BM---B----B----o----------B--------------B-X------B----B----?BB-------B---------X---X----------B--------------?-------?M------------------EB-------------
---------------X?B--?X-----B----------XX-----X----X---M-------o--?B--M-------M--------X-------X-------------?-----BXBB------------?-----------------X------------------o------X----BBX-------X----XBBB-M
---------?--------o--B?-------?----------B---------------M----X-B-B-?B--X---E-------B---------------B------------------------------------oX-------------M--------------------------o--------------------
------B-------?X----------------------XB---M--------------o?-----X---o-BX----------o?----X----?oX-----------------oB----X?X---------MX-------M--------------X-----------B--------B-----------oEX-----MX-
--M--------E?----BXX---------?--XXX---MX-------o-----o-o-----------------X--o-------------------X---------X-------E?----------?-X-------------B--X?-o---X-------X---XX---BBX------------------?--------o
-------Xo?---------------------------B---B-------X-?-----------X---------------------?-------------------o--------BBB-------------------------------------MBB-B------BXX----------B---------XX----B--BE-
----------oMBBX----------------------------------------B----------M------o-------------B-----X-------------------------------------------?-----------X-X--------BBo-X----X-------------------?----------
-XX------X-------------BB------BX---------------?B--B------B-X--B----------------------Bo-----B-BM----------XX-----X--BBX----------------------X-X----o-------oM-------X--------------X---B-XBBX---BBX-v
------?-X----X?----XB-----------------oBB--o?oB--------B---?-----BM----------XB-----MB----XX-----------------------B----BX-----------BBX--------??BX----?B--------BBXXB-B----BB--------BBX--------?----f
----------B--B--------------------------------o--X-------MBXX--------B----------------------o--------X---E---------BX--M------B-------------------------XXBXB-------------------B-------------B---XoBB-f
--------X-----------------------EMB---o---------XXB------------------------?----------BXB---X-------XB-BX--o-XM--------BMB----------------------X?------------X--MB------------B-----------------------f
--------------BXBBBBB----------------?M-BB-------------------XX?X----BBBB------------Bo??B?-B------B-----B-B----XM?-------?-BMB-E--------------XB--------------o------M-------------X--------XBX???X---f
--------oMX--B--------------------------X-------MBBBMBBM--------------??M-----BXX--o?X?X-----oBBB-----------------------------------oB---------B--oXX--EXMXM-----------BBBB----------------?B----------f
-----------X-X---------------X----XX--------------E------------------------BB-----------------------------------------?----------------------B------X?B--M---------BBXB----------EBBB----BX----oBB-----f
m------------------------------------------E--X--------------------T--------M--------------------------M-XX---BB---o--XE---BBB-B------B-M---------oB-------------B------M--------?-----B-BB-------B?---X
---------------B-MoXB---o-----------------------------o?EX--------oB---------------XB-----oX---------B-MB--------------------------BXB--B--?----------B-o----------------------------BXX---------------X
XXX|--XXXXXXXXXXXXX-XX-XX-X-XXXXXX--XXXXXXXXX--|X-|XXXX--XXXXX---XXX-X----XXX-XXXXXX--XX|XXXX-XXX-X-XX-XXXX|X-X-X-XXXXXXXXXX-X-|XXXX|XXXX|XX-|X-XXXXXXXXXXXXXXXX-XXX|-|--XXXXX-XXXX|-XXXXXXXXX--XXX-XXXX
