--X--------?-X-oX--o-X-X--X---M--o---X?--------XB--o-M?---------?------X-E--XB--------------B-XM---X---X---------B---------X-BM-o---------------------oX---?--o----o-o------X-?XX----oX---o----M--------
------T----------------o-X-X-X-------o---B----X?----X--X-E---B-o-----oM-------X-----------EX---------X-X-------E-X---B-X-?o-B------o----X--------MXX--------Xo------o---oX----E-B------------o-B-----X-o
------|---BX-E--o-B-o--X-------X---oB----------X-XB-Xoo---------B---X--------o-o--B--X----o-EX-o-?---BE--E-X----------------------------------------oXE--B-B----X------X---?-B-?-----E--?-----X-X---X---
------|-------B----EX-?--E-BX----?----X---------X-o-----X-----X----X-----B-o-X-----oXo-o-X-------XX-----X-----B---oM---Bo---------------------X-----M-X--------X----X-X------X-----X--X-------o--B----?X
X----E|BX-X-----o----X-----E-XX---Bo-X?o-BXX------?-----------------X---o------X---X----oBo--X-X---------------X-----X---------------------B-----o-----------E---X----------B-X-M-o----X?B?---X---------
EX---M|--?BX----E------B-------------o---E---XX------X--------X-X-M-?-M--------X--oX----------------o------XX--X------o--------E--X-?------X------E------------X--B-B----X------------------B---X-----X-
--X---|---M--E--X----------------------o----X-oo-X-----E---------o---M--X---B--X--B-------------XE--BX----M-X--X----o-XX--o---------------oX-------o--X---------E--X---X---E----XB---------XX---E-XoX--o
------|--X---X-o----X--X---X--?-------X----B--------X--X--?----B?-o---------X----------------E--XX-E-----o-o-------o----------B-------X--B-----X---------M------------B-----E-?-------X--?------?-----Xv
-B---o|----X------X---B------X-M----------o--o---X--------M---?-BX---------------o----o--X-o-B-------?XBX--------o---X-oX-oo------------B----------------E-B-------X----B--o----X----------X--?-??-----X
--E-EX|-----------------X--X--o-M-------X--E--X--X-------X-B-Xo---oE-----B------B---X?----o-------X---o-------------------X--------------?----------o-XX-XX--X--E--E---oXo--B-X---o---?---oX-----?------
-X----|----?------X----------X--------E---B---X----E?---BB-?-----X-------B---B----X---B--X-X-X----o------------X-?E---o-o-o----X----o----------XX------X------------XX-----X-M-X---------M-M------B-----
B--o--|-----E--o------o---X------------?-----BX--X?-B----B-X---------X-----------------o--EX--M------X-----------B-X-XX----MX-B--------X-X-o-XX-----------o----X-----------M-----X---X---------X-----X--
XX-XX-|-XT---E-----------X--X?---X--X-E-E------o---X-------X-----BM----X--XX---B----o-----EX----X---X-----------B-----X-----o--o--E--X--XB---------BX--BX--B--------XB-X-?--------X-X---X-E-B-E------X?E
--X-Xo|--|o---------------BX-------X--X-?-Bo--M------B--B---?X--X-X-X----------X---o---------o--BX?---XB--o---X--X---------------o---o-o---X-X-oM-------------------------?------Eo---o----X-B--E--?B---
mB----|--|--o-X----o----o----oo--X-o?-B----EB-------E--o---?M-----E-X---B--BX--Xo----X--X-----B?X-o?-----o---?-?X-?-o-XXEX---------------MXXo--oX-----E-X-------EX------------B--X?--X-----XX-----?-----
XXXXXXXXXXXXXXXXXXXXXXXXXXXXXXXXXXXXXXXXXXXXXXXXXXXXXXXXXXXXXXXXXXXXXXXXXXXXXXXXXXXXXXXXXXXXXXXXXXXXXXXXXXXXXXXXXXXXXXXXXXXXXXXXXXXXXXXXXXXXXXXXXXXXXXXXXXXXXXXXXXXXXXXXXXXXXXXXXXXXXXXXXXXXXXXXXXXXXXXX
