----B----B--------X-oBX-o-------oX--------B--------o--Xo---?----B--------o-----B-----XB-X----------o-----------B-----o--o-X-------MX----X-----------B------X---------------X---XM---BM--X-?---------XX--
X-X---T--o---X-----X-----E------o----X---X--------X----Eo-------X------X------------X---X--o---------------------o-B--------X----X-B---E---------------B----------ooXBBo--------X--o-----X------------XX
-X----|---o------------o-----------------X--o---X----XX-------X-?---------oX--oE-----B-------oXB-X------B------------M---------Xo----------------oo--o-o---X---X----X-----B-------EE-o--oX---?XX---E---X
-X--Xo|--?------X-XB-----X--------------------M---------B----X----------------X----XE---X----X--------X-EX----E-------------B--E-----E--X-X------XB-------B-------E-----M--X---M----M-X-XoB--o-----?-XX-
---XXX|-X---o-?-----Xo---?---M--o-----X--X--------X---------Xo------X--?-E-E--M---------X---B-X-------M-------X-------X-?X-----o-BXX---X---X-----------X-----X--------X-X---X-------X-----B--o-BEX----B-
E---?-|-----o-X----X------o--X-X-----X----------X-E----B-BX--B--X----?---XE-----o--------XX--B-----o----XX--?--X-B----XX--X-EX-----o--XM-------o-XE------XB-X--------EX--XoX------X-X---M-X-----X-------
------|---XX-------X---X----o--------?---X--o----X---------BX-------?XX--o-------X-?X?o-----E----X----------------o-------oX-o--------X--X------o------------X---EX---------------M------B--------M----?
-X-o-o|---o------o--o-------------X--E--B---X---X---------EBX--------B-------E---?---X-------X-E---oX---------------X--oo?B-------BX-----B---o---B?X-E--X----B--B---------BX--X--X---------XXX-------?-v
XB----|-E-------B-o---------oB---X--B--------X-X-B--E--o----E------o?X------X?X-----------X--------------X------------X---oo---X-----------o--o----EX----M--o-E---X---o---?------------E-------oE--XX---
---?--|-Xo-----o---X--X--?-------B-E---o--E---o-----X-X---M-X--Mo--X---E--XB---MXX------o--?----E----XX-X-------o-------X-BX-X--X-------E--X--o--------XX-X-X---BXX?------X----oo----o-X-XX------o------
--X--o|X---X-X----o----X----X---o----------------X--X----o--X------X-X------o-X-XX-----E----------?--o---X----XB---E---?X-?-------?----------------X--------M----------------M------X----o-X-E-------o--
X--X--|-o-?--o----E-o-----X--?---X---o-----X-o----------oXX-E-BE------X-----o-?---B---B----X-?--X----?-------X---o-o---XBE-X--X?--X-------------X-------X?-----oX--X---------B--X?----?-X--BBEoo--XBX---
------|--X-X-X---o---o--------X------oX-------------X--?--o----?o--B----------X-----B-----------?----XXB---------E-----XXXB------X---------B---M-X-----X---------B?-E--E-XXXX-E--------X---B---------X--
BX----|-B|-----------E------X--X-X-------MXX---X----E--o----o--X-------BT-X--X----------------?------M---o-X---XB--B-----------------X------------o-X-X--Boo----X----oX---o--X----?-----XB-XTE--------X-
m-X--?|-||--oo--X?-M---X------X---------BX-B--o---?----XX-------X---?-BXT---B--------------XX-------E-------------o----X-----X-X------X--------o----------ME---------XB------------EXXX---o-T----------B
XXXXXXXXXXXXXXXXXXXXXXXXXXXXXXXXXXXXXXXXXXXXXXXXXXXXXXXXXXXXXXXXXXXXXXXXXXXXXXXXXXXXXXXXXXXXXXXXXXXXXXXXXXXXXXXXXXXXXXXXXXXXXXXXXXXXXXXXXXXXXXXXXXXXXXXXXXXXXXXXXXXXXXXXXXXXXXXXXXXXXXXXXXXXXXXXXXXXXXXX
