--BBBoBXBB-----------------------------------------------M---------BB-----o?X-----------------------MBB------------------------------------BBX------BBBB-------------------------BB----E----------------
--------------BB--------MBMB-??XBXB--------XB?B?-----?B-?M?BBB---oB--------?XX---XX---B?-BMXB----------EX--------BB?B------M------------------------B----B-----------------MBBB-------XBX-----BX--------
--?MB-----o-------------------BM--------------EB--BB----------------BMMoX----MXXB------MB--------------BX--------?--------BXB----------------B--o-BMX-----------XB----MM---BXB----X--B---------------MB-
-----------X?-------------BBX-----------B--------------------------?------------------o--oXX?B-B-----?---B--------------------------B--B-MX--BBBBX--BXXB??BB---------EX?B------X--?B----BB?BB-M---------
-----??--X?X?---BBM?-------------------------------------------B-EX-----------------B--------X?X--X----------------MBM????----o----------BoXB--------------------------------------BBXXXXBB-----------X-
-oB--B----X?BBM-------MB-BB--XBB----------XXXMM-X----BBB---MB-BMX---------------------------------------XXB----M--BX----------?X---------------X---------XBBB----?B---------------------------X?--?X----
---------------------------------MoX----------------------------------------------------------------------------X-------------------------??-BB?--B??X?M----o--XXXM----XXB----BX-------?X---------------
----------o-----------XM----XXXBBBBBMB--?XXXBBBX------------------------------B-BB?------BB----------?BB?B----------------------------------oXBB-----X-------oXX-B--------oBB--------oX----------------v
--------X--------??MMBX-----B?MB-----BBB------M----XBBB-?-------B-B-?XX-o??------B--------BXX------------------?XXB-o?X?------------XX?-------------------------MX-----------------X?B------------------
-------------------Xo--BBXBX---------BBB---MB?---------XX------------------------------------------------------------------------------------------------oB-------?XXXB?------BB--------------XXXXB-----
----oo??B---------------------------------------------------------Bo--------------XMBB----?XBB-----------BX?---?BB-------MX-------------XM------------?BBBB--------BB?-------?X------o------XBB---??BXB-
MBB--BB-------------------B?MB---------------------oXB--------B-----X?B-B-------------------M---------------------------XMM---------------oX------------?oBBX----------------------BB--X--BBX-----------
--------?-----------??--------------o-----------BXX----------------XX--------------------------B----------------------oB-------B------------------?BBB--------BXX---------------------------------------
-----?BBXB------BT-MBM------------oB--?B-------------------??-------------------?XBX------------------------------XX------------X?BX-----------------------B-------------------------?B----------------o
m-MMXXBXMMXB-----|X??-----------------BX--TT-----XB----BXX--------------------MB----?B-------------MM------TB------oX--X?TB---------------------BBX----BXXBB---BM-----------------------X-B----B--T----o
XXBMXXXXXXXXXXXXXXXXX?XXXX-XXXX---B--XXXXXXX?BXBXXXXXXX-?M-----XBXXXXX-XXXXXXX?BBMBBXXXB--M?-BXXXBXXXX??XBBBBXXXXXXXBMXXX|XBX-BXXXXXXXXXMXXXXXXBBXXXXXXXXXXXXXXBXXXXXXXXXMBXXXXXXXXX--XBBMBXXXX?B?BBXXX-
