-o---------B---X-----XX--X---o---X-----o?X-X-----o--?Xo-------X--X----o--M------o--------E--X------B-X--B-------o-------B---E--X--o---o-----X-EXo-B---o--o-o----------o?---B------X-oM--------?-B-o----B
------T--X------o--M-X---------X--Xo------X---------B--o-?-XXX---------oE---Xo--X-X-------X---X--o-X----o-----?--o------?E---------X--X--X----o---X?X---o----M-E-XXX--------E---?--?E-o-X--X--oo-----B--
-X-o--|---B-X-B------------o----X-o-o-------X----X--o--XX-o-----B-o--?-oXX------------o-X--o--------------------X----X---X-------X-------X-X-------B?--XBX---X---X---XX----EEX-----X?-?X---------X------
X-o---|-X----o-EX--B----------------X-E---BM-o-E----XoB-----X--------Xo-oo-E-X----X-----M-o-?o-----X----------X--X----o--o-X---------X-----XXX---E------o----o--B----B-----------o----------X?----X-X?--
o--?--|-XX--------o--o-XBX------X---------X-X---------E-M-----------X--X?E-----X---o-B----B-----------X---?-------X-X-oX---------E-------X----EX-----X---X-----?-------X-----BoX-o------X------X---?----
-----E|--M----------------o-?-----------BX--B-------o---E------------B--oE---?----X---------o-E---B---?X--o--?-X-E----oo-----o-XXo?--X----B-----X-------o-----------X--X--X-X-----X------E-?-E--E-------
----B-|---------E-X---------X-X--X----------------X-B--?----X-------B------?---X-------o---B--B---o-o----o-X---B---------?XB------------EM-----------EX----X---X------X----------B-o---X----?-------X---
---X-o|--o-X-oEX---X----X-----X-----XBoX--o------o---X---X-B----X------Bo--?-o------M-----X-X-------B---------XXo---oo-X-B--XM?---X-------?-E---X-?-----?--?-----------------o-?----X-BXo-------X--Xo--v
--X---|--XX---X-B---o-------E--------------o-X--X--X-X--------X--------------B---o-X----?E----------B--B---X-------B---E-------B-X------X-X-o--------oo------------XX---?--------EXoX---o---?-X-E-?-----
------|?-o-------X-BX--B--X-o?-o---------?X---?-XE-------B--oo---XX------B-------XX----------X-------B------X---------X----X--------B--?------X---------o----------------------------X-----X-------X----
-----?|-M-?---X-E-E--X--X-----XX--E---o---X---------X-B------------Bo---o----?--------X?-----X-XBM---o-o------X---X-------X---X---o--B----o-E-X-B?--X-----Xo--X---?----o--X---o------------E-BX---------
------|--------BE--------------------X-o--------XoEXB-B---?--X-X?-Mo-X--X--B--------oXB-----X----o-------XXX----?--X------o----XX--X-----EX----E-M-?--B-------X-X---------oX--------M-----Xo---oXE---??-
-o?-E-|?-T--?-oB-X---X?-------------XE-?---X-----------o-----?----X----------XB-------XX-o-----------X-----?-o----B----o------E--MX--E------E---X---------o-B--B-X---E-Bo-----------X--XX-X-----?------X
o-----|X-|------X-BBo-----X------------E-o-?---o---B-X---o--X------X-o------------X---XB-E--?--X--------T---E-----------BE-o----E-X-----E-----MX-----X--??X----TX-X----X----o-------X-B-X---------------
m-----|oo|--XM--------X-----oE--------EB---------XX--X---X---?--------EXB----?B-X-XoB---?-X-M-------X---|-------X----------------o-----o----M-B------X----X----|-------------?------X---X--?------Xo----
XXXXXXXXXXXXXXXXXXXXXXXXXXXXXXXXXXXXXXXXXXXXXXXXXXXXXXXXXXXXXXXXXXXXXXXXXXXXXXXXXXXXXXXXXXXXXXXXXXXXXXXXXXXXXXXXXXXXXXXXXXXXXXXXXXXXXXXXXXXXXXXXXXXXXXXXXXXXXXXXXXXXXXXXXXXXXXXXXXXXXXXXXXXXXXXXXXXXXXXX
