-X-Xo---XoX-----?-X--------MoE?o------------X---XX--X----o----XB-----XXX--------o---X-oX-?B--------X---E-----E--X---X-----XX-------X----XB-----o-X--E--?--B--------X-----B---X---X---X----X--X---------o
X------XBM-XX------o------------o----M----X--?----X-----B--------X-----o------E---B-Xo-?-----X-----E--------X------B----E-------E------M---?--X-oX---------------?----X---X---------------------o--B----
-----M--XX---X-BE-o------?-X---XEX-B---------XX--E--B-------o----------oM-X--?-----------B-X--X-X----X--------MX----E-X-----o--X-o----?X----o-------------oo-----------------XE--XX----X-?---?--B--XX-B-
--------X--X---------X-?--X-M----?---------X------BXX------------------E-?-------X?-----X---BX-o------E-----X----MX----o--E-X--------X---X---X--o-B--E---?X-----o-------------o-------?--X----------X--X
o------B--X-M-----?------------X---o----?o-oB-X----X-X--?-?-B---------B----X-----o------?--------?--------X---------o-----E-------X-----X-o----------X-X---------oB--ooX---------B-X--------E------X---E
-X-XX-----X---o----X-?-------X-X-o-------X-----o-X---------------B-?----X-X--------o----------X----oB-----o--------?X------X-Bo----MX----X--XXBMX----E------oBX--??------B-X---------------------X-----B
-E--XX-ooB-----------X---------------X--X-----------E--XX-----------o----o-X--E-------------X--------X---X--o----o---B--B-o--B------o--o-------B-------------X-X?--X--Xo-------X------Xo---E-E-----X----
X------?---o---Xo---------------------E--------------o--BB-------X----------?-?BXE-X---oo---X----o-------------X-----BX-oX---------E-?----?----E--?-------------------------X----M-XX----EB----o-X---B-v
----------------------------o------------?o---------X-----B---oX---?---o-M--------X--------------X--o---X-X---------X-------------X-------------o--X-----XX-X----X-----B--B----E-B-Eo--------------X---?
X--o----------o---X------------X---------E--B-o--o-oX??-------EXXoX--?-oo-E--o--X--B---oB?--B----EX--XB--------X---X------X----X------X-o------M--X----------------o--BX----X---X------X---------------X
-o--------------------o--------XX-B--X----X--X------E-X-----o-o-E------?-E----------XB--M-o--------BMX--M---?------X-----E------o-BBX-o-------E?----------B-----oX------------o-XB-X--o----EX--X-X------
X-------oE--o----X---------EX--------------------o------------?------X-X-B-B--?X--------?-XX----X-o-----X--E-B---X----X--------X------------------X--------X-----X--X--?----X----M-X-----M---o-o-X------
---X-----B-------?----o------?--o-X---X---X-------X----X-Bo------X---X----------X?-E----X------o-X--X-------------------?--X-B------M-------E----X---X-X-XX--XX-----B-X-?---------X----o-------o-----X--
--M-----------?o--o--X-----X?-X--E----BE-E----?-------B-o---E--------o--X-X------o-XE-?--X--?----XB-----X-?B----X--------o----?---M-X----o-------------------XX-X---E-----------B-------?-B----------EX-
m---o---X----?-X----B---------B--------XB------o-X--o--B-MB-X-oB-----------X-E------------XE--B--B--X--o-o-Xo--------X------X---X---------X-X-B--X-B-----X----X-oX-B----X-------X----------?--X-------XM
XXXXXXXXXXXXXXXXXXXXXXXXXXXXXXXXXXXXXXXXXXXXXXXXXXXXXXXXXXXXXXXXXXXXXXXXXXXXXXXXXXXXXXXXXXXXXXXXXXXXXXXXXXXXXXXXXXXXXXXXXXXXXXXXXXXXXXXXXXXXXXXXXXXXXXXXXXXXXXXXXXXXXXXXXXXXXXXXXXXXXXXXXXXXXXXXXXXXXXXX
