-X-X------------------X-X--------B-X---XT------o---?E--X-X---------X-T--X-X--X--o-o----E------XoE----?-----B--------o-----X---o------------oX-T--------X---XX?-BE------------B----------------E--------E
-B--B------------X--X----BB-----?-------XB-?-------?-----X--------------------X-E------XE----B---X-E-----BX---------o------X----------------o--------BX-------o--BTX-o----XT--B-M---X-X-------X------X-X
XEX-------o-B?----------B----o|o---BE?----o-X-o--?--------X---------B----X?--Xo--------B-oTX-o--o-B-B--XXX---X---X--E----------XX---B---------------o-----E-----E----X-?---E-X-M-M--------E---oBTX---E-o
----o-------B----X------------X--X----XX--X----?------B---B---------o-----X--?-X--------o-B-T---X-X---XX---|----------T--XB----X---X--X-|--Xo-----E----TB---MX--M-------X------?-B-----------X--------?o
---o--oE---X-E-------?EB---X---X---------X--X-----------EX-o-----------?-X--X--X---B--oB----B-X---------E---X--|-o----?-EX-X----E--oX?-E-X----X---XB----Moo---?--X?--|--|-B-oo--B?--E-B---B--------|X?--
B-----BoB----XX---X--Xo---XX-------X----B----X--o-X----------X---X---Bo--?----X----------o------------E----o-X--?--X--------|---X--X---X--o-?--------E------oX--------X---o-X--o-X--o---X-------------X-
-B--------X------o----B--X-X-T-B------X-Xo--E---X----X----o------B----?-B----|-o----X----B----B----XX-T-----M-----oB------XB---X-----B-----X-X---X---o-E-M-----MooX----o-----XXXX---o-----E-------XM-o--
---X-----X--XMXBo------Xo----o--o---X-----X-----E-|--X---|------X--------o---|X----B----XT---B--B---------XX---BBX--X----T-E-----------o---------------?-----------X---X---Xo--XX|--o-----o--XXoX---B--v
X-------Xo--o---X--------MB---------oX-X----oXB--EXX-------X-ooX--X|-----?-B----------o-B----X-X------X--o-XX-X----o--X----?----|-----------------X--?-oX--MX-o----X-o------MBo----BB-------X--M-XX---X-
------B-o-X-------------B------X-B------o----X------X-------------X--X---|--XX---X-?-----B----X-B-X------|--X-X---X---------?-----B---------------T-E----E--------BXXoE--------X--X-X-XB-----X----X-----
------o-----------oB------T--EX-----?oX-----X--E---o---X-o---------------|----------o------------------------o-o---B--|------?X------------XE-----------------------M--XX---o---?--BX-----X----X-------o
--------E|----B---B---o--X?------X-----------X--T--X------X-oXXB------X-----------X----X-----------B--TM----B-X--------o------BE--|-o?X-X--M-------E-X--?--B-X-B--o-----B------------M----X----X-?--XX--
--X---?-----oX-BE--------?X---------------?---o-X---B--?---------E---XB--B---X|X--------M-o-----------M--B------B---X--X---X----X------------o--E----------X--XX-B----X-o--o?--------X-ETXT-E|oE--------
----X-?------B----oXX-----X-----M---X-X-------------X--X-|---------------------------B----EBXX-----|-------oo-----------B-----o----------X|o--?---B---X--B----------X----Xo----XXX---X----BX--X-X--X----
mTTTTTTTTTTTTTTTTTTTTTTTTTTTTTTTTTTTTTTTTTTTTTTTTTTTTTTTTTTTTTTTTTTTTTTTTTTTTTTTTTTTTTTTTTTTTTTTTTTTTTTTTTTTTTTTTTTTTTTTTTTTTTTTTTTTTTTTTTTTTTTTTTTTTTTTTTTTTTTTTTTTTTTTTTTTTTTTTTTTTTTTTTTTTTTTTTTTTTTT
XXXXXXXXXXXXXXXXXXXXXXXXXXXXXXXXXXXXXXXXXXXXXXXXXXXXXXXXXXXXXXXXXXXXXXXXXXXXXXXXXXXXXXXXXXXXXXXXXXXXXXXXXXXXXXXXXXXXXXXXXXXXXXXXXXXXXXXXXXXXXXXXXXXXXXXXXXXXXXXXXXXXXXXXXXXXXXXXXXXXXXXXXXXXXXXXXXXXXXXX
