------------------X---EB--------------------------M?-------MBB--------M--------Boo-----B---o---MB--------BX------------o----------------------------X-B-----?-MBB---XXX----------------oXoXBM-----------
----------XX--XX-----MB--X----------------------------------------------XX----------BB-B------------MXX------------------X?-XXXX--------?B---B---B-------MBB-X?-----------?B----------------------------
E-----X--XX-o-------oXBM?-----------------------------------------X-----BM---------XX-----------------------X-BB------B-------------X----------------------XB?B-----oB-BB--X-------------------------E--
BB----MX----------MB---X-------------------X--BX------XXB---XX-X--M--------BB??B-------B------o---------------BBB-----X------BM----?BXB-M--------?B---B--------MBEM----------oB--B---XBM----X---BB------
---------------?B--M--------MXMB--------BM--------------------------------X--------B-X---X--BX-XXX??o?-----MBB----E?---oX----------------?--?B--o-------X------BB-------?X?---B---------XB?XB-----X--X--
--------B---BBXBX---X?XXB------------BX?B?XBB-BMBBX-----------X?B---BBB------BX----------------------------------------------------X---BXBBB-BBBB--XMXXXB-------BB------------------------B-------------
----------?--------X---B----------B------------------------XXX---------o-------------XB?------o---B?------------------------B---------------------BM-o---------o?-----------------------X--E?-----?B----
B-------------B--------------------BBM----------X----BBX-----------BBBM---------BX-------XX---BBB----------------o----------------XMXM?B---------------B---BXB-----------XXBBXXB------XBMX-------M-----v
-------M?B--------?BBX?MMM----XXBX?-BX-------X?-X-BB-----M-?B-----M---?BM----------------X-----------------o-Xo--------------------------------------?-------B?X--------MBB-------Bo-------------------f
----------E--------------------------------------------BBo-X-------X-------B-B----?-------------------o------BB-----------------------XM---X--XX------oB----BB----o?-----------X-M----B---?--X---?--X--f
-----B-BBB-BBBMXXB----------XB-------BB------------?B------------------------------------XXX---X---------?-------------------------o----------XB------------------B-?---E--XBX-MB---------------------Mf
------BXBBB-----------------?B?BBB----------X-?-----B----------------------------BBBB-?-XB--------------------?---oB-----------BB?M?---------------B--------------X?-------------------------?X--------f
-------X----------------BXX-----XBB--X--MXX------------BB----------X--------XBB---B--XX----?X----------------?--?X---------------B-X--------------------XB--------BBB-B-------X-----?--B----MB---------f
--------XBBX--------?---BB--------B?-XBM---X---------------XM-B----MBB-XB-------------?M---MXXMX------M?B-B--------X--------------M------------X------------------------------------BBBBX--------------f
m--------oX--XX------BB?--?MX-------------MB------------BBBBX--------------X--M-----------?MBBXB---------------?B----o--?-XBXBM-----------------------------------o-------------T----------BB----E---B-X
B---X----------------------?---------------B------??oB---BXBX----------------B--?XXX-----------------------B-------------MB-----------?-B-----M-------------------------XX--XB--X--M--oE??----XB-X?X--oX
XXXXX-X-X--XXXXX--XXXXXX-XX-X|XX-XXX-XXXXX-XXXXXXX-XX|XXXXXXXXXXXXXX|--XXXXXXXXX-XX-XXXXX--XXXX--XXXXXXX|-X-XX--XXX-XXXXXXXXXXXXXXXX---XXX-|-XXXXX-XXXX-XXXXXX-XXXXXXX-X|XXXXXXXXXXXX-XXX--X--XXXX-XX||-
