-----BBB--?-----------E---------BE-E-M------------------------?X--X?------oX---XXBBBB--------|----------------XB?------------BB--------?BoXoXMB---------XM-------------X?XX-------------------T--X--o-T-
----------------------BB----M------------X-----B-E-------T------X-B-------MB--------------------------MM--------------B-----------------------------X--------B----------------XX---------T----|B--------
-------------------?-B?----T----o----oo---BBB---------?--|B---------------------------o--?-----------EX----oB------X---o-T-------T---------X--------------------X--------------X?-----------B-----?X----
-?-------B-----------------|BB--------------B----------XX---------B---o-----------------ooM----------?-----B-B--BBoBX----|?XB-?X-XX-----------------------------B?X--B?M---------------------------X----
-------o-----T----XB-XX-------B---TXB------TE------o-------------------X---------TB-X-----o?X--TX?----------B--------------?----?----M--oXBXB?--------TB?--------------o----------MBXX----------------X-
---o--------X|--X---M-----o-------|--------B--------B----------------B----T----------M-----o-oB----------------------------X?--B-------------------------M-----TB---T---------X-----?BB---------BB------
---E---o---B------EB-----------oT----------MBT---------T---B-------?o--X-o------------------------------X-----o------X---?B--o-oBB----------X--B------?-X------|-?BB|-----------------------------B-----
----MX----T---------------------|T----------XXXX-----TT--------------TB------M--o-?---?-E-------------------o---------E-X---B-------------------------------?BB--------BX----------MB--B---------------v
-----------BMB-XB------------XT-o?MB-----------------|-------------BB---?-M-----------------------M-B-X---E--------XT---------------------------XT----------XE?-------X-------B----B---M--B-------?X---f
--X-?XX-------------?X-MX---------o-------------BBB----T------------X--B---XX-----M?----------o-----MX--------------B-----XX--------TEX--oB---------o-XBXB-----?------------XX-------oB---M-XT-BB------f
-----E??-MB------------------B-MB--X------------M------XB------B??--B----------X----------TB--M-------------?-B--------o-B----------|BXXo--M--T-----------------X--?----T-------T------------|B-----BM-f
-----MX-To-----------------------E--------?-?-BB?---X?-----------BXoM---X------------B--Bo-----------M-?---?-B--BMX--BB-X-BX--------BX-XB-----|BMBB-?---------------------------|-----T-T?----X--------f
------------?BBo-------------o----XTo?--------B--------------X---------E-------------?--B---o-------?----------------------M-------B---------------X---X---------------B--X-BM-X------|--X--B----------f
----------------------------o-----------------------B---------BBM------------?B--E-------------------------?-----E-----------------------------------BM----------Xo---------T-----o-?T--TT-B-----------f
------E------------------BB--------------o------o--------------TB----EB?XBBX-----XXX-------o?M---X--XX-X?M-----?----XB---M-----B---------oB---------------------o------E?X--|-X--X------|----------X---X
XX-----------------------------------B--E--------------T----BB-?-X---------------?BX-M-----B-------E---?----oMXX-----------o------------BEM----BB-------MM-BoX---------XXBX--oBXBXX--------------------X
XX-XXXXX-X-XXXXX-X|XXXXXXXX-XXXX|XXXXXXXXXXXXXXXXX-X-XXXXX-XX|XX|X|XXXXXXXX|XX--|XXXXXXX-XXX|-XXXXX---XXXXXXX-XXX---XXX--XXX-XXXXX-XXXXXX-XX|XXXXXXX-X--X|X-XXXXX-XXXXXXXXXXXXXX-XXXXXXX--XXXX--X-XXXX-X
