-o--------------------------------------------|B----B---B---B-?--------------------B-B------B-------------------B-oB-------------------------|-E---?M-------o-------X-BB---?---B---------------X--------
-B-------------E----EB-----?--M-|--------o?----B-B----?------E--------------------?T-EX--B-B------?|--------M-|-----BB---------------------oo--------B-B--E--?B-B-----o----B--------------M------------E
-------?--E--------o---o--------M-?---o----?----E--------o-----------T---o----------o--T-----------M-----------X--o---------------------B------------B-----B------------B-|--o-----BB--o-X--------B-----
B--|-M---B------------------o---E--------B-------?--|-----------B-E-|-------X----?------B-----------B-----------------X--?---?M?----T---------ME-----------X-----------------X--------------oE--------E-
-----|-----B-B-----E--------o---B---T------------------------?----|-----T----------------o--------------------------T------o------?-X---|--oE-----B---E--------BoE-|B-----o------B--?-----B-------------
------------B---T-----B-------o---------o-------o------------o-----?---E-B------------------o--?-------E-----X-----------------------------B-----------------o-o--B-B------?-------------B------B-----?-
----B-----------------------------oB----E--?--o---E-B------------------------------|-o--|?o--B-----BX-----------BB----------|----------|-------o----------------B--B-----------X---B--|---------------MM
-------B------------------------------B|?-----o----|o------oT?-------------E----B-----o---|-|-----?-?--------o----------|B-------------T---?-M--?-----o-----E-------o---------E-o-------?--------------v
BB--?-o----?-E--B------------------------B?---E-E--X----------------BBB--X--o-----------B-o----M--------E-------o---------o--B-?-B-T-------M--?-------o---E---------------------------?----BM-------|---
-E--------MT---------B---------o-------o---?---------o------E----?-o----E-------B----------------------------------?-------------T-E----X----------|--------|T-E-o----|------|E--X----------E----------|
---?----?---------o-----E-E-E?-------X--o----?--B--------B----B-X---|-|-----X----M---T--o-?--------M--B----E--o--B--X-|-------------------------B---o-------------o-----B---B--B---------E-X---?M-------
----------E-B----E-Eo--B---E-----M---------E--?---|---------B---o--B--T-X------------B--------B-B------------o----MB----B---------?M--M--o----?-M----MT------B-X-E-B--------------------?----X--B----?M-
B------T--B-------M------T----T----------X--------------oE-------B----X-o----------------------------o--?-B--E-------------B---?---------B------------------o---|T---o-?------?|o---------------------E-
--o------------B------------o-E----------------T-------|--E--?----------T?----E----------------?--E--X-------------------------------------------T---B----------------M--------EB---o-------------------
m-------T--o-?---To-o-----B-T--o----B-o-------B----o--------------------Bo-------o|--E----?--------B-E--o--------?B--o-------M--?----------------------o------------------E?-------o--o---M----?-------E
-E--B--B-----------------------------------------o---------T----------------------------E-|---E---------------------------?-E?--------o-----E-------------?---B--------------E--B-M-BE--X-----|---------
