-----E----o--|-X---o---X----EX-?--?--X-Xo-X?---------X---o---?-----X--B-X-o--------------X-XX------B--X--X-------X-------?-o--X--------------oM--X------Xo-o-B------?---X--------------X----T-ET--M-EEX-
-EEXo-T---E-BoB-------oX---X----X-X------X---------X-----E--X--------XM-?-T----B------Xoo--EX------X--B---X?Xo----XX-------oE-----T----X------T----XX--------X----X-------X------BB---B--Eo-?-----------
--M--X|---------X-MX-X--M--X--------XX--X---|---?-------XX---------X----o-----MX----MX---?--X---B-------o--XX--T--X---?-o--X--|X|--X-----------o---B-X-|---|-XoB-?-XM?--|-T--|------B--o-X--------------
--E-BB|-------o--------|-B---------X-----o---BB---------X-oo--o--o---X-X-o----------X---------X-----?o---------B-X------X------------XBX-------X-X-X---------B-X--------------------------o-X---X---X---
?BX---|----------X-Xo---------B---o--B---B|BX--------------B----X-oo-o--------XX-E--oX-?-X--X-X-X?-----M-o-------E----------B-|----o--BB---BBTXX-------X?---oXX-------------XX-X-----?---------X---B----
---M--|----o----oE---B----------XE------BX---------X-X---X---?-----X--B-----M---XEo------?-X--oX---X-T----BX----------E-----------M----E-T-------o--------B--X---o----X---XB-----------B---E--X----o----
------|-------?-B----o--------T-------X------XX---XXT-E----X--?-----E-X------X--o--XE--o---o--X-E-E-E---------|-X-T---------X---E|-----o-------X------X---------X--E--BX-------X-------------XX---|--X--
-oX--X|---ooXMB--X----E-T-?-------o------?o-X--o--X-------X-------X-----------o------EX--oX-----oE---?-----XB---------XT---------EXB----------X--------E-Xo--X---XX-----X-X-B-X-B|---BX---XXX----X-----v
-X----|--X----X---EXM-o----------B---?---------o-------X-?o--------------E-X---?--------------o---o--X---BB-------E?---------X---oX---X-----------|--------|---M------o--X-----X-X---|--XX---------X-X-X
-----X|----X----o---oX--oB-------X-------oX---X-----o---|-----X----BX-X--------o-oX-----B--------To?-|----------X-EX-------X-------X-Xo---M|--o-o--T------M-o----X---T----X-------X--XoX-o---?----o-E-oX
X-X---|T-X-M---o-EXX--------oB?-BXo-B----B?X-X--X--o--To--------------------Mo-X-X-----oX-----------XX-X------EXE---B----XXE------X---------X-----M-X---X------?o--M---E-X-------?----------X--M-----X--
X--B--|----------X-X----B---X-E-XX-XX-----------------------X--X------------------|-o--------EX----X--?-E------XB--X-------XX-----Xo------oo-X---|X----X------X----X--M-XX-------X-X---M|-?B----?--Mo-o-
------|--E-----------------BX------X--X----X------E-MB--------X---X--------------------------B---X----X-T-o-o--o-BX----XX------X--ME---X-B?---X---o---Eo-----X----E---------E-TB---EE-----------------X-
------|X-|----XBX---X--X--|--X--X---X-----------------------|--M---o---E------o--XXX-------------B---XB---X-------o----?--M---E--oX--X---------X-o--X-?----B-------o----M-----XE----X-?-Bo-BMo-Xo|----XX
m----X|--|-B-MT-o--------E------------X?|-----X---oX-o----?-XB----T--------o---------o---X------o----|--?--B?X-Xo?--XX-----o---B--M-------X----X--o-----?--o-X----E------X-----BX--------M---X--T----B--
XXXXXXXXXXXXXXXXXXXXXXXXXXXXXXXXXXXXXXXXXXXXXXXXXXXXXXXXXXXXXXXXXXXXXXXXXXXXXXXXXXXXXXXXXXXXXXXXXXXXXXXXXXXXXXXXXXXXXXXXXXXXXXXXXXXXXXXXXXXXXXXXXXXXXXXXXXXXXXXXXXXXXXXXXXXXXXXXXXXXXXXXXXXXXXXXXXXXXXXX
