------BX------?B-B--------EX-------X---oB-----------------------X----------------------XX---------?BX----------B------X-----------------------B?BXMXBMo--B------B?--XBXX---?B--------------------------E
-----BB-----------------------------------------------------B---------?BBMM----------------------XXBXBB-----XX-----------------------M------------------------------------BX-------o---------------BXXB-
-------BB--------BBB-------------?--------X?B--B-------B----------------o?-----------X--------------------------oX------o--------------------BBX--?B----BBBBXXBo-------oB---?X--BBX---------------------
-----BX-BB--------E-------oXXBoB-------------------------BXX--M--------------------------------X-------?X-------XX-XB?X--------oXXBX-------------BB-----------BBB-----------------B----BBBBBBX?-------M-
--BBBMXBB---X----------?X----------M----------------------B?BXB?------MMBB-o?B---B--------------B--------?B---------------MB--------?BB?--??XBX------------------XMX---?X-?M-----------BoB---?M-X-------
-----BX-B?----------E?---?BBB----------M--?XBXB-?---o-----------MBB?Bo-BB----------------------------------E--------------XX---X---XB---------X-------XB--X--------X----B-----------?-XB----------------
---??X?-B-B------X---------------BBXBXB---------X--BBB--XB--------------EXMM--X-?B-----XB--BMXBB--------------------------------MX-------------------BBXM-----?--------------------X--XX-------BMBX-----
??-B----------------------B-----X---------BX--ME-------B--X------------BBB----------------oB--?MXM--------BoXB---X?M----B?-----XMBX---X-----BB----Xo?---?------oB------------X----B-------M--?---------v
-------B--------------------B----------E---------------------------------------------------E-BX--------o---------o------X-----------------M------o--XBB----B------------B----------MX---B-----??-------f
-----------------?-----------------MBo----X--B?-----B--------X-------B-------------------BB--?X----oX-o--------XB---------------o--------------B-------?-o---o---o---XB--B----B---------X-BX-----------f
-------------------------------------------------------B---------------B---?------XoB--------BBBBXBXX---BBMXX------------?----------oBXMo-------?------------------X-------XMX-X?-B-X-------------X----f
------?B------MXX-----------?B?XBB------------------------o?BBB---------BBM??------BBX-----------B---M----X--XB-X---------BX-------------------XoXB---MBB-----?B--------------oM-B---------------------f
------------------------------------------B--B-----------------MX?----o--------?----oMBBB----------------o-----------?-----XB------------XB--o-B-----------------------------------X-----X-------------f
---------E-------------XBX-----------M-----------BXBB-XM------------------o-X----------B---B--M------------------------o----------------B--oM------------X-X----------------------------------------?BBf
m---------------------------------XBB---------------------??X?X-----X??---------o--XX--T-------------XXXB?------------X-BXXX-----------------B-----------o?------------BBX-----BB------XMX--------B-X--X
---------------?------MMX----------------TX------?----------TB------------B?-----------|----X--M----------B?-----XM---------------o---------T------X-X?--------------------------------X?T-----BM------X
-X-X-X|--XXX--XX-XX-X-X-XXX|XXXXXXX|XX-XX--X|XXXXXX|XXXXX-X-X-XXX-|XX||XXXXXXXXXX-XXX-XXXXXXXXXXXXXXXX-XXXXXX-XXXXXXXXX-XXX-XXX-X-XXXXXXXX-XXX-XXXXX-XXXX-XXXXXX-XXXXXXX--X-X||XX-XXXXXXXX-XX--XX--XXXX-
