------B??-----?--?--------EX-------B---o------------------------X----------------X------BX--?B---------------o--M--B-B--------B-------E?X------BMMMBB-oBBB------BXB-?------oBBB------------------------E
-----MB--------B-B---------BM-----------------------------------X----B---oBB------B---MX------X--------------------------------o------------M---XB-----------?--BB?---XXX----XX--------BXX--------------
-------XB--------?B--------------?--------XBB--B-------BB---------------o?-----------X---------------------------MB-------------------M---------------------?M--BXXX----BB-----------M----------------X-
-----B--MB--------E-------B----XX--?-------------------------XXBB-------------BB--XBB----XXX-M----------X--B----B--?B-------------------------X--X?B------------------X---B?----BB---BBX--------X-------
--BBXXXMX---B----------XX----------M----------------------------------BBBBXXMBBX----------------BXX-------------------------------X---XBBB?-ooBM-------------------M------------------------------------
-----BXXBB----------MBX--?BBB----------X--EXB-B-X---o-----------M-BBBX-BBX---------------------------XXBXM-?BB-??X---------------------------------------EXMXX--------------------------XBXBBXX---------
---BX-?-M-BX-----B---------------B-------------------------X?--------------------BBXM--------------------X-XB-BBX---B------------------------XX---------------------XX-BM----BBX-------XB--BB---B???M---
?B-B----------------------BX----o---------X?BB-----XXXM-----------?B----------BX------------X?-XM-oX--?BB--------------BoXBB-----------------------------XBBBB?-----------------MBB--?------X-------oXBv
-------M--------------------oM---------BBX-------------------------------------------------E-M---------o---------oX-----M?BMX-------------M------B--?BXBBB-X------------B-M?------------MB-------------f
-----------------?--------oB--BX?-------------B--------B??X-------B--BBX----------X---XBBB?-X---------------------------------M----------E------------------------------------??----BXXX--BBB------B---f
---------------?X----------------XB-----------B------X---------?--?XXB-----?---------------------------B--BBXXBB----XX-BBX-----E----------------XXX-----------X--M?------------B---------------MB-----?f
------?X------MXX-----------XB--MB-----------------------XX----------?BX-------------------??---?-------------?B----------XM--------------------BBX--?B-----?BM?XBB----------------?---------oX--XoM---f
--------oXX--B-------------------------oB-------MBBXMBB---------------XXM-----BB---o?BXX-----o-B?X----------------------------------o----------B----X--EX--------------BBXX-----------------oXBX--?BB--f
---------B-------------XB?-----------o-----------BXBX-X-----------------B---------BX----------oBB--------XXXXM---------------BX?X------------------X------------XX------X------------------------------f
m------------------------------------BBX?B-----X--X--------------EBX-------------o-----T--XX--------------------------------T-BBBX-XM-M-------------------------BB-----?B------------------B---T---EX--X
---------------?------M?XX---------------T-------?----------TXB-----------B------------?----X--M----------B------XMX--------------o---------TX-----?--XB?-----------XM?-------------XB--?X-----|---XBBBX
-X-X-X|--XXX--XX-XX-X-X-XXX|XXXXXXX|XX-XX--X|XXXXXX|XXXXX-X-X-XXX-|XX||XXXXXXXXXX-XXX-XXXXXXXXXXXXXXXX-XXXXXX-XXXXXXXXX-XXX-XXX-X-XXXXXXXX-XXX-XXXXX-XXXX-XXXXXX-XXXXXXX--X-X||XX-XXXXXXXX-XX--XX--XXXX-
