-B-------o-----B-----?---o--B---------------|--------------E--o---BB------?-B------Eo---------B-----------o-----------E-------------B--E----o---o------?-B-M----B-E-o-B---X----------------------o------
-o------o----|---------------T--E-------------------------?-------T----------E--------o?--------X-BM----B----------|-oE--o?----------o-----------------------o--------M--------------------X-----B--E--?
---X--------o---E---X--T----B-----------------------------B---?----o--------------o--|----------------E-------------------M-----o---------B------E-------E-----o----?----------------------|---MB-----B-
------------|---------|-M-----E-----|-?--------?-------o--X--X--X--X--------------------------o--------------M---------E--|Bo-----------|-----|---------------E---B----M--------M-|-o------B----------?-
o-----oT-------------o--------------|o--------B----B--------E--?------?------------o---------M-E---------------?------o----B--|--------T---------X-----oo-------B-E-To?------M-??---------------X-o----o
-------o--BT--B-M--?--XM--?B------B-o---?-----o-----E?-???-------?------o?----M---o------------Bo--------------------oo--B|B------------------o?----B----------T----E-------|------B----------------X---
--BE-o-------------E-------B-M|--X------X----------B-----------?-o---XB-?-----o---------o-------ME------|---B------?BE-------M--------X---------oB---E--------E-----B--o-------M------------??------ET--
------?---EE--?--------B-----------o--o-|-------M-------B--B--|-------o----B-----------?-----o-----------------------B---E------------o-E----------------B--------o----------B------------EE---M-M-----v
?-E----------o---X--T----------?B-To---o-M-|-----T--M-------?--------M------------B--To-----------------|-----?--------o------------T-----------B--------M-----T--------------------?-------------------
--o-o--?---------o----------B---M-----o---T--------|-------oB----|------------E------B---------B----B----o---------|---o----?----oE-----XB-T------------------o---------------------X------?------------
--o--X--?--------B------------o----B------E?-?T-----------E-o------------T--------------|o----------o-----oB----X-----------------------------------M---------------M------T-o-----------BB-T-----------
----|------------X-----------------------------------------------B-----B-------------B-----o----B--?-o---E--------T--------------------?--?----M------ME---------------o--oXo----|--|--------o---oT-----
|----M------o----E------M----X--------------------BE-?---------------o-?-o-----------------M------------E--------------T-o---o----?----B-|--o-------------------------E---M----------------------B---X--
B?----E-B---T-------------------?--M------------------X-------BB----B?o----------------X----------o---B-------E-----B-------------------------?---B-B----B----------T---?--B---o--ME-----?--o--T--?--B--
m-------M-------------o--X-----?---?--B--MBE----------B-X------------------T?-ME------ME-----T----oB-M-----EB--o----|----T----------o-----?---------------?-------------?---------------E---------------
XXXXXXXXXXXXXXXXXXXXXXXXXXXXXXXXXXXXXXXXXXXXXXXXXXXXXXXXXXXXXXXXXXXXXXXXXXXXXXXXXXXXXXXXXXXXXXXXXXXXXXXXXXXXXXXXXXXXXXXXXXXXXXXXXXXXXXXXXXXXXXXXXXXXXXXXXXXXXXXXXXXXXXXXXXXXXXXXXXXXXXXXXXXXXXXXXXXXXXXX
