-X--?------X--XX----X-----------X--?-oX----------------XX----X--XoE-X--X-XX--------E-B------X-----o---E-----X---B-----o--------X--XX----X?-----------------X---------------B-X--X--X--------?--X------M-
-X--------oX------XX---------------X---X-----X----o-----B-BE------?-E-------BM-----o-X-------?------------X-------XXo--X------E------o--------E--------E---E------o------X--------B---XM-XM--B-X-E-X----
-------M---X----------X--B-----------o-----?----X-------X--?----B----o-o?X--o----X-----B----X-o-EX----------------B------X-------XXo--Xo-------oBB--XX------X-B-----oE-X-------o----------------------X-
o------X-B--------X------B----------XX---B-M---oX--oo-X--X-----------X---X---X----B-----X-X----X---B----X----X----XXB--X--o---------XX-o-----XX--------?----X--------XX---XX-------o-X----------X----X--
o-------X--------E-XX----o----MX---Bo-X-X-------XM------B--------B-------------MB-----X-X-----X------EX---X-X----X------Xo--------X-o-------------BXXo--?-X-------o----X-M-X-------?----X---o---oE------
E--o---X---E---X-B-X?EB--M-X---X-o---E--EX----X--oE-----o------------------BX------XX--B----------X-XB--o--------X------?-X-----o-X--------Eo-------o--oo--X-B-------XXXoo--------------X---B---------X-
X------X-------o--?-B-------B----o----------Xo----------?X----------------M-X---------------M---------X--------------o----------MX-------XB----M--------X---------?---B-----M--------o--------B-B---E---
X----X-XX--------Xo---Xo-X----------------?B-------?--E-------X----X-M-------X------X---B--o---------X--------o-----o--X----------------------------oo---------------X-----MX--------B------X---X---EX-v
BB---?-------o----------X--X-B-------?---X---X-o----X--------XoE---------------o-XX-X-?-?---XX---?------------X---oX--------X----BM--X----o-------------X----X--------------BXX-----------X--------X-E--
--X----?---X--------?-------o----?-Xo--------------X-----X---X----X-X-----X--B---X----X--------Xoo-----o------------------?---Xo-X------B--?--EXE--X-------------?------------X--------------X-X-?X--E--
X----?--------X------X----B---o---X---------?E-o------------X----X?----X-o-?--X---E--------E-X?X-----M-------------X--------o--o---B-----------------X-o-XX----o-XX--------X--X--X---B--o--X-X-X---T----
----------o--X-oo------B---------X-----?----E----X-----XBB---Xo-X--X-E-B---B-----B-X-----X--------XX--M-oX--X-X---B----X?X--oX-------X--o-----X--X-XE-XX-------B-----XX---M---XX---------M-X-X-Xo--|X---
X--B-----ToE----B--X-----E--------------B------------X--------?--o------o--XX----?o----XX-----X--B-X-E-----------o--------Eo--------------Xo--------X-M-X------------------?-------M--------?--o--XXX--X
---------|----------?-------X----o---oT-------BXXT-----X-X---B------X--T-XX-T-o-XX-X--X-----B--X---------X--o--XX---T----X--------X-X--E--E---XX-B---o-BXXX---o----?----X-X---X---o--T--------X------X?-
mo--X----|--------X------E----B-------|-?-------oT?-X-o--X--------o----T-X-oT-----------B--------B---o----E-----?-?-|--EX---X--X?X-XXB------X-X------------X-X-----------B--------?X-T------X-X----?EXo-
XXXXXXX-XXXXXXXXXXXXXXXXXXXXXXXXXXXXXXXXXXXXX-XXXXXXXXXXXXXXXXXXXXXXXXXXXXXXXXXXXXXXXXXXXXXXXXXXXXXXXXXXXXXXXXXXXXXXXXXXXXXXXXXXXXXXXXXXXXXXXXXXXXXXXXXXXXXXXXXXXXXXXXXXXXXXXXXXXXXXXXXXXXXXXXXXX-XXXXXX
