-X---XM-E-o?----E-----X---X----E----M---o---oM------o---X---------o-------M-X----X--B-------EX--X-X-M-X---o--BX------E---X-XB---------E-----X-Eo-----X---XX-X---X----XX--?----------B?-B---M--X---------
-X----T?--------X----X---X-X-BX--X----B-------X--------------o--XX-X-------------------oo-o----X-E---o------X----E-------X-----B-----M----?---X---X--EX--------o---o--------?-------X---B--X--X---------
------|--X----X---X-B-E----o-----X--BXX----------------------E-X--BX--?---o----o-------X--X--------------------?------B-o---BX-?-o-----B----E------X-------X------------M--X-X--XM--?-----X-----X-------
-E----|---X--XX---X---o--X---X---?E-Bo-X-------X---------M-E-------??-B----Xo--BX--o---?---oEXX---------X----o----X-----X--------X-----E-B-o--X---MM-XX-o---EBE----------XM-----X------B------o----X----
M----B|X-------XB-X--BX-------?--X-oX--X------EXXX---E--o--------E-BE--E---MXX-X?---?-o-E-X-E-X-----E--o----X-XX-X--------XB-oX?----X--B-----X-----------X-B--X-X------?-oo-B---X--X-X-o-X--X-Xo--XX---o
MM-X--|XB---?----EBX------X-------B-----EEXX----?--X-XX--B------B-----X--o-X---Xo--EXBX----X-X----?-o----------M--B-X--E---Eo--------B-----Eo-X------B--------B--o--X------?X--B---B-XX---XB----B----XX-
------|--Xo----X----X------?---o-XEX--------o??--o---------XM--X----------XXXEo------o---o-B----?--X---X----------------?----XXX-----X----------X---X--------X?--------B--o-X----X----------------o--E?-
o-----|---------X------B------------------o--X-E----BXE-?E---B------------------B---o---------------E----X------------o-XX-------?--B--X--o--------o---E-X------------o-----X--X---------MXB-?-----o--Xv
X-----|--?X---oX-----X-o----X-----X--BX-X--------X-------X---?-E----------------?------E-----X---o-o----?X-XEX-----------B--------X---------ME?--X--?M--X--E-----------------X-oE--EXX-XB--X--X---BX----
---X--|-X-----X--X------XX----o-------X--E-B-X-----B-------X--o------B-------XX----X---------oo-----------B--X-----o----X--X---XB-----X---X-X---o---M---X--M----X---B------------X-B--XE------XE--------
------|B--X--------XE-o----o------M-----B--?oM----oX-o--B-X-----XB---M-o------o?--E-X--------------X-?-------X-X---X---X-MX---X-----X---?-oX---o----BX--?-X--M--X-XB?X---X-B-X----M-------------BE--X---
X---X-|--X-----Bo---------o-----X-XX--EXo-----X--XB?---?-------o-----XX------E---XoBB------------X------o---------X----E-X-----X----?--------X----X-X-B--EX------o-----M-?-?-o--B-X-X-----X---E-XXB-----
-B----|o-T----X-----?--B-o------o--oX---o----M----?E--E----X-----X-------BM--o-------X-----X-E--X-----E---E-X----X--X------E-----------X-X----o---X---EEX---BX--X----------??-X-------------E--X--E---B-
----XX|--|X---X-------T-?o---------------o---?--X-X-o--X-MB--?----------X---o-BX-------oo-E-B-o-----T--B------EX----X--------B------------BE-----------?---X-T--o-------------MX-T---X------T?-XX--X-B--
m---X-|X-|----X-------|--E---X--------------X----X----X-------B---------X-XX------E----BX--X-X--X-o-|---o-----Bo---E-X--X-X-o--------------BX-?X---M--X-M---X|--Xo---------------|----------|--o-------X
XXXXXXXXXXXXXXXXXXXXXXXXXXXXXXXXXXXXXXXXXXXXXXXXXXXXXXXXXXXXXXXXXXXXXXXXXXXXXXXXXXXXXXXXXXXXXXXXXXXXXXXXXXXXXXXXXXXXXXXXXXXXXXXXXXXXXXXXXXXXXXXXXXXXXXXXXXXXXXXXXXXXXXXXXXXXXXXXXXXXXXXXXXXXXXXXXXXXXXXX
