X--o--T--o---o-----E------T-o-X-----E------X--X------X?-E--X?-o-E---M-XX---------BX-To--------B---X-X-o-B----B-EB--X-T-Xo-B---XB----o---X--E---X-X----------XXX------?o---o------------X---?-----BX--X--
-----oT-XoXX--o-----X-X--X---o-?----T------o-XB--X-----oX-o?--B---B--------?-----E-------T--X-------oXM---------------T----X----M--------------o----X----------T----------T--oTE----------------BX-----X
X-B--T|----BT---?---o------XX------?-X--oX-----?--Bo-----------------o---------------?-X----B-X-X--XXXo--X-XX--T-X---o--oXX-B-o-X-----o-B-X-o?-E------B-----T-----------Xo--BE-X------M-----X-X---------
----o-|-ooX--------------?X---Bo-T--B-----XE-X---------XX------MT--XM-E--X----T--------?-----MXTB-B--------M---------T--o-M------o-------X-M-----oT-------?-T----B--T-------X-?-o-X-------------X---M---
-----X|--XBX----M-o?-----X---X------------------o------X----oXE----------o---X-B-T?BoXX--X------ME----?B----T-----XB---?E-----TX---X--?o-XE-E--X---o--XX-------X?--X---T-----X---------------XT---------
---X--|X-B-EB----oX------------?X------X-E--T--X-o--B-----M--X-----E-oB----B--------X-B-?B------------XE-X---B-o--X------B---X--------X--X---B--B----o--o--------------------oBoBXXX----o-X-X--XX-o-B--T
T---XX|----X-?---X--Bo--oX--To-------------E----XX-oXT---MBE----X--X--?---XBXE------o---o----E---X-E------E--?Bo--?------XXE------BT-----BX?---------?-?-------?--------X-----oB-B----------T----X--B---
--o---|o---B---------X-E------------o--X----X---Xo-X------X----X---XB----oX-X-X----------oT---------X-E?oo------XX---X--X--M--XE----X---X-?--XE---XX-T----------XX--o-----B-o-XEE---o---------XX-------v
--?---|---E--------o-M--o----X---X-------------oM--X-o------------------T-Xo-B-B--B-o?-B----X-X-X---X------------o-X-------X-X-----o--o-------X---X-B---E------?-o--o-E-------E--?-----E---ToX-----X----
------|--X-----------XXo---------X-MTT----------T-----X-------T-----------X--X--------X---X?---?--X-XX-------X---------------XX--o---------T-?------X--X-o--BTBEX--E-X--XXM---oX--------XXT------E--o---
----X-|--------Eo-EX--------?X--E-X---X-------TX-o-X-oX---oXX-------X-------------XBX----XX-X--------o-XX-----XB--XX--------o-----XX------?---B-------M------------------EX--o-----o---X--------B-------
-X-oX-|------------X-XB--XTo--X---X--B-M----?-------o-------X----X-T-----oXB---E--XX--X-o---BXE-----X----X------X---X-X----M------------XXX-----------X---E----Xo--------MX--?---XX?--X-M---------o-----
?--Bo-|o-T-Xo---X-------XX|---------B---oB-X----X-o-----o--XX--X--------X-----------B----oX----------------T-----X------X----M--T--------------o----X------B-EX----XB----------M----XX----------------o-
------|M-|----X---B-------XX--X------o-----------X----X---X-X----XX---------X-B-X--X---XXo-X---B-X-X--------------------X---------X-XX---oo--X--?---X----?------X-BB--o-X-o---------E----X?T---X------o-
m--XM-|?o|-------XE-----B---?X--o-?EXE?-?oB--------X---------XB------o-o----X---------X------oX----B-------------B--EM--XoB------M---?---------Xo--X-----------XXoX---MX-------X--?-----E?-TX----?------
XXXXXXXXXXXXXXXXXXXXXXXXXXXXXXXXXXXXXXXXXXXXXXXXXXXXXXXXXXXXXXXXXXXXXXXXXXXXXXXXXXXXXXXXXXXXXXXXXXXXXXXXXXXXXXXXXXXXXXXXXXXXXXXXXXXXXXXXXXXXXXXXXXXXXXXXXXXXXXXXXXXXXXXXXXXXXXXXXXXXXXXXXXXXXXXXXXXXXXXX
