oBB---------------------------M-------?X--------------MoBBBMX----------------o------------?B?XX----------BB-----M?----o-BMM------------?B--BB--------BXX---------?o?BBB--?BB?-----------XX-XM--------B--
---oXM-?XX----------------M?-------------?BB----------------------------------XBXX---XMX-MMB--------MBXBBB---------B?B---EBB?-----------------------?BX-------XMXM--BXBBB-----X?M??----------XBB--------
oB-----EX---MBBX---------?B?--------oBB-----------------XB?BM-----B-BXM---------XBB-XXX-XBXB-----------MX------MBM---------------B----BB---BB-------------?----M?--------------------------------------X
o-B----------MX------------XXX--------?M?-??-----XBB---EB--------BMB--?B?B-------BMB----BXB----------------X-XXX?B---------MBBo---------B-----------------------------------------------MB----------oBX-
---------------------?Xo--------------------?-?----------oBX------------------------XBB----------------------------------o?X?B-BBX--------------------------E-E?X----XBBBBX---XM-------------B----------
EXo?XX-?XM?---M---B-----------------?B--BBB--------------------B?B-------------------------------------------BB-??M--------------M---------------------------------------------BB-----------------------
-XX?--MX-M--------------------X?--------X--?--------------------------------XX------?MM----------B?oB?EB--X?XB--XBBB--------BMBBXBXX?-B---------------------XXBB-----------B??BBB----------------BX-XMB-
--------BB--------o-------------------XMM-------------X--------XXXXXXX------------------XMB------------------X?B------------------o--------XB------X--------------o--B----XXX------------MB-------E?BBXv
--o---BBX---------------oBB-----MBBB-----------oM?X?B----------------MBB?B---------------------BBBX------B----------?--?X------XM-----MB---------MB---------BM?B------XB---------B??MMM----------------f
---------------------------XBB-BB----------------------------------------------------X-------BX-------------------X---------XXXB----XM---X-----------E----BB--BB??-----XX------------B-B----------B----f
-----------------------------------XBBBBB?-----o-----XM---------oBX-----------XX?--?----------------M----------------------------BBXB-----------------------XXBXB-----------------------------------BBBf
-----------M-------------BXX--B-----------X-----oBB------M-------------------------------X?B----?-------XXB----MMB?-X--o?------B?---BMBBXX?----------------------M----------------XBB?X---X------?BX?XMf
-----------------BMBB---------X--XB----------------------B-------oBX-----B-BEBX?----------------BB--------oB-------------BXX?----BBB--------------------o-------------------------------------------BXXf
------MM-------------------B----------------------------------------------BBB?XBB--------?B-------------------------------------B------------------------BX--B------B----------------------X------BX---f
m-------------------X--------oMM?B----XB-X-BBB?XB--------TBB-----XBB----MM--X--MXX---------o-------BX--------------------?B-----------B---------------------X----MBBM-------B?BB--------MXXB-----------X
X---------------XX--------------------------------MMXMBBB|TX----------------??BBB--------BXB--------------oBBBB-----?X-?XMX---X?-------------------------------------------------------------XXBMB-----X
---XXXX-XXXXX-XXX-XXX--X-XX-X-XXXXXXX-XXXXXXXX-X-X-XXXXXX-XXXX|X--XXXXXX-XXX--XXXX|XX-X-XXXX|XXX-X--X-XXXXXXXXXXXXXXXX-XXX-XXXX--X|XXXXXXXX-XXX-XX-XX-|XXXXXXXXX--XXXXXX-XXX-XX-XXXX-X-XXXXXX-XXXX---X-X
