-o------?------------oX-?X--X-----X-----?---?-E---------?X-o--E-----------Bo-X------M------o------XBoX----XX----------o------BX--------?---X-----------Xo---X-------EX--------B------X---X----X-----X---
--?--BT--XX----------?-----B---X-B---E----E-B------X-B-----E-o?---------X--------------E--------------M------X-o------o---B--------------X----X---o--o-----------Bo-o---B---X-XXXo--T-----X--X-------M-B
---o-B|X-----X--E-----XX--B-----M-B------X-----?--------------------------X-X----oX----X--X--XX-o---Boo--X--------oBo-----X-XX--XXXX-------X------XBo----o-------X-----X-----------X|---------o---X-----
-X-Bo-|-o--X------X---B-----X----------------X------Xo-----E-?----B-X--------o----o----------X----X--X------------X------?-X-------?----EX--B-------o---E-------oBXX----X-XM--BX?--X|X--XX?---X------X--
------|----X----MXX--X-----??--BX-X----------------o--B--B--------------XX---E-oXBX---E?--------B-?----|---X----?-?--X------------------XX-------------X--?-------B----oB--X--------|------------------X
XX----|-------X-------------------X--X---o----?X-B-------------o---BX-------X---X----X-----?--EB-------XX-----oo-X---o-----X-----o??-?------o---Xo---B-----BX---------X?X--o----?-X-|-X--------?----XX-X
----X-|MXX-----B---------X-|-------X?------X------X----E---X-----------o----X---M-E--X-X----E------B-?----------oX--------o-------X---X-X-X--o---X-----B-----E------------X----E---M|EB-------XX-----B--
-o--o-|---XXX-------X?-----XBX--?--XXoX---X------------E--XX----X-X---E-X--X---B------X--------M---oX---X-X-----EB---B?-------BX---E--------X?--o----o----B----M----X---?E-------X--|---X-?-----?----X-v
oX--B-|--?-?--B--?--B------X-BX--------XXX------o----?--M------XXXB--oXo?-B??XEX--XB-----------XE-------X--B-----?-X---------X-B---Bo--X-X-oX-XX-----o---o--??B-----E------X-X-X----|-----M--XX--E----X-
----Xo|-----o------X-----BX-----X--M--E----o-B---B----X--X----Bo----XB---o-X-----X---oM--------XX--M------------E-------------o--X----B-X----BM---------------X--oX--------Xo----?Xo|----o-oE-----------
-----o|--o-E--X----BX-X-o----X----------B-----X--X-----------------?---X-oX-------X---------o--------E----o---?X--------X-----B--------------------XX-?-----X-o---o-----E---XX------|X------oo--X--E----
M-E---|-----X---?E----oM----X-X--X---Eooo----?-----------XB--EXX---X-------X-----X-----X------------o-X-------------X------X-X------X--X---EE------X----X-E-------Xo-------X--XX--o-|---------X--------X
---X--|-----X-----?o----B----?---------B--X-B--X---oo-o---MM--XXXE---X-------------B-------M-XBX---X-o---X--X-----XE--X--------o---B--B---o---------B------o------?X-X--M---Xo---X--|-----------B-------
-E--X-|---M-----B--------X------?-MX---XXM----X--XM-----------?-EX----X-X---o-B--B--XB-------X--?X-M-o-------X-X-----o-X---X--------------X----oo--?---X-------o----------Eo---XX---|-------X-----------
m----E|--MM------X-----X--X--X----o----o--o---X---E-----------------o---?--------X-B----------X------X---o?-------------X----------E----X--X---o----X-------o-----------------X---X-|X-Bo----XX-X------X
XXXXXXXXXXXXXXXXXXXXXXXXXXXXXXXXXXXXXXXXXXXXXXXXXXXXXXXXXXXXXXXXXXXXXXXXXXXXXXXXXXXXXXXXXXXXXXXXXXXXXXXXXXXXXXXXXXXXXXXXXXXXXXXXXXXXXXXXXXXXXXXXXXXXXXXXXXXXXXXXXXXXXXXXXXXXXXXXXXXXXXXXXXXXXXXXXXXXXXXX
