o----?----B----T-------XX-----------X--------X---XB-----oE-----oE-------B------X-X-------oBo-----X--------T-----To------?-----T-------XX-----X--T-X----E----?---------X----------ooo--------B-?--XX-----
------T-----B------Xo---X-?-X-BBBo-----?------X------------T-----E--X-------X---X----X--|-----------------------M-X--BX------X--E---o-X----------X----?--o--------------------M---------ooE----X--E--Xo-
------|-X---------o---B--------T------M|o------------X---X?---------E-XX---oX-BE-?-------X--X-----------|E---X------B---??----E--M-o-B--X--X---B--X-----------E-----o---X-oE-B--B----------X|o-E----|--X
------|X--o--M-X---Bo----B--B--Xoo-----X---B-----------X--|-XB-X----oMX------------X--oBX------------X-----E------|-BX----------B-----------X-T---------X-oTX-XX-|-BXXo?BX------XoX----o-o-o------X-----
-----B|------o---oX-----XXB----o---oE|-X--?--X-----X-----M-B--o--o---X----o?--E-----------X-o------X-EMX-X----XXX-X----|-X-------?--X----E?-B----|-----?--o----X--X--B-o-------B?------------BEB----E--B
--X---|--X--------o--------X--E------o----E--X---o----EX-o--------|----BX-?--o---X------M---X--E-----oE----TE-X--X--X---E-----o--------X-E---------B---------|-XX---o----------------------------E-X----
----oB|-MB-----------X----E-o--E--oXoX-?EB---o-TB--B--M|------o-|--X---E--T-B------XXE---?X----|--------------------X----X--M--------X--XXX-B---o-XX--o---B---X?X---X----XX--o----------Xo-X--------X---
---B--|-X--o---oX----X--X--------B--M---------BB---X-----X--o---------X---X-?-oE----B---X----?-M--XB-o----XMBE-----X---oB----oo---------o-----X------XX-o--X-----?---X-?-----B----E------X----XX------Bv
-?--XM|---o---------X----B-------XX----X-----------?--o------------X?--E------?---oT---X-----X-o-X-BX----------------------X----?---?-X-X---XM-T--ooE-o-T------B--B-----------?--o-X--XXXB----EX--------
------|-E---X-------X----X--X-X-||o----------B-------M-------oEo-E-XB---X--o-o------------------E------X-E-----------B----B---X--oX--X------o-----------o----B------M----X--E--M-XE-?----o----|---o-----
|---B-|X-XE---Xo-----BX------Xo-o---o-----oM----X-E-?--X------------Xo--B-X--?----X-XXBX-------------TX-----------B?--o--------EM-X------Xo--------BB----------X---o---?-----X----X-----------------E-X-
-B--o-|-o-E----X-----------XXX------X-------T---o---o---X---XT--------X-X-------Xo---o--B-----X--X-E--T-EXXX-X-o-----X----?---?----B------E------X----X-------X--X-----X----E----X------X-X----X--o-T--E
-o----|-----------------------------------X------X--|-----X--------X-o-|---X-o-E-XX------E------X--Too-X-----------X--------------B---E--o---o------X--X-----?X|---X-------B------X-|-X-T--------------B
------|--|--X-------X--TX--M----------o-XX-----o------M---------M?-X---------o--|-B----E-o----------X-------------Xo-----|TX---?--X--------------o---------E-X--o--------X-------B----X-X----X-B--B?----
m----X|X-|?-X--X----X--------XoXXB-----o---X-T---XX----E?--X---oX----X?------X--------?|----|---------E-------T----X-----o---BEo-------|-----X----|-----B-o--XE----?---X--------B--?-------X----o------X
XXXXXXXXXXXXXXXXXXXXXXXXXXXXXXXXXXXXXXXXXXXXXXXXXXXXXXXXXXXXXXXXXXXXXXXXXXXXXXXXXXXXXXXXXXXXXXXXXXXXXXXXXXXXXXXXXXXXXXXXXXXXXXXXXXXXXXXXXXXXXXXXXXXXXXXXXXXXXXXXXXXXXXXXXXXXXXXXXXXXXXXXXXXXXXXXXXXXXXXX
