--o--------B---oX-oX----X-----X-----X-X-X----M---Eo---X------?---------------E?---XBE---EX-----------------B------------X--------X-B------o------X---X-X-------X-M----B--o-X-EM-o--o---------oX---E-----
---B--T----------------oEBE---XoXEoX------X-XB----X-X------?--B--oE-oo-------?-?--oB---------X-------------o-----X-E----M-X-X-X-X-B------------o---BX------------X-?---X---X--E---o----------o--M-o---?-
---?-o|M---o-X--?---------X---X-----BX---XX----X--E--E-------------X----------E--X-----------Xo-------------XX-X?---------o-E----------------------M-X-X-X----X---X--X--?-----X------B-----X----o-------
----X-|-o----XX----X----B--X--X--?--X---o-X-X-X-----o--?oX-X-----------B-------M----o--------BB--oE-------B?-X------XX-------Eo-X-----X---oE-EX------M-o-------M-----oBM--------B--X-X-M--B-------------
---X--|M---EM-X----------?---M--EX-----o-----X-B-----o--?---------------------XX--o?--------X------E--?------------------X-------E--o-----------EE-o---------?---o-------X--E---X---------E-----------X-
---X-B|--X?------B---o-X-----B------X-X---o-----XX----E-------X-o--?----?---B-----B------Xo-----E----B--?o-----X-----B-X--------------X-B-----?---B?--o-o---------X-X--X?B---E----o------X--X---E-------
------|?-------X----o-X---X----X--X-B----?----o-------B-------------o-o------oXXE-X---X---o-----o---------X-X------------X----oX--X-E----M---?BX-M-----BX-X--M-------------------------------oB-X--X----
--XX-X|-----------X----X---B---X--o-------oE?---o--E---X---?--o---o--------------X------X----XX-----X----?----XEXX---X------BX----------------o------X-----o--X--EX--o------o------X--B----?--------o--v
X--BX-|-XXo----X--------X------X----X-X--------o-------X-----o-?-B---------B--------o-XX----B-X-----X---M----B---------?Mo---------X----?B----B-Bo---X----oE--B----------X------------------------X-X--X
---XX-|--oX----------X---------o-o--o--oB----X----------oX----------M-------X-X--XE------EB------X----------------E---o-----------o----X--X-E-XX----E------MX-----BE---Eo-X----X---E----X--------X----X-
--X--?|oXB-X-------Mo--X--------o-?----?--X-----------E-----X--?-------X-X-B-----X-------B----?oX------B-----XXo----o---BX-----B-----X-X---X---XBXX-----------B-----------------M---------------X--o-X--
----XE|------------X-o--X-X-X---o--X--M---B--B-X------X----?--o----B----XB-E-?-------X----BB------B----------X-----------X---X----?--?-E-o--B-o--X----X-XXM--------o-M-XX--o-----X------------EX--o-o-?-
----X-|X-TX----------------o-XX-o-----M----M--?------X-------------E--Mo----X-------B-------BEBM-------o-----X-B----E----X-X?-B-E---------XE-?-------X---B-----B-------XB-M----?-----Bo-----------------
--XX?-|-o|----X--------X--o-----?E-----o-----X-o-----oX---X----B--EM-B-------X----Xo-----o---o-o-X----o---------------X------X--Bo-ME-o------B---X--E-E----X?X-B--B-?-o---?XB-?----o----X-----X---o--?--
m-----|--|------------X------------?X-o---M-M-----X----X---X-----X-o----X---XX---------------------------XX--B----X---E-------o------------oX---------o----B-?------------?E------------o------B-----X-X
XXXXXXXXXXXXXXXXXXXXXXXXXXXXXXXXXXXXXXXXXXXXXXXXXXXXXXXXXXXXXXXXXXXXXXXXXXXXXXXXXXXXXXXXXXXXXXXXXXXXXXXXXXXXXXXXXXXXXXXXXXXXXXXXXXXXXXXXXXXXXXXXXXXXXXXXXXXXXXXXXXXXXXXXXXXXXXXXXXXXXXXXXXXXXXXXXXXXXXXX
