-------o---------------M---------?X--------T--------------TM-EX-X--------M?------------|--?----BXB------------XX---?BB-------X----------------------?-----BB----X-------B---B----EB---------------------
----------------B------?-B------o----X-----X----------XE---M-E------Eo-------o---------T------|-------T-----------------------------------------E-----M-o---------------------B-----------BB------|-----
---|-o--------------------B-X----M----|-X-X------------T---X--o-----o---------------M-----B?-----X-o--X-B---------------X-----T----------|-B-?--------------?--T----X--X---------E----------------------
--------o----XB----------------B?-----B-----------------------------B-----------------B-----oB--------X---|----------------o|--M--------------------T--B-----------------X-------o--o-|-----T-----------
---------B-------------------------------o--BX--------------------------------------?---------B---------------------------T----T------X--B--o-B-XX---B-----------------BB---------------??--------?T?---
o-----X---B-------B----oB--XB-------?--------BB----------BM----B?---------X-X--X----------------MXB-X?-----X?--B-----B-----------B-XXEB---------XT--XX?-?M--B-o------------oX-X------------XB-EM--------
------X-----------------------?X------M----BX--XXo----ooM------B--M-------------------------------o----------X-----------X----B-XX---BBX---------o-|?X?BB------------------------T-----B-------E---??---
-----X------------B----------------B--BX--E---------MM--------------BB--------------BB--?X-----------------------------------o-----------X-------------M--------o-o--B------------B---------|----------v
-------o|o-----------o-----T---------?------------------------------B---M--B---------B---------------o---|E--------------BM-----MM------------------?----oo----|----?----------------------------------f
------oX------B-M---o---E---------XX--------M----X-T--B-?-------M--X-------------?-T------o------M-o----|--------o-X-B---o---------B--------------o-----------------X-----o--------------------?-------f
----------X?-------oB---X--B?E-----?----------TB-------B--------------B----X----------------------o----o-----M-X------M----B------------------------------------------------------------T-B--X--o-----Tf
------B---------------B-o-M-------------------o?------------o-oB?B----------o-M----B--o----------------------T---B-----X----------------X---------------X----------------------T-----------M---MX-----|f
------------------------B-----o-E---X-------------E--------o--------------X---------B?E------------|----X---------------------|---??X-----------------E---o----T---------------------|----------o------f
-------o----------------M-B------T-------------?-----X-------------------------|---Xo---------------|------------------M--------M-----T--M-X--------o-------M---?-o--------------|---TXX--T------------f
m-----o---o---XX------------o----------------XX-B-------?--------------Eo----------------------------M--B-M-----------------??---?----------M-??----E-------------o-------MX-?-TBB---------------B---|-X
-X-------------X----X-------M--X------------o?----X-o------------------B-----------------------------B------?------o-X-----o-----o-----o-------M-----------T------E-----------------o----------------E-X
X-XXXXXXXX-XXX-XX-XX--XXXXXX-XXX-X|XXX-X-XXX--|XXXXX|-X-XXXXXXXX-|X-XXXXX-XXXX-XXXXXXXXXXX-X----X-XXX|XXXX|XX|--XXXXXXXXX--XX-X-XXXXXXXXXXXXXX-XXX||XXX-X-XXX-XXX-XXX-XXXXXXXXX-XXXX-XX-X--XXXXXXX-XXX-X
