-T---BTXT---X-X-----EX--X-oX--B---B---o---M----o--------o??---XX-M-X-X--?----X----------XX-----X-o------XB--EE--TE-X--------?----B----------------X-----ET-------X-----T-XooX--E---Bo--X------o--------X
---M--TE--Eo----?-----o-----E-?---o--X--X-----------o----------X---o----E------X---E--BT-X-----M-------------X-B----?--X-----X-B-XX----X-XXXXo--o?X-XTX------BX-EXX-E-X-----------------X--XX----------o
-o----|o-------B-BX------------XB--?-XoX?-----?-------o-------o----oBo-B--XEX--X-o---T---------EX----X------X--o-B------M--X----o------------o---oMT--X--M-XE----B--B---X----B-------X-----o---TX-------
?X--XX|?------X-X-----XoX---?------X-X----X-M--------B--?----EM-Xo---M---oX-----X--X?-----BXX-BXB------------XX--------X------T-------BX-X?-T------------------EB-o-------o---X---X----B-----B--X-X---MX
-E-M--|---?--o---Bo----o---X---X----TE-BX--B-----XM---BX----o--------X-----------------?X-X---X------oE-B---T-----B------E---T-X---X----o--------E---------o-B-E----Xo--T----?X----X-XB-E--X-------o-oBX
---X--|?----X----o-X----XXM-?--X--E-----------TBM-XX--o--?----XXXT-------E-------X-B--------X--X----Xo----?---X--X------------B-------oXB----------X------------?------------B-X-X------XXB-------------
B-X---|--X---X?-o--X----X----BX-----------X-----oXE------o-X----------------B--------?----B--------o--T-----T----B------------oBo--XB-----------X----X-o-------X-o--o-oX--T---M--M-----X-o-----EE-------
------|-----M---B-------EX-X-X-----X---o---X-X--------TB-?oX-X--o---X-X-------?-B-----o----XX-X----o-o-T--EXTB---X---X-E--E------o--X--E-X---o---B---TXo--o---o-BBX-T----o--oBo-Xo-X-o?-----------X----v
---X--|-T----oX------B--------X-T------XXM----------o---------------EX-oXEX-------X----o--M--B---X--o-------------?-----B--------X--------o--B--------X---B-----X?Bo------X------X-E-o-----XB---------oX
-----B|X----X-T-o--X-------------XXX--EX------To--X--------o--------XB---X------------E-----?----T-------X---XTX-X----------T-X--------X-o---XXBX-oX----?---o---X-B---B-BE---------------------o--------
T-o---|-o------X--X-------------EX-----------------Eo----E----B-X-----X-o-B----?o---T------oTBB-X-X--?XE--Xo----X--?-----?----------?------XX-----?-----------E-?------------B---?----B-X-X--X-T--------
----To|--XXo---o---X-X---XTB--------E-T-X----X--Xo-o?B--X--o--------?--X---B-----X-B------B----o--------------XB-X----?---------------X--E-------M---------o--?----X---X---X----TXE-X-----E-BX--oX--X---
-X---X|?XXX--X---o-E---XE------oEX------------------T----X---------X---?---X-----?-?-----?E---X-----?----?-XM----------------X---X--------------------E-----X-------E--X-?----X---X--E-------B-E-B------
-BBX--|--|--X--o-B--B?-X-o-----B-B---M-o----o-----o-----X----o-B-------------E----XXB--o--TE------X--X---XX--------X--?-o-X--X-------------E---X------X----------oXB?-X-------T-------XX-----M---X?-----
m-----|--|-----B-------X-X-----------?-X?-X----o-------o---------o--X--?-------o-X----X---TBX----------o----o---?----X-----XX---o-----------------X-----X-------o---X--X----o-T-------------------------
XXXXXXXXXXXXXXXXXXXXXXXXXXXXXXXXXXXXXXXXXXXXXXXXXXXXXXXXXXXXXXXXXXXXXXXXXXXXXXXXXXXXXXXXXXXXXXXXXXXXXXXXXXXXXXXXXXXXXXXXXXXXXXXXXXXXXXXXXXXXXXXXXXXXXXXXXXXXXXXXXXXXXXXXXXXXXXXXXXXXXXXXXXXXXXXXXXXXXXXX
