--X-------------------X-X----X-X---E-M------X---?---o----?X?-XX---o---X------oXo----X--?----M-X----------EB-X-X------X------BXE-?-----------X----o---X---X-X--B----?----oX-----------B-----?X-X---------
--X---T---------M----------X--------------B--o--o---------X-B-X----E---X---X-----XX-Eo---M--XB-------?B--X----X----X-----?-------X-X-X-----o-X------oo----X-------o-----?---XB---?B---Xo--B-X-oX-o-o----
------|B-------o---M--??X----------o?o-----B--------E-X---------X---B-X----?B-B-BXo---o--BX---------X-B-----------X-----B-------X------------------------Xo----o?-M---X----------X-----------Xo---o-B---
------|--X-----------X---X-o----B--X------X----?----o---o---------------E--E----X--o-X-?--MB---X---------X--B------?--B--X--?---E-B-E-BBX--o-------B?-o------E-XE-----E-X?X-o----------BX-Mo---------XBB
MX--o-|-o--o----X----MXXX-----B-----XB?-----XXX?---X--X------E---B--------------X----X-------?--M----X-----X---Xo----X------X--M---B------o-o----------BE-M-XX---B--o---o---------o---------X---X---o?--
o---X-|---o--------E----XX-X---B--E--X------M?XX-X---M------X-X--X------X-----E--------X----XX-------X?------------B-----B----X----XX-------X-?---oo--------?----M-X---------X----EX--------E-----------
-----X|------BXEX-X-?-----X-----?----B-----X---MX-----X-----------X----B-----BX-------------XX-B--?---------?------o--------oX-B------X--X---------------------XX---------X-o-?--------------X--X-?----B
------|-o-BMX--BX------X----X---E--?------B----X-X-------X----------Xo---BX-o-X-----BX----X------B--oX----------X------o--X-----X---E-------B--X?o----X-----------------------M--B--------------X------v
------|-------X-------X---------------o------X?---X-X----------------M---B-E-X------o--XB--X---------------o---------X--B---X---?----oEB---------o--o------X-M----XB-----o------------E-------------E---
----X-|-----------X-----?-o---E--B-o-XX-----B?--XEB----Xo-Xo--X----------X----X-E---X-----X------------------------B-----X--------------?---X--o----X-----XB-------------X------X--?--?--X---o-----XB-X-
-E---o|-------?E-------B--X--X?---X-oX-?X----?X-o-XX----B--X--?-?------------------oo-oX---oX--X----Eo-X-XX-X-X-E-B--BXBX--?o---o?---B----------------o---B-----------o-X---M--X---B-X------X---X----B--
------|----X----------------X-----------X-B-------X--E-?----o------M---X--o---X-o-X-BX-?--X----X-------------------o-o---o-X-B------X----X--?X-o--------X----o---X---o--?-----------MX-----EB--B----o---
----X-|-XT--X--XME-----B-----X--------B-X--------E-?o---o-----X?----E----oX--Xo---X-----------B-XE-------X----oB-?-------X-----B----X---?--o--------B--Xo----X------X----?-------X-EoX----X-------------
X---o-|-X|-----------?---E---X----X----E------o--X-X----X-----B----X--EX-?--B-o----------XBB---o--------X---------XB----B----X-----E-o------X---B----o?-----------?X------T---BX----B-?--o---T--Eo?-----
m---o-|--|----------XXX--B---B------?X-X-X--BX-?XXB-------------BX--X-----X-X-----M---X----X---X-XXoX----------XX-----M?o----B---E------------oX-o-----o-E--X-----X---X---|--X-----oX-E--B--X|----------
XXXXXXXXXXXXXXXXXXXXXXXXXXXXXXXXXXXXXXXXXXXXXXXXXXXXXXXXXXXXXXXXXXXXXXXXXXXXXXXXXXXXXXXXXXXXXXXXXXXXXXXXXXXXXXXXXXXXXXXXXXXXXXXXXXXXXXXXXXXXXXXXXXXXXXXXXXXXXXXXXXXXXXXXXXXXXXXXXXXXXXXXXXXXXXXXXXXXXXXX
