-------oX-------------B--------------------BBo?BXX--------------?B---------------o-------------B?X---XX?BB---------MB----B-----B?X--B---------?------------------BBXBM--------------------------M-------
XX-----??--B--------------------------------M-X--------------BBB??B---------------------BBB-------X-------B-------------------------------BBBM?MXB?-----------------------------BBBB--------X-----------
ooB----------------------BBBXXBB------------X-------M------BX?------XM?B-----------BB?-----------XX-------BBBX----?--------B----------------oX-------------X-----------B-----------------o--------------
-------------------------BX??XoB?B-----------------X?----------X---------o?-------------BB-------------------------?BBB---------B--?---XM?M-----------XB------XXXBM----------XBB--------BBX-BB--X-------
---X?B--------------XBB------BXXB?------Xo------------X---------------------?BB-------o-------------XBB?B---------B---------------------B--------XXEB--------------------------------XB------XX---------
-----------BB---X?--------?XB-MBBX-------------------BX----B-----?BMBBX--------------------------------BBM-------MB?--X--XB?----------------------------------?M---------------------------BX---------MM
-M-------XX--BB--XXMM-X---------------XB-----------XB-?BX-BBBX-------------------o?M?BX------MBE??X----------------X-BBB---------?-B---M-----BXB-----------M?-----------XB?MM----XBB---------B?---------
-----------------X---------BBBXXB--B--------------------o??B----o-----------------BBXXB----?B---------B------------------------------MBBB-B--------------XX----------------XBBXBXBBX---------oXB-------v
--------BM---?--------BB-----------??-oBXBB----------------------MBE?---?BB--------------BX?XX--XXBBXB-----------------------------BX-------------------------------B-------------------------MXX--BB--f
---------------------------------BB--------------------------------ooXBX------B?BXXBM-----oM?-------BXXB------MoMBM-------------------------------BB-----------------EMB-X??--XX--XBXB?-------------MBBf
----------B??B-B?B----------------------------o?-------------E----------------------?XX?----o--------------------?BBB------------?------------EMB-------MX-BB--?BBB---------X----XXXBXB?M-XM------B---Bf
------------XBBBo----------------X-------XB?-------------X--------------------------------?-----------M?-------BMB---------XB-X------------------------------------------MX?---------------------------f
-----BXB-------------o?----??B----B-------------------------XB-------?B-XB--?------------------XBX--BB?XMM------XX-----B?-------------------EX------------MXBB----o?XX------------------MXB?--------BX-f
----------------BBXXB------XE?X-?XBB--------MXBXM---------XXX---BBBXo----BB--------------XB-----X-------------------------------------BBXX?BB---M-----XB------------------------------BB---------------f
m---------------------------oXXMX---------BBB--------------------MB------------------T----------MBXBBX--M--B-----------M---MMB--------------------------------XBBB------------X?------M-------BM?------X
X?B-XX?------------XBMXBM------------------------------B---------------------X?-------B-XBX---B-?-?-??---------------BX?B------------MBB------------BBBXB-----------------------B----------XXXXBBB---oXX
XXXXXXXXXXXX-XXX-XXXXXXX|XXXX--XXXX|||XX-XX-XX-|X|XXXXXX-XXX-|XXXXX|XXX-X-XX|XX-X-XXXX-X-XXXX-XXX-X-X|X|XX-|-XX-XX-XX|-|X-X-XXXX-XXX|-X--XX-XX-|XXXX|XXXXX-|XXX-X-XX-|--XXXX-X-XXXXXX--XXX--XXXXX-XXX--X
