-BBBBX-----------------------------------??------oB?-B----------------BBBBBB?XMB-----------------o----oX--oBBB-----XXXBBX?X-----XBXX-------??--------EBB---BXX-------------BB------------------X?-------
------X?-------------XB-------------BMX--------B-------X?o--------BoB--BB---X?MBBB--?-----?B---------?--------------------B-----?B--------------?BB------BB----------E--------BX-oB--------------------M
-------BX-----BX-----------------------------BB-------------EXB-BBX----------X-XXX-------MB----------------MB?----------------------------?--------B?-----MBXX---------------------XBX--BBX----BBB-BBX--
----MMB?--------oB----------------BX------------XX----EX-------------------------------M?X-------------------------BB------------------BB-------------XBoX----XXXX-B--X-B--------------BXBB----------??-
---B-------------------------------B----BB-----BB?XBB?-------------------X-----BBB--------------------------------------XMMBXMXBXX?-------------------------BB-------------XXM-------------BXX----------
---------XBB----------------?X-------------------------oBBoXBB------B---------o?X--------------B---------------?BM??-------??B?-BX--------XX-----?---------------------X--------------BX----------------
---------M-XBX-----------------B---BXBM---------XB---XXB--------M------EXX?--------M------B--BB------?BBXB-------------o-oBBX----------------??M-----------XM----??---------------------------BBBB---XB-
----------------------------B-----------MB-X-----B?B---------XX--BBBB----------XX---------BM----?--------BXB----BBB------------------------XBB-----BX------BB----B--------------?BB-----------EB------?v
------------------------B?---oX----------B?B-BBX-----X-----------BBB-------o--M??-----B--------?---MBXB-------X-------XBB----BBB----XBX---------------B-------B---------------------------MBX-------oB-f
---M?--??M--X-----BM-------M------BXB--BB----------------X-----??----B----------------B---------------X?--------?X--BXX-oB---------------------------------------------------------B-----------?BBBXX--f
----B?-B-----BXMX--B---??BBBBM?---XB----o?MM-----------X?--------------oB----------XB??B----------------------------------XXBXMX---XX---?BBBBBXX------B---------EB---XB---------------------o----------f
-------------------------------BB?B-E--BBM-----oBBXXX-----------------XXX?X--------------MB------------------?B?MX---XXXXX------M---?B----------B-----------------------BB-----------------------------f
---?--------oX----------------o?----------------------------X?-----BoB----M----------?X-------------------BBB-------------oB--------E------------X----------BX-----------??BB-------XMX---X------------f
--MB-----------------------B--------------------------------------------B--?---------T------MBBBBBBBBBX--------------X------------?X?-------BXBXX?---EBBXB---------BXXB?-BXo-------------?XX---?XB---X-f
m----B--?----BBX----------------T---?XB-----BBXBB--M-------------XXX-BBX--TT-X?--BB---T----oX?X--T-B-E-T-MBXT-TTB----------B--B-XTXBBX?--XB---------?---T--------------BXBBB---B------XB---BB----------X
X--XXXXXXXXXXXXX-?XM?MXXXXXXX--?|?XXBXX-BXXBXXXXXXXBXXXXXXXXXXXXXXBB-XBBXB?MX-?XX-MMBXBBXBXXXXXXXXXXXXX|?-XX|---XXXBXXXXXXXXBMXXXXX-X-M?XXXX-X-BBBXXXXXB|BBBBXXX-X-BXXXXBXXXXXXXXXXXXXXXXXX--BBXXXXXXXXX
