--------------X----X-X---------B--B--------------X-------MXX-o-o-------X----B--oX--------------Xo--E----X----?--X----------B------X-?--BX--X--B-----------------------B---?---------------------------X-
------T-X---?--o-o-----?X----?------E------o-?---------X-X--------X-X-------B----------o----B--o----X---E-X-XX----------------X---M?-E---oE-MX-?-B--?---o------------------X-E---X-X---------M-X--o-----
--?---|XE---------E------B-X--X------X----?X---BB---?----------X--?-------------B--o-XXX-----MX-----X-X------XE--XM------X----o---X?-------------------M-o---XE---BX-XB------X-B--o---XM-XX-X--------X-o
----o-|---B--Bo-----X----M------X-o--------X---X---X-X---XMX-E-M--E---X---M---X---XX----X---oo---X------X--X-o----oX-----------?BXoo-------------------XX--X--o-------XB-o--X--XE-M---X---B-EM-----B---o
----o-|--------------Bo----X?--------Xo---------B?--X?------?----o--?------E?--------o-o--------B--E-X----X------Xo---B----X---E----X---------X----X---XX-B------------X---X------o-B--X-----o-X-XoX--XX
----X-|-Xo----------X---?-X-oX------B------E------?------XB-B-------B-X-X----B--EE---------X--B-------X---E---o--o--------X-X----?-o--oX-X-------X-X--E-----X-o----oEX---o-o---o-B-XB-XBBo--BoX---X-----
--X---|-E--X-----o--------B-X-B-------------B---Eo----B--X------------XX--Eo----?------------E-----E---X----X--X--X-X------------X---BX-----X-------oo-o-X----MX-----o-M-----B------------X---?--------o
------|------X--X-o--X-EX-X----------X---X-X-X---BX--?----E------X------o------BX---B-Xo----X--o-----?--o-?----o-----------X--X-o-----X-------X-X-o------X-----Eo---X-M-o-----M----B--?----X----X---X-Xv
X-X---|----------XM------------M--X---------BM--?--B------o-X---X-XE-----X-X---XoX----oo-B------E---?----------B-X-X------------o-----o-?---B----------------------o-XB--o-------X--E------X------o-----
?-o--E|?------M---X-----------XX?---------------o--X---------o---X--B--Xo-XX-X------------Xo-----------o----E---------B-X---?B---X---X-----o-E-----X----o-XBE--X---X--X----E------------?------Xo?----BX
--?-X-|---E-----------o-EX-o-B------X---o-X-------o----X-X-Mo--E---?---X--X--o-------o---X------X?-?X----X----o--------Xo---B----------o----------B--XX--X--X-----X-B------X?------M--B-X-----BX--------
----X-|-----M-----B-----?-X--X-----XX--o---XB-X--M------B----o----------X-X-----------X--X----------E-----o-X----X-B----------X----------X----------X---BX-X--o---E-----?----X-----X-X-XX---?X-XX--X---X
--To-?|--TX----o--------E--B--X----------E----X-X--------X----XM-X---X---oX-X----------X-o---o----------------X--------M-------X--------X-------X----B--X-----X-?--o-X----o--o----X?-----X?BXME-X-----X-
--||-X|--|-----X------X?-----o---XM----XXoT---B---B--o--X--X-T--X---E-MX-----------------o----------o---Xo-----X-X?-X-X-------X?----------E-B---o------------X-X---o-X-------X-------B--------EX----B---
mo||--|--|-----E-------B--M-X---X---------|X-----------X-?---|-----oX-------------o---------M-------M----o--X----X--X-------oXo---E----o--X-o-----ooB----E---B-o----o--X-----X------X--E-X-------E--X---
XXXXXXXXXXXXXXXXXXXXXXXXXXXXXXXXXXXXXXXXXXXXXXXXXXXXXXXXXXXXXXXXXXXXXXXXXXXXXXXXXXXXXXXXXXXXXXXXXXXXXXXXXXXXXXXXXXXXXXXXXXXXXXXXXXXXXXXXXXXXXXXXXXXXXXXXXXXXXXXXXXXXXXXXXXXXXXXXXXXXXXXXXXXXXXXXXXXXXXXX
