-B---------------------------------------??------oB?-X----------------BBBBBB?BMB----------------------------o---------------EBBBXB----------BBBB--------------------E------------------X----B?----------
------X?-------------XB-------------XMX----------------------------------------oXXX----?BBB----------B?B---------XBB------B-------o?---------------------------------E--------BXBB-------------------X-M
-------M?B-----------------------X----------------------BBB--BB-----------------------BBBo?B----BBMX--------------------------X--?X?----XB---------?------------------B?B-B?----------------------------
----X?BXM-------oB----------------BXB-----------XX----BX----------------------------XB--XM--------------------------?-------BX--------MMB?-----------------------o--------------------------------------
---X-------------------------------o----BBB?---BBXXXM?-------------------X-----BBBX-------------------------------------BMMXXMXBXB--------------------------BX-------------XXM---------M---B?B--BoMBMX--
---------XX----------BMB---------------?XX?----------BBB-------BBX------------------------------------B-------------------BBM?----X-----M--?BXXBB?-------------BB-o------------------------BXBB---------
---------B-BB------------------B---BXB----------XB---XX---------M------BX----------B------B--BB------B-------------------E--B----------------B?B--XBo?---oM--------------------B?X------------?X--------
----------------------------BX----------XB-X-----B-----------X---BBB-----------?X---------B??---B------------------------oX--?BB----BXB----B--------ooM--------------------------M-----XBBX?-----------v
------------------------X----BX----------B---XXXM----BBB---------B------------------------E-?BoXBXXB----------------------------X-----------XXBBX---------------------------------BBBBBM---X-o?B?XB--B?f
---MXB----------------BX-----------BB-------BXBB-------X------------X?--X------BBBB--oBB--------XMB?---------B-------??M?-----------BBB--B-------BX-------XX-------------XX?MB-MMB----------------B----f
----X?-B-----BXMXMBB---MXBB-------o?XBXXBB-------------X----------X?-XoBX---o--BM-----------B-------------BB--------------------------BMX----------------------MB------X---------oXMXX----------oXB----f
-------------------------------B??X-E--XB------oXBBXX--------------o-XBX-----------B--M?B-------------------XB---M----M------------------------------------??X--------------------XBB------B?M----B--B?f
---?--------o-----------------oB---------BBB----------XBB----------XXX------EBB------X?B??B--BB------------MBX?------------------------------X?X-BBM--------BXBM---------------------------------------f
--BB-----------------------------B------------------------MB---------B--------X----oX-------B--X------------------XB?B?-BX---------B----MBX-------------EM----MXX--BBB?------------------MBB?-----BXMB-f
m----B--BB?B-BB-----------------TB--MXBBBB--BBX----T-------------X-BX-----E?--?--XXBB----------o----X-----------B-----X-??XX----------------XX---------BB----------To--B---BB-----BM------XXX-X-TMTM---X
X--BXXXXX-XXXXXX-?XX?XXXXXXXXX-?|MMX--X-BBX?XXXXXXX?XXXXXXXXXXXXXXBB-??BXBXXX-XXX?BBXXBXX-XXXXXXXXXX-XXXXXXXXX-----?XBX???MXBX-MXX-X-XXXXXXXXXXXX--X-XXXXX-?-XXXB?XBXXBBMXXXXXX-XX-B-BBX-XXXXXXB|MXXXXXX
