-------o-----B-o--------X-X-----M-XX----X-----X---X-----------B-oM----XX--M--------o------------M---------?BX--------o-----------------?----X-E-X----o------B-------M---E-B--B-------o-----o-----X?-----
------TX------B----o--B-BXB--X---------------X--o------?----X-X---E---o--X-------X---B--?--X--------X?-----?-B--o--X------E---------o-----BoX-------oXo------XX----------EX------E---B---X--------------
----oo|-B---------M----?-Xo-B----B---B-B-----X--o-----X-Xo---?----------X---X-X-oX-------X-E---X----------------E--XEo--X------?---o---X-------X--XE-X----XX-X---M---X-------o?-B---o?X----X?--?--------
------|-X---E------XX-------B------X-X--X--X----X-----o-X-X?------XM-------X-o---E-------XX--XX--B-------XX------X------oX--------M-----M-----X--X---X-X-----X--------X-------o----B-----o--X--B---B----
---X--|-B?---------X-B---------X-X----Bo-------X-----B--M-X----Eo-E--------X------?------?-E-X-------------X---X----X---?---E----o---oB-----B------X---X-B-X--------MX-o---BX--------o-------X---XX-----
-X----|-----X---X----X----BX-XM-----------X----XEM-?-o-X--X-----X-?-o-----o-------MX-o??-M----o--B------XX-X-----?---EX----?------------XXE-B------X------B--?---B--X-----X---oo---o--oo-----X------M--o
--X---|o--X----Xo--------X--o----------o-------------XMX---?----E----X-o----X----XX-------------E---------------o------------XM---X--------X---------XX------?--B----?-----o---B--------XE---------XX--X
-----M|-BEEX----E---BX--Xo-o-------B----?o-Bo-X---M----------B-X---oE--Eo--M--------XB---------X----X------------XB----------------X-----o-X-----X-o-----------------X-oXoX------?---Bo--XX----XB-----Xv
-B----|-----E-----B?---o--o-EXX-------E-----?-X-----------X--X---?------B-------B--XM------o--o--X-----XX-------X-------B-X-------XB----MM------o--E---XX-X---B-----X---------X-?----oX-M---M-X---BX-XBX
------|X-----------------B----------------------?--M-oX-o----------M--X?X------X--X--X---X--------------X-------X--o------------B-----------X---X--X---------o--X---?B----oo----------?------?------E-B-
------|---X---E-------------ooB-----o----o--E-XoX-------X------o---?--?-------Eoo-----o-XXXX----------------X----B-----o---o-B--X------X-X----B---XBX--B---E-X------X--------?--X----XXE-B--X--------B-B
------|----?---B--------o---X-----o-----M---------o---X---------X-?-o--B-X?E----B---?-X-----B--X-----B-B---X------------X---X-----------X----B-XB------------B--X-----B---X-X------X-----XX-o------XX---
--TXXo|--T---XX-----M---o----------o-------X----BX------oX--Xo-M?---------X---XEM?--o---E--X-----X----------M---------o---X-----X--XEo------XX---------oB--X-E-E---B------oE---B-E-B--X------o-E-----?--
--||--|--|-T---X--o-------X?----B--M-?-X-E-?--oB-----------X-T?----X--E--o----------Xo?MX--BoB-X---EXE------------------oBXME--o----X--?--X-X-M--EX---B-X---X---------MT--X-------T-oXM----o-----B-E---o
m-||--|X-|-|-------X?---E---X-------------?---E-X-----o------|--M-E--------------oo--XT-----o-----X----X--XX------?-----Xo------X---------X-X-----------X---X-o--------T------XB--TX----X---X----X-X----
XXXXXXXXXXXXXXXXXXXXXXXXXXXXXXXXXXXXXXXXXXXXXXXXXXXXXXXXXXXXXXXXXXXXXXXXXXXXXXXXXXXXXXXXXXXXXXXXXXXXXXXXXXXXXXXXXXXXXXXXXXXXXXXXXXXXXXXXXXXXXXXXXXXXXXXXXXXXXXXXXXXXXXXXXXXXXXXXXXXXXXXXXXXXXXXXXXXXXXXX
