---oXoo----oX-----o-X------M---X----------XE---------?--X----B----o-|o--X-Bo----?X-X---B-----X----o-------X----E---E--X------o--|---------X---Xo--EM-M?------B-------------M-Xo--o-----X---oX----MX-X---
X---E---------XX--o--XB---?-B---X---X-------------B-M--EX--------------------X----BX------X--XX------------|------X---oXX--X--E----B-o-X----?oX----X------?-o-----XX---------------?T-o-X-oX--X?-M----X-
-X------------B----XX---------B-------------X?---------E-------------E--------X?---X----|--XE-----o----X--E--X-----?-----------o----BB------------X---XX-----------------E----X---BX|X-----X-----?o-----
---X----E----o---?----?--------o--XX--X-Xo-----------------XX-o|----X---E-X---o----X-----?---------------B--------E-X------o-----?--MX--|-----o-X-X-------X--------|-|-----X-----Mo||X---oX-X--------XX-
---X---B------XXB--?----EXo--X--Xo--o---XX-BX---|-X--------------X-X-ooB------------E--X--|-oX-B----------BB-E--X------o----X-EX----------X---------M----E------?----X-XE--o--o----X|-------oo-B--------
----------X--X-o|---X-X--|-E---------XX---------------X---E-----?-----B-XB---E---B----X------X-------------X-X-XB-X----?--B-oB---o-o--X--------|---EB--E----X--M-X--------XX--------|----------X----E--|
X-EX-|--BXEE---oM-X-X--Mo-BoX-----X----------------------X---------X----X--o----X--E-----E--?------X----X--X--o-----B-o----o---X--oX---?--X-----B-------XoXM----|----X-------o----o-|----X-?X-X-BXX--?X-
--B-----B-o---B--?-----X--------E----------|---XX----XB----|BB---X--E---------------X-----M-|---X------M-M---BBX------?-----X-XX----X-B--o-X--XEB---o------X----------X-----------X-|o--B--X-o--X------v
--E-------B---X--M--------------o-|--o-X-----?---XX--X--E--X-------oX------?--?--X-MX-----X--?-o--X-o---------X----?--B-----------o------X-XX-|-----|-----X--------o--M-----o-o--X--|--ooo--|XEX----o---
---|X--M-----XX---BXX-o-|----B----------------o----------oX---X----------BB----?--oB------------X--X-----X-o-XX-?--------?--?-X-o---------o--?---Xo-XE---B-E----------E--B-o--X-B---|o-o--?-------------
|---X-----B----B------MX--X--E----------B-B----Bo--------X-X-XB-XoX---?|----oB----XX----X------?---E-XoE----Xo--E----B|------o------E-----------X----X------XE---------------?------|-----X--B-----X-X--
-------EB--E---X-X-----|-|----X---o--X-X------X-|-X----------o--o----X-----E--------o---X----?X-B-------------------B-X--X|X-------oXX---------------|-XX-B--M----?o---------X------|--X-E-X---------XBM
-o-?-|--B-X-------------o-------E-|---X----------X-----?-o---?-X-----B-B?-o--XX---------M--X----------o----XX-?--X--X----X-o-oB-----XXX--X------X-X----------------------o----------|-------------X---oX
---|--------?-X----X------EX-------XX-X-?XX------|---X---------X-X----X--o-X----X--XB---------?-----X-X-X-X------------X-X---X-oB------------E------o-?---------BX-----EE--oX-------|X-E--M-?X---X-----X
m-----|-------B--o-X-?M-M-------X-------------X-o--------XXB-X?-----|-------X---XX---------X---X--o-------?-M--o-XX--?o?BMXB---X----o-Xo----B---o---X---?---------X--o---o-X--B-----|----X----X--X------
XXXXXXXXXXXXXXXXXXXXXXXXXXXXXXXXXXXXXXXXXXXXXXXXXXXXXXXXXXXXXXXXXXXXXXXXXXXXXXXXXXXXXXXXXXXXXXXXXXXXXXXXXXXXXXXXXXXXXXXXXXXXXXXXXXXXXXXXXXXXXXXXXXXXXXXXXXXXXXXXXXXXXXXXXXXXXXXXXXXXXXXXXXXXXXXXXXXXXXXX
