-------?B---------?------------------T-----o--o-------E-----------B---------o-----------------E---B----o-------------E--BT-----------X------?---------------E----E-------------------o-------o--o-------
--------?---------------o---------o-------|--------------------B-?---------------------o--M----------B-----E------------o--E-o---------o--------------B---X---E-TB----|-----o-----------oB--------------
--E------o---E--E---------X-?---B-----B-------?-----B--o----BE-B----------o--o--------?--T---o-M--E-------o----X-----------------?-E---------|----o--B-------XM---------|B--M--X-----?-----M-o----------
-----BB--B---B----------E-----------|-------B---M----------o|--E--------o----------o---o-?X------|-----?E-------------------X---M-----------oB------------------Xo-------T---------B-----B----|---------
----o------B----?--oX------?--------o-E------o---------------------BB--------------------X-------oB-M---------B-?-------------Moo------?-------------E----B---|o-----B------?E------------|-----o--B|---
----B---------|--T--o------B----T-B--------------|-T--o-B------M--------?--o------?-----o|-------------X----B-----------X------------------o---?------------------o---------?-----o---------------------
-----E-B------B-------------oo--------------?-ooo------------------EE--BBo------------------------------X----------------M-B-|-----------------TB-B----------E---M----|-------B----------X--------?---B-
--------BX-------------X---o------------------B-------------?------?--------------M---B---------o----------------------B------B----?-------------?------------------oXT---E-----?-X------T-------------v
M-E--oMo----------E-B----------?-----------B----------------BB-------------------------------------------o-----------?--o---oo-----X------------E-E---o-----EM---------------E---T-----o----------------
--X--------|--------T?------------?----o-------------------|-------------------------o-B------------------------E---------M--B-------E-----------------------o---o-----B??----B------------------B------
-o---B------|--o--X--B-------------E-----o---o--EX--------------?------B---o----------------------o?-----?-M--B--------o|--------------B-------|--?-|o---XB--------------Xo-------o--BBE-------|--|-----
-----X?-|-------X----------------o-------E-?----E----|------M-------T------------------B----o----M---B-----------B-----|--o---T---o---------o----?---E-----|-|--B----------------o--o------M-------T----
X----o-----o---------?-ooE---?-E-----X-----------M---X------------o--------------------T----|---oX----------------------B-----X---T--?------|-------------B-----------TB-o------?--------B--------------
----o----------T-----------------o-----B-XB-------T-------------------X----------?B----T--------------|------------------B-----------TT--------|B-----E--X---------o-------------X--B---X---B--?--E--E--
m--X-EB-------o|--Mo-------X---BB-B--------------E----------B--------B------?------------?-------------|--------------------------------B--------------?------------------X---------o-E-?---To------o---
XXXXXXXXXXXXXXXXXXXXXXXXXXXXXXXXXXXXXXXXXXXXXXXXXXXXXXXXXXXXXXXXXXXXXXXXXXXXXXXXXXXXXXXXXXXXXXXXXXXXXXXXXXXXXXXXXXXXXXXXXXXXXXXXXXXXXXXXXXXXXXXXXXXXXXXXXXXXXXXXXXXXXXXXXXXXXXXXXXXXXXXXXXXXXXXXXXXXXXXX
