-----BX---M-----------E---------oE-E-M------------------------?---T-----XBXB--XX-||----------------------XXB-------E-----E?X-T------EM?B---B----------------BBMBM------?-----XXXB-----------------------
----------------------?X----M-T----------X-----BBE--------------T-------------------------X-------o--o-------XX---T---E--BBX----------------o--------------------o-------------E--------BX---oo---------
--------------?X?--B--M----TX-|BM--BBX--M-------E-------------T------------M---------X-M-----X---M---------------E-------T---o---T-------o---------------------------T-M-------------X------------------
-?-------B-----------------B?B--------------o----------XX---------MB--o-----------------ooM----------?-----B?MB-B-BB-----|-X--?X-|X-----------------------------B----B--------------o-----------TB------
-------B-----T----XB-E--------M----BB-------E------o-------------------X---------TB-BX?B--oB---TX?----------X--------------B----XX---M--oXB--?--------T----------------oBX------------------MXB?--------
---o--------XB--X---MB----------------MM-----------B--B-B------oXT-----T-------MM--XX----XT?BBM-----EB-------------T-B-----------------------B?----B---BoBT--X------------------------T-----------------
---MXE-X---M---------X-----o----T------------T-E-----------X-----|-----|--X-----?---------|-B---M-----XB---M---------B------?--------X------------------------?--?-----------------B------MX--------X---
----MB----TX--------------------|T----------XM-X-----TTB-------------TX------o--o-?---B-E-------------------XM--------E-XXBXo--------------X--------ME---B-?-MX--X--------o----------------TM--B-------v
-----------XMBXX-------------BT-o?M------------------|-------------B--------X------------B------B-------------------B------------X----------?-----MM--------------------B-------BB---------------------f
--?-oXX-------------oB-M----------o-------------XXo----T------------X--X---B?X----X------M?-BBXT---XBB---T--B-MXBB----------M---T-o-?XB------M--------------------?------MB---X--?-X----M--------------f
-----EM?BBX------------------B-BB--X-----------------------?-------X-------B-----------oBB-----|---------MB------------------------------------------XBXXXX-------B--B---o--MB------------X---------TB-f
-----MX-Mo-----------------------E--------BX?--X------------TX-------XB------------T-------X----BX-----------------------------------------oX------------BBBXoXX----BM----------T----------BX-B-----?--f
------------oXBo-------------o----XTo---------o--------------?----------------X---X|X-B--------------X?---T?------oB---------B---T--B--BBM-o-B-------X---Mo--BB---------X-------|-X-T----XB--------X---f
----------------------------o-----------------------M---------B-MB---------------MoX--BB------X-BM-------------------------Bo---X|------T--------B---E--------------------M---------|X---------M-------f
------B------------------BM--------------oX-----o--------------T?----EB----------------------o-------?---------------TBX----?----------B|XB----T-o------?------?BX------X---o--?--TX------X-BBM------o-X
X------------------------------------B--BX-------------T----BB-?-X---------------?B--MB----B-------BB--?----BM-B--------------------TM??------------------------B------?BBX-??BB--B--------XXBB--------X
XX-XXXXX-X-XXXXX-X|XXXXXXXX-XXXX|XXXXXXXXXXXXXXXXX-X-XXXXX-XX|XX|X|XXXXXXXX|XX--|XXXXXXX-XXX|-XXXXX---XXXXXXX-XXX---XXX--XXX-XXXXX-XXXXXX-XX|XXXXXXX-X--X|X-XXXXX-XXXXXXXXXXXXXX-XXXXXXX--XXXX--X-XXXX-X
