--------?-----XX----X-------------XXM-M--X---X-----XB----X-----B----------X----o----??--XX---XX-oX-o-X-----XE---MX-------XM---EX-----------------------X----B---EE-X---o-------X--?-----XB-o----oo-----?
XX?-BE--XX-oXo------Xo-o-X---o-------------X-?---X--------X-o---X------X---X--?-----o-X?X-oo----X--X-----B-B---M--oB---E-------B--X-o-X------M----E--Bo-X-o----XX---XX------X--o----E--Xo--------XX---B-
X-X---------X-B--X-X---E------EX----X---------------------------X---o----B---XM----X-X?---X---X-------EX---o-----XX----B-------?-----o-----X--B----o---B--oX--B-----X----X-oX--------?-X----------------
-X----------o----------oB-?--X-----B-B------X---X-----E----------X-Xo--X-------M-E----E--oE--------X-------X-XXX---Bo-X--------XE-------X-------------?---------------------?-------B-----------o-X-----
-----------------E-M-?----B--o------------------------o----------X-XE------?---------------o---------E-X---oXB---M----X-----Xo-?-ToX--X----M--X------B----X--?--B------X---X---o-----X-X-----X---B--MB-X
--X-?----XoE--B---?-o---o----------B---X----------M-X------Bo-X----E------X-X------X--X---------o----B---X-EX---?BE------X-----?-|-----XoB--oB-------o----X------B------X--o---------o----------XX-?--?X
---M-----XE-------B-----?--X-o---------Xo-------------?o----X-o----B------E-----X-----X----X---M---o--------------X------B--X----XX---X---?B??-o--oBo-X--------?------B-------X---X--o-----oBM--M-----o-
X----------B-------X--X---------------X-------B--X--X----EXE--X-Eo--B-oX-----X---X---X--Xo-X--B----------?----?-X----B---------o--o--XX--?--XX-------X-------oE--o-----------------------Xo---o-M---XM-v
-X-----------MXX--?--o--B-----B-X----X-X-------X-E-Xo-----------XM-B--X--B---B-X----------??o------X-------------------X----X--X---B--X------?----X-?--X-----X-X----------o---------E-X---X---X--MX-----
--?-B-----------B-?-X--o---B-----M-----X-------o---B---------X----X-------?----------o----------o---EE-----X?X------X-o--X------B---------X-------X------X---?-------B--?X----X---X------XX----X--X-----
-----M--------B----M----X---------?------o-------X-----X-X----------X--X---EXXB-M--X--XE----X-?X-o-Xo-o----X--X---X--XB-?----E-X-XE----X?-------BXE--X------X----M-------?----------BX-----oE----XB--o-X
----o--X-----EMX-X---B--------------oB----B-----?E---------?--------o?--oXB-----------?X------Eo---------X-X-?---X-o-X---BB---------?------X------------?-oX--------X---------------E-o-?--X----X--?----
----------o---X?-X--M------X--------------X---XB-E-oE-----X-o---------------------o----------X--o-X---X-oEB---oX-XX-----------oo-M-M--?---MB--M----X-----------o-------B-----B-------XXB-------B--X-----
-o------E---X---o-----B----XT--------------?--B-----XX--T-o---B----XX-T--X-----E----------M----o------X-------EB-----o--XT--o?----T--o--X-----T---------------------------X-E-----------XB-X--?-----o--B
m--o---------o--Xo---B-X--o-TX-X----X------B-------X--B-T-XX---X------TBX-----EoX-----B---XXBX------o-----B-----o---E-X-X|X----X-B|--X?o----E-|M-E-X-E--E------BB--------X---XX-----?-----Bo-X-----X----
XXXXXXX-X-XXXXXXXXXXXXXXXXX-XXXXXXXXXXXXXXXXXXXXXXXXXXXXXXXXXXXXXXXXX-XX-XXXXXXXXXXXXXX-XXXX-XXXXXXXXXXXXXXXXXXXXXXXXXXXXXXXXXXXXXXXXXXXXXXXXXXXXXXXXXXXXXXXXXXXXXXXXXXXXXXX-XXXXXXXXXXXXXXXXXX-XXXXXXXX
