----X-------XXo---BX-----------------X?E-X----------BXX-B-E----BoXX------XX--oM?o---M---------EXX--X-----------B-----o---B------XX-------------X------o-----------------X-X-------X--X----X---o---------
------T-X---M-X--XX----X-----X-M----B-EX------B----Xo---B----------X--------X---X---------X------B-----------o--------X----oX-B--?------X-X----X---X----X--------E--X-?X----BM--------X--B-o-X--B?------
------|---------X----Xo---?-----X--MX------?---X----------o-------E--X--Xo---o------X---X---X-E-----o----M--X--------o--XX-?---X----------Xo----------------B-----------Bo-XX-B---------X----X----B?---X
-B----|-o---E-------------?---XXoE-------M---XXo---Xoo---------X-B-X-X---------E--Xo---X-o--B-------X------------X----X--XoX-X-o-E--------?M---X-----XE---------E--X---X--X----E---MXo---?-o?------X-o--
MX-?--|B-X-o----?---?-X---X--------X--M----------?-X-----------E--X-o---X-------?--------o-E-X------------o----o-------X-------E?--B------X------M--X-XBXXEB----------?-M------o---o--B-X---?-o------XE-
------|-------o-----XXM-------------EE-----X---X---?-B---E----X-----E----X-X-X---X-X-MB--------B----------B----?-------------Xo-E------X-------EX--------B-X-----?---BM-------XB-X-B---XXX-----X-----EX-
---o-o|----XE--oB---------X-------------XBX--o------M--o---------o---------------X--o-------X---M---------B-----------o-----X-X---X-X--B------------M--XX--X---------B-----XB-----B--------------B-E-o--
------|B---X--B---X---?X---XX-------------------o--X--BX----M----oX-----o------B--o-------?--?-----------X--?--------X-----X-----X?---EB-XXo--X------------E-EB-----X-X-------o----X------B--X-E-------v
-XE---|M-------X-----B--B---------X----o------X----------------X----X-?-----o---E-oB--------X-----?-------o---B-X---oB---X-?-----------X-------X-------------o----M--------------B-------XE-----MB------
-X----|--B--X----B-X------o-----------X---o-----------------?-X---------------------B---oX----?-------o-X-X---Bo-------B--o-----X---------X--------------?--M--X------o------------B---------X--EB-oX-o-
--?-o-|------?---X----X--------X?------------------------B-X----X------------B-----B-o-------------XB---X--B--?-o-o-----X-------X---------------X--X--------?X?--X---BXX--X------M--------oX--X------B-E
------|-B----------------M---X---Xo-----------X-----B--X--X----X----X-E-oX--E-oB----------------E----EE-------------o-X-Bo-----X-o--M--------X-----Bo-------o----o-----------o----o-X----------------?X-
------|-----------B----XB--X-B----X----B--M-X-------B-E-X----------E-XBXX-MX-X------oXXX--------------------B-XX-----o-------MoB-X----------------B--X--X---X----------E---?----X-------?-B--o------XXX-
--M---|--B-X-----X---XX------X----------X---------------E----------B---X-------------X----X---------------X-------X----XX---X--M-M-X--B-------------o---E-----o-E------o---o----o---?X----XX--?------B--
m-X---|--X---|--XM-----?--------o-T------M---------X-T-XX-----|------Xo-X---XX------X--------------o-----E--XB--o--o---?XX-X--X--XE--XX----X--X-----X------E-X-B---T-o-------------X-MoX-----------B----
XXXXXXXXXXXXXXXXXXXXXXXXXXXXXXXXXXXXXXXXXXXXXXXXXXXXXXXXXXXXXXXXXXXXXXXXXXXXXXXXXXXXXXXXXXXXXXXXXXXXXXXXXXXXXXXXXXXXXXXXXXXXXXXXXXXXXXXXXXXXXXXXXXXXXXXXXXXXXXXXXXXXXXXXXXXXXXXXXXXXXXXXXXXXXXXXXXXXXXXX
