---E------Xo?---------X-X---?-X--B-?oB--X--------X---MM--o--?--?-----X--o---------X----E-----MX-X---X-X------o-----------X-----X----B---E-o--B-----X------X--?-o-XX---B-X-------E--X--?E----------o--X--
------T-oX---X?-----B-?X--------XX-MB-----------EX-o----------XX----X?-XoX-E-----?M----o----XX----B-X----------o------X-----o----------o-X-o----oB----X------X---------X-E-----X----B-------E-BE--------
-X---X|-----X---E---X--?----B------------BX----oX--------------X-----X-X-----X-XB-X----------M--B??--------XXXX----o------Xo-------?-------------------X-B-----?B--X--B-XMB?---E---X-?--------XM-o------
o---o-|-BE--------X--?-Xo--o--Bo--E--------o----------------?--X---------E-X---o-o--MX?---B--------?---o---X-B------------B-o-------X----------------X----XX---B---?XXXE-B--oXXX---X---B----------------
o-o---|-X-----B-------E----oB----X----o-X-o-o----------------X-X-X-XB-----------X---X----B--XX------o----XE?-?--Bo-B----XXX--B--oo-oX-----X-E-----X-----o---X--M--X??----BB-E------X-------B-----X----X-
----B-|---?B----X--X--B------Bo--o----XMo---------Xo------------------------EX---------E----o------E------??M--X----B-----B----X------------M--?--M---------XXBE-X------------------X----X---------X-E--
--Xo-B|--E----X--X-?-XX-----X---------o-M-X-E---oX-o---X-----XX-XX-----------E-----o-B---EX----------X-X-X----X-M-X-----------o------E---B------B-X-X-X------M---o-X-o-?---o----X----X-E--B------X------
B----X|---Xo-----------------o-o-XX---Xo-----------?---X-B-----BM---------X--------o-X-XX---X----o----oX----?------X--o-X-----MB---------M---X-o-----M--X-E------XX--o-?-o----------XX---X---------X-oXv
---X-X|--?---E-E-X--X-?-X------X-X-X--Eo--X--X-X---M----M-XX-EX--X----XX---------------o---XX------X--o-Eoo-------B---B---------X---XB--B---o----Xo--------E-o-E----X---------B--o---?------------------
--Xo-M|------X----X------------------B----?-XX-------E-----M------?-----------E--X-X----X----X----B----EEX--o---XE-------------X------------?----------------------B----------o-X--oBoE---X--o---o------
-----X|------------------?--B-------X---E----X----oX-----X---------B---------o-----X----------o---------------M-XX---X-o--?------EE---------X-E---B---------B-----X------o----------?--oX---XB-----o-B--
-B--X-|----X-XBB-E-X----X---------?--X-o----X-----XX-X-B-o---X----o-------?-----?--?-------o---------------?-B--E---B----X----?B------E-o---o-oX---?--XX-------------------B------X--o---X-------X-----X
------|o-T--?--X---------------E---X---X-X---o---M---?--E-B-X-BXoB--X--------B---X-B----o----B-B--X-------?-------X-X-X---------o-?------E------M------E-E---?---X------------B-------X------o-----o----
----X-|X-|X------X--oB----X---o-TX--------------oo-o-----?---o-Eo---------XE-----XX--?---XX-----------B---X-----Bo-----o-X----T-XE-----o-B---B--?-X--------X-------E-----X--X---X-T--XXX--TM-----X------
m-----|--|B-X---X----XB?----X---|--X----------------------o-----X--o------X-X------X----X-E-o?B-----------------Mo?M----X-----|-?----XB--o------o--X-------B-----XE---E-X---------|---?o--|---o--XMX--E-
XXXXXXXXXXXXXXXXXXXXXXXXXXXXXXXXXXXXXXXXXXXXXXXXXXXXXXXXXXXXXXXXXXXXXXXXXXXXXXXXXXXXXXXXXXXXXXXXXXXXXXXXXXXXXXXXXXXXXXXXXXXXXXXXXXXXXXXXXXXXXXXXXXXXXXXXXXXXXXXXXXXXXXXXXXXXXXXXXXXXXXXXXXXXXXXXXXXXXXXX
