-----?----------------------------MBB------BXBM------o---------M--X-------------B-------?-------------XMoMBX------------------?XX--XXX?-----?X----------------------------------?-------X----B---M-XX-X-
---------BB------------------------??-----XX---------------oM-----------------BXXBXB--------XMBXX--XBB-M-----------------MoBB---M-----------B------o-----XX---XB-BBX?EB-----------B---------------B-----
--------------E?-BBBM--------B----M-----------------B------BXX?-???B-------------------------------------B--------XB------XX----------------------BXB-------BB-BX---XB---?X---------BB----------------EB
XMXBMX---------BBBBXBMX?---BX?X---E?oB-X?--XXBX---------oMM----------BX-----------------------------------------------MBX---------BX-----------------------------------oMM--------BBXXXBBX--------BB---o
-----BBX-----------X------BXB---------M?B-----X--oB---------XXX----------BB-----------BBBB----BB?------------MB-------BB----------------------------------BBXXBBXB?-X---------------------------?XX-EM--
-----------?BBB--------------X-----------EB--oB------BBX------B---------B----E-------------------------------X----------------------BBBBM---------B---X--BXXB--------o??------------------MB--BXMB------
-----------M---------?--------??------EMB--BB-------XMB----------XBBBB-----XB?-------BXX--------EMMXX--------MM----------XB----------BMXX--?BX?-----------B------B--------?B?-------BXB----?XX--B-------
------------MBB---------------Bo?--XX---?X?----B---------------B?B-----X-----------------------o----B??BB-------------BB--------------?XXBXBM---------------------BBX-B------XX--------------B------?BXv
---X-------MMBB---?-----?B-XBB----B-----------------BBXBBEBBBMB---------------------MBX----XMXB--B?------------MBBBoB?-------XBX-------oX?------------XXX---------B----?-------oBB---------------------f
---BX-----?X----------------?B---oMB-X-XXX------X------?XBX------?BM?---------------------------------------?BBM---------BB-----------------------------EXXX?-----oBXB-------B?------------------------f
----------------------XXXXB-----MBX---B----------BMB------------BX-XXXX--XX--------B?--------------X--------------------oB-B?BB------------------------------XX-B?-------------XXBBBBXX----------------f
--------?B?------------------X--oMXBB----?XB-----o?-------------?MB------------B?-----XXoB-----------X-BBB---------X-------BoM------------------B----------------------?XBBBBX--------------BB-------XBf
----------------------------------BoB?X?---------oXXXXM----B------------------BBBXXBBB--------B-BB-----------------BBXB------BBBBB?BBB------BBB--?XB---------XXBMMMBB------------------------MXX-----X-f
-----------------------oB?X--B-----------BB----------------?X---------------BBXMB---------MMB------MMXB--XX---?--------------BBBBBB-----------------M----------BBB----------------B?-------o?---XBB?---f
m----------------------------BB-------------BB----T---------------XX---------------------XX-XB--------------------?B----------------------?BXX---B-B----------------oB----?X??---------XoXBB-BBBB----BXX
---------------BXB--o--------------XX---------MB--BBB-------B-------------BBBB-----------------------B?--BBMM---BBXXB?MX--BB-BXXBB--?-----X--------?MB-----B--------o??XB--?-BBMoXBXB---X----BBXXB-----X
XXXX-XXXXXX-X|XX-XXX|XXX-X-XX|X|XX-||||X--XX-XXXXX---X|-X-|XX|XX--XX-|XX-XXXXX-|-XXX--X-X--XXXXXXXXXXXXX-X-||X--XXX-XXXXX-X-XXXX-XXX--X|X-XX|-|XXXX--X|XXX|X-XXXXX|XXXXXXXXXXXX-XXX|XXXXXXX-XX-X-XXX|-X-
