-----------------B--------------X----?--------MT---------------B?---M----TTX-EE--?|B--------?------B-T------------T---?--B----------B----------------------B---M-----?-------------BE?----o----------o-M
-----------E--EE----------------------o---o-----?E----?-----------------?T----|------o---B---------------||---------------o----M--------?|-------M-------oEE----X--T--B----o--Xo------------------B-----
--B----o--------------------------------o-------------------------E-----M--?-----------o--Eoo--E-------?----BM--B-----E-----o---------B?-M-------X-----------------------------M-ME---------?-----------
o-----|---------------|-?---------------M------|----X---B------T-----------------------------T?----o----?---MTE----o?--|-------o----------------B---------------?-----B--M---------------------E----M---
---B--?Bo-------|----------o-----E-------EE--------------------M---------------B----------E-------o----------X-----|------B----------B---o------------E--------------------------B--------------B-------
------------------------o--------|o------|-------B-|---?-M----B|---o---B------------?-B--o--o------?----------|-E--o-E-T---------------T---E---B-----------------BX-----|---X---E---------------------EB
-o---T---B------o------------B-----------?---------------o-X--T------?------------?-------B-----?---o?---------------------------oB----------------------o-M----M-----o---B-------?--o----?-o---M-----o-
-----o---------?------------------E---BX-------o--------X-------B----E---?-E--o------?---B---------B----o---o-------------------E---?-----o------------B-T---?-------B-E----E--------------o-------B---v
----B-X--oB----------------------------------?-B--T---------------EB----------------o---------------B----E----------M-Bo---------B--Bo----------------B----B-------------------T------?--o-M-T------M---
------E--------------------?---|---------------B----B-----E----o---B---M----------X---------E-------------B-|-?----------------------B--?o---------?---B----------------o?o----------E?-----------------
-M------o-----B---------B------o--------o-----------X-o---------o--Bo--------B----------|------o------B-o---------B-----B----B---X--------------EX-------|T-----EB------o--------------?----B-----------
------------------E------------------------o------E------|----?----------?--M--------?--?---o--------------------B----------o----|------|-E--------T------------o--o---B--M--------T---------------o--T-
---o--|--?------------------------|---o--?-------o----M---o------Bo-----E-------------B-----------?--------|---T------------------B------------------B-M---------M-----X--o--o-B---B-----------M--o----o
-T-EM-----?-------o------X------------M-----E-------------E-M---o-----BB--------?--B------------E------------------------------------?-X-----T--------T--------------------------X-------------------M--
mB---------------------E-----------o-----E-o----E--?------M?---X----------B--T---o---------|B------o------------E-----M|---------------o--?-----o-?----------------o------B-----------BB-------------E--
o--o?----------X--?----E-?------------?------M----E----------EX----------B---------------------o----o--o-E-----BM-o-------o----o---------------------X--EB---oo--B-------------o---------o--M-----?--?B-
