-?XT--T-X-X----oo----------------B-Xo?--oX---oX-BX-Xo--T---oX---E----------X---ET--------o----X------B-oTBo-X--BX--XX-?----oX-------?-o--------M----X--------X---X---XB?---XX--X-----o-----------o------
-X--X-TXX-----X-XoX----------X-B?--E------?X-----?-X---ToX-Xo-BoB--X---E---X--?X--?----ooX-o--X------------X----X-X--?o----o-E-----o--X--------T-?-B--X-----X------XX--------o---B-----T--X-X--X------X-
----M-|T------X-------XX----------o-----X---------------?-EX-XX-o-------M--o--?-BX--X?--?X--------X-----BE----M-o----E---X----T--------o-----?----------o--?----------B---?B------o---X--------XX-X-----
M----B|--?---X----M---X--X------------X----------ToE--X-----X--------XX--EM-------------X------X-o-B-X-E--o-----?------Xo-To---M-?X-XE---oo----B?X----?--Xo--X----T--X--B-------------?X-X---------B----
----o-|-BX--X----X-oo--------o----X-XXB---?XX--o----Xo--------o--------B---o--X-X-T----X---BX-Bo-o--X-------E---?--E--XXX-T-X-BBE?--------X--X-------E-X--X------------o----------M---EoXX-----X-o---X--
------|E--X--M----o-X--o--------XX---XT-----------B-X----BX---o--X--o---------XX-----------XX-o-----E-----o--XXBX-XX--E----------E----------oX-X--X-M----X-----XXX--------o-----X---------oB--?-----o---
XX-o--|X----B--E-M---------T---E---?EoTX-?-------------T---?T-X----------o--B-------------?B--------------X---------------o--o--oT-X--oX-X-----BX--B----------E----------ooEo--X--T-XX--E----------X--o-
M-X---|EBM----XB---------X--------------o----B----X-?oM--TX-----?---XX--X-X---M---X---------------X--------E--------X-----------o-----B--oo-?----M-M------TX------------T-oX-------X--B----------XX----v
-E----|--------------------E-X--BX-----T--?-----XX-------------------X----?-B--TX--BT-------X----o----------o--T-o-B---o--BX-B-M-------B---?XB------------------E------------X---MX-------B----?------M-
------|-X---o-E--o-----o----B-X--?X----T-------XM----oo-o--------o--?-------o--------?o-o-----Bo-----X--B-M------oE-o---Xo-X-M----B-X----?---o---E-XXE--XX----MX-------o-X------o----------B?--TB--X---E
-ET---|-X--X-------oooX-X--T-X--E--X------E--XXBX-E--M---oB-----B------X--X----o--Bo----Xo----X--X----X-o----X-?-----B-E-E----------o--X----B----To---oX------X------------X---XXB-B--TB?-----o--XT----X
-X---T|-----?Xo-X--o--?-----?-----------------X----?---X---------EX-B--X------?----o------X-----X---E----BB-o-XB-------?X---o?--------X--------------?X-EX-----B-----X-------M-Xo---------X--------B-X--
---o--|--T-o-X------E-E-----X------------E--------TX---------T---X-----------------X-?X--M----EB-o--?----------?--o------B----oB----oo----M---------?XB--B---------------X---X-------XX--M?-X----------M
?B-X--|--|-----M----X-----T-------T-------------Xo-BB----XE---X?-----X---B-----oEEXT-M------oXB-------oX---X-XB-----X----?----------------X----B---X?---?X--------X------E-TXB-EE-----------XX--B---XT--
m----X|--|----B-------X-o-T------oT---B-?X---B-X-o------E----EX-XX---E----X------B|T--X----o----M--X---o-----X-X------X---o-----X-----------?---X--|-X--|-----XX------o----|-B------B--?-------------T-E
XXXXXXXXXXXXXXXXXXXXXXXXXXXXXXXXXXXXXXXXXXXXXXXXXXXXXXXXXXXXXXXXXXXXXXXXXXXXXXXXXXXXXXXXXXXXXXXXXXXXXXXXXXXXXXXXXXXXXXXXXXXXXXXXXXXXXXXXXXXXXXXXXXXXXXXXXXXXXXXXXXXXXXXXXXXXXXXXXXXXXXXXXXXXXXXXXXXXXXXX
