--|--X---XM-o-X--------X--------B-BX-----X-T---E-X-------X-----o-----X----X-?-o-----BX------X------X----X---------X------o-----E-B------X-------XB?oX-X-------?-----X-----E-----M--?-E-o-T----------X-X-
--XX-?|---------XE-o-T-X-M---X----------M-----o-X--T----X--X---X-B-------Xo-X-X?--o|o---------?---XX-E-X---o---X---|-------o--------B-|oXX-X-B---XB----X-------?-----X-------------|-E---o-------B---o-X
-----B---o-XX---MX-|---X-----------E-----X--------B-E---X----o----X--?X----|----M-B----X---E---E--o----o-|-X-------|Xoo--------o------TT----?--o-----XE--B--|E------------X-T--X-X-------o---------X?---
X----------X--BE-?--B-------------|EX---B--Xo----X-----------T-E----E-------X-?X-oX-E--TX---------X-o--B-----X--o----------------BXX-X-----EXX-----E-X---X|?-TX-----?|--B-o-X---------T--------XB----?--
X-Xo----X-----X-------To-B-X-------X?-X----B---|----BX----??-o---o----X----X--?-----------M-B--M-X--X---X------TX--X--XE-XB-B----|--------?-X---X-X-?--T-------MM-X-o-------o--X------oB-----o-----X-X--
---XM-XX-----o-------E-X--T---XoX-M--X--X------------BX-B---XX-X--XX-XB----o-----------o-X----T--X-X|B-------X---X-X--T--E-E---X-------o-----------?X--------E-----X-X-B------?---o-EEX-------|---------
-X---oB------?--------TX--X----X-----BE--------M--XXoX--X--|--o-E--E---BB---E-----X------o-X------ooX--o-X----B--X-E----XX--B---X---B----------------Xo-----XX----X----oX--o---TX----X----------T----XX-
-X---?---o-?------------------oB--E-BXX---?-o-X---|X-----o--o--EXo---Mo----X--XX-B--X--X--BX----X-----------B----E------B------?--o----T-X----X-X---X----X-----------------------X--|------?---o---T-o-v
X--B----------T--?XX--------------E-------E----Xo--------|-BE----X?X-----------o------X-----B------EX-Xoo-B-X-X-oX-XX-----X---o---E------T-B--o-o-------XXXE--Xo-o-XB--M-E------B-----------T--X-----BX-
--o-B--T----X-XB--X----B-----EX----X---o----X----E--B--?T--o----X-----X---B--o-?----X-?B-E-EX-B---E?B?-E-X---------X-X--M--------T---X---X--------E-B---------T----B-------X---------|X-oX----------BB--
----------o--X---------|---------X----B-----------o-?---------X--o------E-?--X-----XX----B------XX------E-X--XXX--T--E---E---------X---------B--o-------X----X-|--------?-------X-Xo-------X--oX--------
---X-----X---MX-----X---------B-----X--X------o----B---T------E-----XX----?-|---X------oB-----X--o---------X-o---Xo----X-----E--B---M----------M----X-------------X----------XX----B--------------X---BX
-----X--------XB?X--X-------X--E----E-X--E-|-?--|---------X-----o-------------X-E----BX--XX---EX--E--XX--X----------E--M-X---?-oE-B----?X--X----------X-------|--|E-------XX--T--X---X|---X---M-X---X--o
-B------X----X---X-XT--X---o-------------BX--X|-o--X----B-----o-B--X---o----------X----------o--E-X-X--?-B--X-----BB-B------TM---X--------X-M---X-----X---X--------o-|XB--X------Mo-X----B------?--T--o-
m|||||||||||||||||||||||||||||||||||||||||||||||||||||||||||||||||||||||||||||||||||||||||||||||||||||||||||||||||||||||||||||||||||||||||||||||||||||||||||||||||||||||||||||||||||||||||||||||||||||||
XXXXXXXXXXXXXXXXXXXXXXXXXXXXXXXXXXXXXXXXXXXXXXXXXXXXXXXXXXXXXXXXXXXXXXXXXXXXXXXXXXXXXXXXXXXXXXXXXXXXXXXXXXXXXXXXXXXXXXXXXXXXXXXXXXXXXXXXXXXXXXXXXXXXXXXXXXXXXXXXXXXXXXXXXXXXXXXXXXXXXXXXXXXXXXXXXXXXXXXX
