--BBMX?B------------------------------------------------EB---------BXX----BX-----------oB-----?B-------------------------------------------XXB------XBM-------------------------------------BoMX--------
-----B?----------MB---XXXX-----------------BBBB?BX-oBB-----------------------BBBB--XBBBMMB--------------oMM?MXM--?------BXX---------------------------?B---------------------BB-----BB-----------------B
------------?B------------BoBBX------BB-XB-------------------------------------------X?X-----------------------------?XB-----?------------------oM?B----?XBX--BB-------??XBBB---------------B-----------
X----------------------------------B-----XMXX--BXBB----BBXB---BX--BXBXo------?MMXBBX-BBBB-?XB----XBXBXB----------BMBM----o?M---?--------o?B----------------XBM--BB---------------------------------MXB--
-XX----------MB----------B---------------------EBX-XMXXBXX---------BXB--------------X--------XBBX-BB---------------?-MX?BB----o?X--------?BBBX-------------------------------------XBXB---------------X-
-----XXMM--------------?BB-BB?B-?B----EXB-MMX?B-B----MBB?--MB-?MB----B----------XXBXB-----------BBB--X?BBX-----o?----BB----------------------------------X--E?B--------------MB------------------BBXMB--
-------EX-------MBB?-----------------------------------BXBX---BX----------------------------------------------?------B-------MXXM--------?B----------------------------------XX-----------B-----BBBB----
-------------------?-----------XXM----------------BM---?--------------------------?M--------------BBBBXB--------B----------B---------------X-XX---?X-BBX-----B-----------------------------?X----------v
------B?XB-------XB---------BBBBB?-----------BX??-------BX----X-------MB----o?-------------------------BBBXX?-----------B?----?XX----------------------o?------------XMB----oXXB-MB---XB----------------
BB-?BMMBB--------------o-------B-------?M----------------------?BXMB----------------------------------------?B-XBX-BBBBBBX-----------------BBXXBXB----------o-----B?BX-XX-BXBM---------XX-----------XB--
------??XBM-------------?B?---XXXBX--------?---X----------------?B?B--------------------oX------------------------BXXXB----------------------------------------------------------XXXX?XM?XXMBX----------
--------------------------BMMB---------------------oB---------X?B---XB--X-------------------BB--------------------------B?BB--------------oBX-----------?oBBB----------------------X---X--BXX-----------
------?MXXM----XX-----B?---------------------------------------------oXXX---oX-----------------B---------------------------------------------XXBBX-------BBB----X?X--------XXB--------XBBB??BB?BB-XB-E--
----------------X--?--------------?---XBX-------------------------BM-BBBX-----------------BXB---BE-----------------------------------XXBB-------------------------XB-----------------?------BBBM-------E
m-?--BX?-MXXXX----B-BB-----------TB?-------TXBB-T?XXBMX------B----------------TXM---TTT--T---------BMX?B---?-------oX--XX?B---------------------BB-----XB--?XM-----BBBXB--BXX??B----------------?-------
XXXB-BBM-XXXXXXXXX-BB??BBBBXXXXB-|?BXXXXXXMXXMXXXXXBBXM-BXXXXX?BXXXBBB-BBB?XXXXXXXX?B||B???BBX-XXXMXXX?MMXXXBXXXXXXXBXXM-BBXM-XXXXXX-BBXXXXXXXXBBBXXXXXXXX-?XX-XXXXXXX?XXBXMBXXXXXX--XXXB?-XXBXX?BXXXXX-
