o--XX----------E-o------X-?-XE-X----X---XX---X---X----E-------X-----E----------?-X----?------o---o-B--oXX---------------o------------------XMM--X----------|BX?B-------M-------XE----X---B---XB--X------
---?------------XE---X-o---o-------EE-E-o-X--X-Xo-----M-----X----EX---Xo--o-----MX---X-----X-o---B--------------XBo-------B-------X-----|-----X----?-----X--E---oB------?-M----X----T--Xo--X-?---X------
--------------?X----Xo|B---X---X---?--E-----------B----o--XE--------------E---X--X-X-----X-o----?----E--M--------------X--------B-----XX---X---------o-----------o?-X-----o--o-X----|X--XX--X-o-----X---
--X------X-X------X------X------------X-----------B--XB----E|-XB---E--XM---XE-X---oo--B------------X-o------E--XM-X------X-?-o-o----------X-X-----------B--------B-------X----------|--------|--o-oME-o-
--X--E-B------Xo--B-|-------|BE---ME-X-o--X---X-X-------------MB?-----M-?-----Xo-----B---X-----X--------M-oX-X----M--------X--B-------------X---XX------M------o--?-o---XoBX--M----X|---B-oX-X------X-X-
------------------XoX--------X-------------B--X-X---X--?---XX--E-B----o-----------o?-M---X-----o---o----o-X--XB--oE--?--XM-------------X-o-BX-X--?---------E-----X---X----oX-X-o?-o-|----|-?oo---?------
-oEEXX------o-B--X---o---?----X-B---o------EX-o--X---?--E--o--M-?-X-------X-------XXXo-X--B--------------Xo----X-----?-X---X---X------?---o--B-------?------X---X--X---------o-|---o|--o------E---------
---X---X--X----X-o----B------E-X-----o---------------XE---X-XX----M-----XEE---|------X--oX-------------X----o-----------------X-M--X----XB--BXo---BBB---X------|-X-X----X-----X---oX|--X-M-----X-----X-v
---B---X---o|oX---|----X?--E------EB--------oX---B----X----------------o--X--XMX--X----X------X-|-M---------o--?----o-----o-X--------------------------B--o--X----------o--o---XXXX-|--------X---B-B---X
-Xo--X-XoB--------B--|---X--?-?-------X?o---BX----------XE---X--------?-----XB-----E-X----X--?B---B-?|-------X---X--X-----------X-X--B---XM-----X-M----E----?---?---X-----o-------X-|--X---XX--E-X---B--
-EX------------?-----|--|-----X-o-B-B---X------------?------o-------XX------X--o---Bo------------X---------X-B------o-E---------X-X|B-Xo---------oE-----X-X--B-----EB----X---------X|--o|E-----M--X----X
---|------------MX-X--------M-X-----X---X-------o-o----EX---XXXo---?X----------o-B---X------X----E-X---B-----oE---B|X------------|----------EoB-|--XX------X----X----B--------------|---XB--X---X-oX----
----X-----------------B---?-B----?---?-?-X----X?X-X-----X------o--------X--|--X--oX-X-------------E---------MoB-E-EE-----o----?---M--------o-----B-----------X--X----X--X-----o--B--|--X--X--o-X-X-XXX-B
-X--BX-X-X--------X----XEB--X-M---X--?-EE--B---?-?--------------o------------------B---------------X-|-o--o-?------XX---X----oX----X--X-o-M----XX--|-----o-B---------o--E----X------|XX---X---X-ME---X--
m---X-|-oX-----o-X-------o-----X---?-----B----BB-oXB--------BX------------M--------oXXoX------------?XX-X----o-------o-EX----B-----X-X---X-E--X-------B--X-------------X--X--B------|-EX------B---------
XXXXXXXXXXXXXXXXXXXXXXXXXXXXXXXXXXXXXXXXXXXXXXXXXXXXXXXXXXXXXXXXXXXXXXXXXXXXXXXXXXXXXXXXXXXXXXXXXXXXXXXXXXXXXXXXXXXXXXXXXXXXXXXXXXXXXXXXXXXXXXXXXXXXXXXXXXXXXXXXXXXXXXXXXXXXXXXXXXXXXXXXXXXXXXXXXXXXXXXX
