-X-X------EXX-XX-o-X-------------B?X--------------X-----E--------E------BB------BX--------B--X?---X------X--------------X--?X---------------?--X-------X----X--M-X----B-X---------X------X-------B-X--X-
-X---X-?--X--X-------X---XBoE-?----o-------?--X--X----E--B----------------------XX-o--X-X-oM------oX-----MX--E--BX----------?------BX-X--X---E-----X------oM-?---Eo-X--?-X-X-------------------BB---o---
--------------X-------X--?---?--o--X---------X-------------------X-----XX--------E-------B--X---X---XB-X---------X-?--------X?--o---------o-XE?--o----Bo----X--E-X---o-------X--X?X--o-X--o------------o
MXXXoM---?X-X--o??-o------M-----------o--X------X-X-E------?----X---?--Eo-----X----X---------oo---X-----------X----XX-?----?-----BoXE--XE-------------E---o--X-?---B-XX--E-ooE----X-X-E-X?-?--------M--X
X--?-E----oBB---X--X--------X------X--B--------o-----------o-----X-?----B----------------o-----o--?--B----M--X-------------------M---B---B---X-Bo-X-----X-E----o--X-oM--B-----------M-B--X-------M-X--X-
---XXX-B--o----o--XXE---B--?------E-----X----?--o----M?---------o-X---B--XXXX---XX-XX-----X----?-X-----E---X--o-----------------B-----------------X---oE-XMX---B--------B----------------------M--------
X---o--o-X-------?-------------B----XB------B---XX--o?---------X---o-----BB--o-----?--X----X-----o?--E--oX-------------o-X-----X---X------------B---X-X-------o?--o------XX-o--------B---------X-BXB?--o
--------EE---------------------XB------E--X------o--X-E-----XM--X------X--XE---------?--X-X?-X----X?---X-Boo--M-XXX--------o---B-XB-------?------X--X-------------o----B--X---B--X--?---o--------------v
-X----X-----?-Xo----E---B---------------XX------??-----XB--EoX---?----M----X-----B----o-X--o----------------X--oo--o------o----X-------M----o---XX--M----X---?--XX----X-------------o--X----X----XB--X--
XX---------B-oX-X---B----B---M-----X------X---------E---X-?-------------X-------B--X-M----X-X-------X------X------oX---B-X------X-X--------X--X----X-----B------B---X-o--B---B---B-B--oo---oX----X------
----X-----X-E-oX-M----o-X---o-------------E----X-----o--o---?-E------------X------------X-?XX---E--X-X-----------Eo---X---E------XB-EX------BM--o-------?-----------XM-----B-------------------X--X---?X
---X-X----E-----X-Xo-o--o---?BX--------XX-------XXo-----B--?-oX------XX--------X--B---------o----------?-X-------XXB-----XX----------------------M-------?----XX-o--X-X----B---B-------o--?o?-o--X------
-X---------B---EX-----X---X---X---o---------X-------------o--o----------o---X-o---o-----X----Bo---BE?E-o-o---o------E------Mo--B----X---MM-X--XE--------X---------B---------X---XX---?-X---X--E--X-----o
-------o-?-------?---?-----------X---o---o-X-X-----------o----------E---XX-X--oB-XM-XBo??--B------E---X-X----?-B----?--X-o--------B-----o------B--X------X----X---o--X--------------XX--B--o-o---X--o---
mX----|--X-------o-----?---M-X---X|----|--o-------XX-o-X---------------o----------B---X------?E--------XX|--------------E-o------------M-------------XX------?----X--EX----------oX-oX------X----X------
XXXXXXXXXXXXXXXXXXXXXXXXXXXXXXXXXXXXXXXXXXXXXXXXXXXXXXXXXXXXXXXXXXXXXXXXXXXXXXXXXXXXXXXXXXXXXXXXXXXXXXXXXXXXXXXXXXXXXXXXXXXXXXXXXXXXXXXXXXXXXXXXXXXXXXXXXXXXXXXXXXXXXXXXXXXXXXXXXXXXXXXXXXXXXXXXXXXXXXXX
