--o----------E------------X---------XM---o-----X-E---X-o-o-X-B-------o----Bo----X----------X----E-X-oX------B--MX--B-o-o---X---B------------o-B--X---?----------X--------X-XX-B------?-X--X-XE---X---o--
-------X-oB------o-o---B-------o-----E---B----?---BB-----X-------?------X---?-?--XXBX-------XX-o---o---oX-------------X--X-E--oX-X---E----X-X--E-----B--oEo--o-?----X-E----?---------XX---------M-------
-------------------XE--B-X---X-X-E-----M-----E-E-X--------------------------?--------------XX--o---------------X---EX--------XX-B-B---X----X-----X-----------E--------o-?X----B------B-E------X-B?--X--E
-----X--o-----o-------X-----B-X--X----------X--B-M---------B-X---?---?X-------Xo------------XX---BB------X-X-----X--X---X------?--E----------------E---------X--o-X-----B-B-----------E-------?-M---B---
--------B--------XX?X-X--B---X---?----?------o---X-X--X---X--------X---------o--E--E----X-------E----------X----XoBo---X--BMEo--X--o----o-?X---X-B-B---ME-B-E-----X-----XX-------EX--o------E---M-----X-
X----X--o---X-----X-o-M----BoX----------X-X---?--------X---EX-----X-X-M-XX--M----o-B-----M?---X--X---X----o----X----X----------M--B---BX---BX--X-X---X-oX----X---------X---------Xo--XM----B-B-E--X--M--
---E----E---------X------Xo----------B---o----X---M------X--?-oX-----------oX------M----X---?--BX----BX----o----X--X---------M---B--E-E-------------o--X---------Xo-----------X---------------o-E-------
--XBX-X-o--o?-?-------X?X?X-o---o--?-------------X----Xo--X----------B---X------X-----------o--X---E--X--?--B---M----------o-X-----Xo-------------X----------X--X-M----E-?---------M----------X--------v
-E---X-B-X--------M--o---------X-B----o--E--------o-X------o--?X---------M--E-X-o--o-----o----?XX--B-X--o-o----E--X----X----------X-M---------X-E----XX--X-----X-?------B----------?-X-------?-XB---B-B-
------o------X--Bo-B-o----------?-X---X-----------E-----E-B-B----------X----------o--o-B------oE-----X-----?X----X----X-BXo-------XX------X-----X---X-------o-XEE---B--M-------M--?--------?-EB----X--X-
--X----BXXX-----X---M----X-----------X--X---X---X----o-------X----XXX-M-o-X--M---EEX-----X----?--X----------X----------------XX-----?------B-------o--------E------------oBX----------------X----B-o?---
-----?-----------oX-------X-----X---XB-------X---E--XM------X-o-X----B--------BX-----o-------B-----------oX----------B--X-------------o-X-B--?X-------X--EM-X---------M-o----E---E------B---?--------X--
-X--o---EX---X--------B---XXX-X-----X-X--o---------X---E--EBX------X--X-B----?-oo--o---E----XXX-E----o-----?--Eo-XX?-X-B------E-----------X----Eo?o--X-X--------?--X------BX---------o-X------X---E--B--
------------------X--X-----XoB---o---X-------B-X---B------?--XX-?--XXo------B----o-o-------X----X---------o-------X-XX-?B--------X-BXX----X--X-----XX-?-----?-B--o---?---XE------XX?----?X--Xo----------
m--|----B--------------------X----|-----X--|-X---------------------X-------------X------E?------------------------M--oXE--BXXB---E------E---E-Bo---|----EM|---X---X-|?-E|X--X-|-----|------X---X-----?--
XXXXXXXXXXXXXXXXXXXXXXXXXXXXXXXXXXXXXXXXXXXXXXXXXXXXXXXXXXXXXXXXXXXXXXXXXXXXXXXXXXXXXXXXXXXXXXXXXXXXXXXXXXXXXXXXXXXXXXXXXXXXXXXXXXXXXXXXXXXXXXXXXXXXXXXXXXXXXXXXXXXXXXXXXXXXXXXXXXXXXXXXXXXXXXXXXXXXXXXX
