-X--------------------XX-o----X-X---X-B?X-XB----B---------?--X------o-?-o-|X-----X-|--------X--o----E---Xo-o-B----o----------E---X----X--o---------?---X------o-------X--X-----T-XE---------------X--B-E
------T------X-?-X-----XX------------X-----X--------X-----o-o---?-----oE-B-oX-------XE--------X------------------X-Xo---X--o-----o-----X--------------X-----------B--E------?-o-X--X-M---o-----o--------
----B-|------|-------X-----T--?XB--------XX---X----|----o---?--X--o---T-XX----B-----|--X--B----X-------T------X---BX-------?-T--------B-X-----------B---E---?---E-X----X---oX-X---o?-o?-oB-----o--X----E
------|---EX-o-o----X-----E---E-X---------X---------oo-X---EX------XXoX?B-XB--?-oB-----B-X--B-----------------M--E--X-M-----------?-XX----------X---------------XB-o------T--o-?--XX--X-o-X-?o-B---?----
-M-?X-|-----X-XXX------M-?-----B----------o------------?-B----X--X---------------XT----XM-?-X------X---------X--E--------X----B-X-Xo?-XX------B------X---EX--?XT--X---X--X-----X-X---E-X----------|-X---
---T-T|---?o-o------?--oX---X-o---X-X-?---Xo-------o-XT---X-X-o-EX----XB---o--X|X-X-X-X--|---X-------E-BX---X-X--------B--X|--X?BX-----X-E-?-----X--X-o------T----X-----X----------X--T--|-o--X-----|X--
------|ET------X---------o-------|--|--M------X-X--E---TE--X--o-------------------------B------X|-o----B-----------B--X----------o---EX-------?-----?----XX----------o---Xo---------------XX-oB---X-----
------|--------X---X?B---X---X-X--X-----XE--o---E----B----X-o--B---B------?--ET--XBBXX--------------?-----------X------o-X-o---------BX-----E-X---oo-X-?-----X--?-|-o-?--------------X----X-B-TB---B-B-v
-----X|--X----------------------X-----------------X---M------M-----?B---X?---X----T-B------o----B---M--o---X--M-o---EX----E----?-M-X---E-oX--X-oE-B-o------o-o-------o---?----------|---o---X----X------
M-----|----X?------?---X-E---B-E--B-EX-B----B---?---XE----o--------X------------Xo-B----BoE--------|o-o-?--?XX-------------------XX--o-----o-----X--T------B-----X---o-X---EX----B-X-o-----X----oEX----?
------|X-M----X-oX-o--X---X-E-B------------o----B---BX---T?----oEo--E---E----X--------B---E--B--X-X---?-?----M---Xo------TX-M---TXX----E-------XE-MX---oXB?|-X------M------------X-o---B---B---X--------
--o-B-|------------XXX-------------o?---X------BE?------X---M-------B-|-----XX----X---E---------X-------------o-----?oM---E-o--o----X-------X-X-----M-----X-----X----X-XX---X-E---X-----XB-----------X|-
-M----|-o?B-X----X|-B-X---E------X---------?-----o---------X----------B-X---o-B-?-X---o?oo--M-----Eo------o-------?---XB---------------|----E-M---B-------X-B--------|--------B-----?T----XX--X-XXX--T--
-E----|--B----------oB---X-B--------X-oXB--X--------oX-------------------Bo----------X--?-------X-XoX--B--o------MEX------------|------To------------o----X---------------|-o-----X----M-----------X----
mX-o--|---B--X-|EoT-------------------B------XX-----------------o--o-----X----------X-oBX----X-X?X--o----X--M--XBo----E----X------------------X--o-----?B-X?------------EX----T---oXMX?--------B---X--?-
XT-X--X-------X-----B--?-XX---------oB----------MX--X----------|------?-oE----|-X----o--X---X------B------B------B---------|--------B--X------X------|----X--MMX--E---X------XB------X-X----------o-----
