oBXBBX----BXM---?X---------oB----?XB----------?-------Bo?-------?B-------------B---------BX--?---------XX?B-----XXB--------BX---------------------------B??B--------------B---------------?BX---BB?-----
---XBM-BBXBX--------------MBB------------E---------------------??B?----BX----------BXM?------------B?--------------B-------------------------------MBB----MBBBB---XMB-BB??BM------------------?XX-------
o------EXo----BBXB------BBBBBB?B-----------?B?MB-----------XB-----BBoBB-----------------------------B-----BX--------B------------?----B?------BX--------------MBX?XMM----------M-----------------------X
oXX?XX-------BBB-----------BBX----------XB-------------------XXX-------B-----BX?--BBXB-E----------o------XX-X--------EB-BX------------------B-----------------B----BBB------------------oB------------B-
-----XB--------------?XXX-------------------BB?B---------BB-------------EBB----BBBMBBX-B-BB---?XMBB---X-------EM-BX----------------------XX------------------XBMX-------o---------------------B?--------
E??XMXBB-?----X?--BBM---------------?---XB---------------------o?BB-----------------------------------------------------XB----------------MBB-----------------------------------------?XX-----oBXBBX----
-XB?--B--X-------------------XBX-------------XB---------E------?------------------EBBX---------oBXBB----o----XX-------BX?BB-----EMXXB------------E?BBBX------------XB--BBM-----X?--XBB-XMM--------EM----
--------X?M-------BM------------------XXM-------------B--------B---XXXBB----------------?B-----XX---------BB----------------------------X------BX----B??M?X---------------------------------E----------v
--X---BXX---------------BMBXX---------------X?---------B------------?B-----EX--------------XB?-------XX------EBXXXBX------------------------BBBXXM----XB-----------X-----X-------MB--------------------f
----------------------------------------------B----BB---B??---B---MXX-BB-------------XMBB---------------------XX-BX---------?---XX?X?X?B-------XXX?B-----------B--?B-----------------X-BX?---BX--------f
---------------XXM---oB---M---XB????MB---------XX?-o-o-----------XXM-MXBM?B?--------------X?----------------M?B?----XBX?BB?--BXB-M---------------BB??----------------------------------BB---------BX---f
-----------M-------------oBBB-MXB---------?B----oB------BBB----------------EB------------XB------------------------B?XX?----?XX--?----------BX----------M---?X----??--------------------------------oBBf
-----------------XX???BB------XXXXXM----BBBB---------B-----MB?-------BX----?BMB---------------------------------M----BBB-------------------XX----------------B?-BM---------------------------X---X?----f
----------?--BBB?X-----------XM-------X------B---------------X-------X--BB------------------o-------------------BBBBB-?----B----------------------------E------------X-XMM-------B?BBBXXXB-------B-----f
m-------------------BXXX-----oXX------XBBX---------------TBMo-------?X--BB--------XXB--X------oXX-------------------BX-------------------XXXX?TX------------M---------------B?----?B------?--BX------?BX
X---------------XBB-------------------------------BBB----|BB------------XXB?X-----------XBM---------------------------------------------------|BX-------B?X--------------------B---B-------------------X
---XXXX-XXXXX-XXX-XXX--X-XX-X-XXXXXXX-XXXXXXXX-X-X-XXXXXX-XXXX|X--XXXXXX-XXX--XXXX|XX-X-XXXX|XXX-X--X-XXXXXXXXXXXXXXXX-XXX-XXXX--X|XXXXXXXX-XXX-XX-XX-|XXXXXXXXX--XXXXXX-XXX-XX-XXXX-X-XXXXXX-XXXX---X-X
