----------------X-------X---|-------------------o----T-----X-------X-------X--XX-X----o-E----X-XE-?------X------|-o---Bo-XX-----?----o--B-X--o---E-o--o---X--E--M|---------------X---?----oEX--X--------
--o--o---o-T-B----oX-o-----------X-oE---X------?---------?--oX-----------------B-----|?---o-----E--ME------o-?----o--B-M?--E----------E-M---|------E---E--X---X---?------o---o----oooo--X---------------
o--Xo?----oX--X-------------B-XE---o----X-oX-------X-o--?-o-------X--E--------TX--ME--o---X-|XoB--o-B--------o------oM-------X---E--B-X--B---B--------?-o------------E?--X---E--X----??---------X---o?-T
-XE-o-oX---X---XB-BX?-----------o----X--o--------------?--------------E------XB---X--X-B--B---EX--E----X-----X-X----------X-----------o---o----------------E------B-|--X--X-|o------o-X------------B--M-
---------X---------?-X------X-B-------X-oX-B-----X---M----XX----------o--E-------oE-X---T-X---------|X----X---o-o----?-----------o-?------------X-?--X----X-|------o---M----oX--X---M-T--EB---XoX-----o-
----X-----o-----oX---XX-o-o-BXX--XXX---o--X--BEXB---X--------BX-------X-X------X-Xo-----B-X--X--------|-E---T-o---XT--X-X----M--EXXT--XX--------X------E--X?-----------BT-o-X-----------BX-BX-----o----X
----------T?-------X-----X-B------X--oE---B----o----------------|---?----T------B--X--X----------M-----X-oE--|--|-----X--|-oB--o--------E-?--?B--X---E-X-----X----X-X---X----o--M-X----E---------B-?--X-
o---X---TB--?-----X--X-XT-XB---------o----B|-----XT-------------B-----?B---B-M|----E---o----E-----o--E---?-----o--X--XEXE---X--M-|--X-----------BX--X--?--?---XB----------X--XB?B-X---E---X--X-o--X----v
BT-oXX---X-X-------B-------------M?-----X-X--?--o----X---MX-----------XX---X-----B--X-B------X-?-T--BX-----M--X--Xo---oo---X|-E---X----|X---X-|------X-B------------|-XT------X---B--X-X-B-------B-B----
----E-?--X---X--XB---X--XX|---o-----X--o-|--o---TTX----B-X----T-XX------X--X-XX----B-----T--M---Mo-E---B--XX--?Eo----?-X---o--X--------o-B-------X--?--------X----o----o-----X--------X-oB----X-X---BBo-
---X------o-----------X---|-oX-----?---X----?-------Xo?--?T---T?---o-X--XEX---B|-----?------?--MB------?----X--|X--|--X-------B-oX-----X-E--X-X---?--------X---------X--------?-E-|-X-X--B---Bo?---M-B--
X---X-X----X|------XX-X--?-XX--?----X--?-B----o-----X----B-------T----X---------Bo---------BX--------?X------X-------B--o-XX--X--o|-------oX---E-----?|---X----?----B----X-?--?--X--------o-XE---o-----B
---E--E--oX-------------X-T---o------------X--?B---BX--o----XXE---X----?--o-|-----T------------E-------------B---M--X--------Eo----------EE--XB|B----X--X-------------o---------T---B--o----X----E----X-
-Xo------M--XEX----o----X--------Xo-?--X---XXX------XX---Xo--T-E--o-------X-------------------?-------B------------EX----o-----X-X---------X-----?B-------X-B-X------M-XX-----X--------M--B----oX?o---X-
m-|--X-----X--B------?-E-------oM-----X-X-B--E---o----X-----X-o-X---B-----------?--o---?X----o-----M---X---o-B---------oX--X--------XXo--------------o--|--X-B-oo-----------X---XX-|X|?---B---o-----X---
XXXXXXXXXXXXXXXXXXXXXXXXXXXXXXXXXXXXXXXXXXXXXXXXXXXXXXXXXXXXXXXXXXXXXXXXXXXXXXXXXXXXXXXXXXXXXXXXXXXXXXXXXXXXXXXXXXXXXXXXXXXXXXXXXXXXXXXXXXXXXXXXXXXXXXXXXXXXXXXXXXXXXXXXXXXXXXXXXXXXXXXXXXXXXXXXXXXXXXXX
