--|--BB------------?--------X----------------M---T----------------E-----------TB--o------X--------?B-T--------?---T------------------------BX------MB-----T?B---?----BX--T-T--------------|XX--X--------
-B------------XXXXX----------T-------------B---?-X-----------------o-------------?---------?---------|-------------T------------------------XBB----------X------B--T-T-X-|B-----MB-B-----------E--o-----
-XT---?XBXX--------E--?------|BB---------?---------?------------oo???X?--BT--------------B----?MM-----T?---------?-|Bo---E---X-B-------------E------T----B---------|-M----------------------------------
--|----X--------T---------E---------B?--?---B-------XB-----oXXM-----------------oBX---------B--BX?M--------------------o-------------X--------------o-------B---X--------------------------------?------
-------X--------o-----oBX------o-----------------B-----oB----------o---------BX?XMBX---X--------B------------------?B?-------o--?----------X------------oX---BXB---X------B----o-------X--XX----------X-
---B-T-----------------o-------?B------------TB------B--E----o---XTBB--?BBB?MB----XX------------X-----?-BX-BB---B--------BE---Bo-B-----------------X----------T-----------------------B??-----------XM--
----M|--M--------------oX--EM??---------------?M------BB------X---|XB---------B---?B-------------------BB----------------------M----------B--------X---X----MM|---------?T----X--------------oXM--------
------------------------------------------------------------XX------------------B-----------?-------XX-------------------------?--------o--------B----------------o------|---MX?----------------?------v
----------X-X----BX---------------------T---------------------------------------------BXXB-----BB----------TBB-------M------o------------------o------o------X--------------XMX-------T----------------f
-------------T-oBXM--------o---T-BBX--?-?-----M--B---XB---B------??--?-----------X-E------BBB?B----------o---BM-X--------------T----?X-----?-----------XME------------TB---E-------To-----------------Bf
-------------|B-B--------------X----------X--------BXX-----------------------------------EX---------XBBX---------------XBBB---B--TT-----oX---------------------------oXo---------o-|-----X------T------f
--------E-E?---------B----MB-?--BE--?-X----?-------------------MBB----B------X?-----------------------------B----X?-----------M--o---------------BX------XXX-----T---X------X----T----------MB-BM------f
--------TB--B-------------oBMBX----X--T------------M-X---X-XXXB-E---------TB----XBB-B?----------------------T-----X-X---------M-----X------o-T-----------X--------X-----------T-------------B----------f
--------|---XX---X-M---BX-----------BT--T------------XB--------?--------------T?--X--X----TT--------------------------------------------------?-----oXTX----o---------T--------------------T----------Tf
m--T---------M--------------?---------B-|--B------BB?-----T-----BoBXB---T-----X-----------|X-----M-------------MBBX-----------T--------?----?-----M---|X------------X---T---X--------------------oB---XX
---|-------------------------E-E-B??-----BX----o-oEXB----X---X----------|BX---------------------E---------------------------E?---------BB----------B-M--------o---BBo-oMXB------M--?--------X--BX------X
