-----------o--M-B--------------X-----BX-------B-----?B----------------------BB--?----MB--------------------------BB------BX--?---MMB---------?-----oMBB---------BM-EX-----------------------------------
-----------------------------?---------M??--B------------?B---------?B-----B----------B-----BB-------BXB-------X???--------------------XXBBX--?---MX-----------------MM-XB--XB--------o---X--------XXB--
-?B----oB-------B------oo----?M---X-------oX-----XBBXX------------------------------oXX----------XX---?--------------------X-------BB-B-M-X------------------------XX-BB---BX-X-------------X-----------
--------------------BBXBBB--X?B-----BX-X--BB-------???----MX-----M--o-----XX--X--X------?---BBB---------X----oXM--------o----XB----------B---------------?X------X---B--X-----oBB-M---------------------
---------------BX--BM------------------B---X---------E---M------XBB-------XEXB------------B-----BBX--------------?--X---o----B-B-M-----XB----X--o-X-??-------X------------------B-------------X-------EX
---------------X-XMM---------------B-----------oXB?--MBX----------X??-------------------?BXX---------------------BB-------------X--------------------------M----oX-----X-oEB----oXXBM----BM----------?X-
--------B?---?-----------E-X--XXXM--------B--------?X------------------o-------------------BX--------------XMB?--------?X-------------M--------------------------------------B--E-------BE--------?B----
B-------------B----------oMXB-----------B-X-------------------oB----------EBBM----------------------------------X---o-----B----BB--E---XX-----------------------------X-----------------?---------B----v
B--------------X-BB------------X------------XBBX---------o--------------MB--BB-XXB---------?XXX-------------------X-----X------------------------------------M----X-----X?BBBM?-----M?BBX?XB--B-??-BBB-f
---------------------X----X---------X-B---X-----B----------BX----B-?------?--XX--------BB?o--M-?-------M----------XM-X----XX------B---------------X?BMX------------------------------------------B-----f
-------------------X--oXB--oMBBBBBB------------B-------------X-BB---?BBBBB----------E------------------o------------BX--X------?XX--------------B??B--BBBB------?X-----------------------B-X-------X---f
--------XBB?------X-----BB----------BB-------------MB?----------o--o--------o------------o-----X------------------B--------------------?BX----?B-------M-B-B---M------MX--B--------B---------B----B?---f
-----XB?B---?B--------B?----B--------------------XBX----X--BXM---BBXB-----oXB----------B-oB---B??X?BX----XX-------------X-X---X-----oB-?-----?BB?----X?---MB--XXXM?-------------------?----MXMBBX------f
---------------------------------?---X----M------o---------------------------------------B?--------o------E--------------oMB------B---------------------------X--------------?X-------X-------o---?----f
m---------B-BX-------------TX-----o---B-----XB----B-------o---B---B-B--E-?--------------------?BB------T----X--M--B------o---------B--B-------BT----BB-------------?BB------------XBT--XBBB------------X
X-----------------X--------|-X--X-?--------------B---------------E-----------B--?------------M--X--o---|-----------------XM-----------------X--|-XBX-------MBXX--E-----------?XB----|-B---------X-XBoB-X
X--XXXXXXX-XXX--XXXXXX|XXXXX-XXXXX-XX-XXXXXX-XXXXXXXX-XXX-|XX---XXXXX-XX-XXX-XXXXXXXXXXX--X-X-XX-X-XXX|XXX-XX-XX-XXXXXXXXXXXXXXXX|-X-XX-XXXX|X||XX-XXXXXXXX-|XXXXXX-XXXXX-XXXXX-|XXXXXX-X-X-X-X-XXXXXXX-
