----?--------------------------XX------E-------E--X---X------E---TBo-?---E-------|-E-------------X----------o---?T-T--?-----?--|------o-----T-?-----B--|------o-------E--|?---------------------oB------
--o--B?------T-------------?--Mo---M---------------------E-----M--Bo---------------------E-------E----B-EM--B------E-T------------o-----??----|----------?--M----------o------E----------M--E-----------
-------BB---------X-------X--X---o--------?-------|oX--------?----M-E---X--B--M------------------B----------BX-o|-----M------------M--?o--------B------------------B--------E-|-E-?-o-------------------
--------T?----------T---X--EB|---------EB------B------?------------------Eo------------X-------E---------oo----B---E--X---?B------------------------E--o--B-T---T-B-------------B-----------E-------T--o
-------------X------EB-----B------?---B---T---------------T-B------------B|-------?-----------E--T-M-----------M--------M-o-----B-T-------Bo---------M------o|-o--------------E---------------?--M------
----E-----|----------|-----B---------B-------------E------?-------------------B---o?-----------XM----------?B-M--?--------------M------------?-----oX-|---------?-X-----------?-EB---B------T-----------
-o----------|-----?--o---------------------------o----EX--------T-BE--------------------------------X-----?---o-----------o-----E------B-----B----------------E------------E-------o--o--?---B----M-o-?-
-------------oo---B----------------------------------------?-----------|-------E--------?------------X--------?--o------------B----?---X---?--------------------B--?------Eooo------o---T---------o-T--v
--B-E--E---o----------|-B------EX------------------------E----B-----TE------------B--X-|------E------------------o--|------------X-------B----M---B-------------?--?-----------B-------EB--E--MB--------
--T-----B--?--------X-------o-------?----o---B---------BB-|----XEBT----BB--------o------------?------------T-T-E------------?--E------------o-X------M-------------------B-----M----T---?B----o-M-T-----
-----------E-----M-----------o---------?---T--o--------------------------------------B---X-----------------------E-Moo------X-----------oX------------?--------E-----o----------------------E-----------
------EX--?-?---------------E---B----------------------oM--B-----EX---------|-------?---------E-----------o-----B--M-T-------T-T--o-----------|----o-----B-?-----oE-----------EM-----?o-----------------
--------------------B-E---o----X--B-----E---E---------------------?-----------------------------o----o------------o-----EB-----oT--E-------------X---|---E---?------------E-------------o--?---|?-------
-----T--------B----------------------?----------?----o-oM--o-M------------B--E-----B-o----------------------------|B-------------------oB------T--E--------------E-----?-------------------------------o
m----o---------------X-B-----XE----T---------------B-M------------E------------?----E-------T--E------|---------------B-|--B--?------------EB----------------------oB-----oTB---------------?---?---?---
Mo--------|----B-o--------------oM-------------o---|oB--o|--B----------E?-|----E--------M----?--o-------B----------E--o--E---------------------B-----E-B---------B-T--|----------------?-----o-E-------o
