-?M--o-------o--------------------X-------o?-----------B------?-------X--E----X---oMB-B-----------E-B-----------------o-----o-----o------B-----E-------o-----------XX---------EE---------X-?-X?------o--
--------------------E----------X-E---o----------------EX--o-B-o------------X----------------o--BE--------------------------------------o----------?----B----------E-X----?-----------------o-M------X-E-
-----B-------o---X----------M--XX------o-------X----------X-B------------------M--------o-M----XE-o-------X---------M-----E----B----------------------o--------XM-?-------------?-E--o--o--X-----o---X--
-o-----------------o---o---------o-------B---X----------------B-------------BE---------oB---o--B-?--X--E--------o--o-B---o-------X-X---------------X----?----?------o-----E-----o-XB---------------o----
B--o-E-----------X----o-------XoB-------X--o-------------------------M------E-B--XB--E----------------------B----?---------o--------B--BX--------B--M?----o-X--X-------E----------Eo----M?---M----------
----o-----X-------------o--o-----o-X--o-BB-o---------X-EX-----?---------EX-Mo---B-------o----------X--------M-----------X---------------------------X------o------EB------X------?---------o------oo----
X------Xo---B-----------M--E-----o-------------------B-o---X---B-X---B-----B---M-------X---------E------------------------------E--B-E-E-----------o--E-----?-------------------?-?---o---?--------E---o
---E----X-------X--------oB-----------E--B-XX--------------?-------E----------X-------------------X--o----------?--------M-X------XE-----------B-o--X----------X---------X-----------X----B------?-----v
----------B-----------X-------X------X----oo--X-------------X-o-?--E-E--------------------------X-X-o--B--------?-X--------------------------------------?---------------X---------E---------------B--E-
--------B---?--------o--o-----------X-X---------Mo---------E------------------------o------E-----E-o-o--B------------X---E-----------------o----X----oXE-----E-----E---o-M-?--B----------------------X--
----------X---------o----X-----o---------o---?----------E--o------M--------o------M-------X---o-M--------o-----X-----------X--o------o-----E------?-------------X------o---------X-----Eo-?-----------B-
-------B-----?--o--X------?---------E---E-------------o------B---EB--------E------------XoE-------M--oE-------E--X-----------X---X--B?------X-----------------------?-E--X----------------?-----E--M--o-
---------B-?----oE----------------M-------??--------------------X--B------E-X--X---------o--------------o-B-----------------o--E-X---------X-X--o--B------------Xo--B----------o-------------X----------
------M?-----T-TT---TTXXT-E---T---X-T----T--o-E-E-?---o----oT--T-----T---TX-TTToT------T-T-----T--T-XTTT--------o----B----o----E--To-?ET---E-oTM--TB--------T---T-----T-----TX-T---T-T-----T--------T---
m------XX----|B||---||--|-----|---X-|--oX|--Xo----X----o-oX-|--|-----|---|--|||-|-EE--?|-|X-EBB|X-|-o|||?-----X-B-Xo--B-----X--M--|----|---XE-|B--|--X------|--?|--X-X|---B-|--|--?|?|-----|-?-MX-M-|-M-
XXXXXXXXXXXXXXXXXXXXXXXXXXXXXXXXXXXXXXXXXXXXXXXXXXXXXXXXXXXXXXXXXXXXXXXXXXXXXXXXXXXXXXXXXXXXXXXXXXXXXXXXXXXXXXXXXXXXXXXXXXXXXXXXXXXXXXXXXXXXXXXXXXXXXXXXXXXXXXXXXXXXXXXXXXXXXXXXXXXXXXXXXXXXXXXXXXXXXXXX
