--X------E-B------o-------B-B------M-----M---------M--E-X-B-----------?-MBX-X-----X----B----X------B---X-------------------------X---X-?-----E------B---XBXX-----o--X--oB-o-M-X---?------E-----?X--oX---
--X-E-To--o----BB-o-----X---X------------------------------?X---XXBXXB-------------X-X---o-X--o--------?------XE--X---o--o--------X-o----oooo-?----B---o-----B--X--XE----X--oXB---X---XX---o----o-XB--?-
-X---X|--XB----X--------X-XXX-?------X---E------X--XE------?----------X------E---XM--?-------?------o-?-o----?---o-X---X---X----X--X-X--X--------?--o-E--------B--o-------E-----E--M--?-----?---X--E----
------|EX-------------B-------M-----oE------?---oX---o-o---------X----X-----------X-X-------------oXX---oX-----E---B----o-X-----o-E-----------X---------o--?-----X----------------E-------------B----M-X
------|-------B----------X--X---B-X--------?-X-XoX-X-----oB--X------XE----X--B-----o-M-X--B-X---?-----M--X------X-------X--X-------X-o----------------XX---Boo----X-B-X----------?----X-X----B--M--?--B-
-X----|---o---X-------X--?-X------------X-------?------?-----XX-o-X---M--------ooo----o---?-o-B--X--------X--X-----B--X---?--?-----?---------o--------E------------?---XX--------------X----------B-----
---o--|---------XE-------XX--X--X------XX---B-B?---X--o--X-?--?BX---oo--?-XXX--------X-X----------------XE-E---------------BBM--------MX-X--X-EXXE-M-------------oXX---E------------oX--XX---X-B--------
-X----|---MXXXEX?------XX----oE-E---oBX-----?-----BB------M----------o------o------------XE--E----M-----X----------------XXEo?-X-?o----oB?----X-----?---------o-B-o-----oo-------o--XXXXX--B----X------v
-MX-X-|----Xo-----B--XX------X---X---XX--BX------------Xo-X----X----------------------X---?oE-----------------o-------Bo----XX----M------o-E---?----X-B--------BE----?---X-B--Mo-X-?---?---------o-E--o-
-X---?|-X---------o-B---------X--------------X----B------o-X-X-X--XX----EB---------MB-----X--X----B--o----X----E------X-X---o-------B-----Xo-------X--X------B-XX---oXBXM---------M---?----BX----B------
---B-E|-------X---------MX---X------o-------X------B----------X---oX--------X-----BoX-X-----------X----o----------X--X--------M-X-o---X--XXBX----------------oX------X-?XE-------------X-----E-X-----?-X
------|---------?--E-X---X--?X---X--------E-----X--E-?---oX--X-X-?-o--X-M----------?-----XX-X-B-----BX---------X----------M-------Xo---X-o------E-----X-------XXB----?-X---EB--o-X----X---o-------------
M-TT--|--T----M--XX------------o----X------------X---------X--------?-------M---------oX?----o------X-X-XXE-----B-------X-X------------M------Xo----o---X---X-------B---?----B-----o------------BXE-----
--||--|--|---X-X-------X------o-----?-----o-B---o-X-------E-X-------?-oB--X------o----o--oXXX-----------X-o-----E-E-----------X------o--------XB-X--o------X------T--o-X----X-----------Xo-XT-----XXE---
mE||--|--|---X-X-X-o--X------------X--X---oX------X----X--X-X---Eo--------oo--M-B------E-------------o---XT---Eo--X-XX-------oE--------B------M--X-------X-T----EXT-X-----X--B-o-----------|T---o-?-----
XXXXXXXXXXXXXXXXXXXXXXXXXXXXXXXXXXXXXXXXXXXXXXXXXXXXXXXXXXXXXXXXXXXXXXXXXXXXXXXXXXXXXXXXXXXXXXXXXXXXXXXXXXXXXXXXXXXXXXXXXXXXXXXXXXXXXXXXXXXXXXXXXXXXXXXXXXXXXXXXXXXXXXXXXXXXXXXXXXXXXXXXXXXXXXXXXXXXXXXX
