----o----B-X-XX--X-------B---?--X-------------M---X--o----X----o--B-B-------------X-----M------o-XE-XX-------------X----X-o---B-o?--------X-X-X-X-M----------X---------M----------------X---E---E-------
------T----M-E---X--X?E------X---X-?-----B-----X-----------------X-----------o----X---?----B---?-------E--?---B-X--------M------X-------M-X--------oX-----o-X--?-o----o---o-------X-o---X-----X---------
-----X|X---------X-B-M-X?-E---MBoo-------M-----XE-----------o------------B--XM-o---X---Xo-----------o-o-oX-o-----X----B-E-o----?X----?-----------X--------o--E-X--o--E-XX--X---X------X--E--B-EE---XB---
X---B-|------o---E--------------E--X-?-------E------------M---X-----M-------X--X-X-X--XX------------B---------?------B------X-------M------o--oX----E-B-----?X---E----?----X--o------o-----BE------X---X
--oX--|--o-o--------X---oB------?--oB---o-B-B-XB----X---B-B?----------X------E-Xo-----X-MX---------o----E-o-X?---?--?--X--E--------XB----------B---X------X--------o-E--B--XB-?---X-X-X--oB----E-X---B--
-o----|-X-o-X-------XB----------X-X--X---Xo----X--E----?X---XX-?-oX--------o-----------?------o----?---E---XXE------?-?--B-Xo-o--Xo-X--o-X--XX-----------X--X-XX---o------o------X-------X-------M-X-E--
-----X|---X---E-B----XX-X--E---------------X----M---X-o----o?-------X--X---?-------------o-X---MX----o-----X--o---o--------X---E--X----------?-?---o-XX--B----XB---X-?-----X--------o-----------?-X-----
---B--|--X-------B---MXX---X--X--Xo--E---?--E---?-----oXo---X-----X--X-------X----X--------X-------E--X--------o-------?--X-X-X-XoM---------X-B--E--o---E-------?-E--o--X-X-XBX----------B-----------X-v
o-----|-E----X----XE-----X---------Xo--X---XXX---o---X-B-----B-------X-X---o------XE-?E-B-----ME-----------X-------X--?M----X---o---o-o------------B--X-------oEE--X-----X--oo-----?-------o--X--o?--X--
--XB--|-------X------X-----X---?---XooB---oX-X--o-----X---o-X----------X---X-o--X----------X-----B----o--B---X----X---X-B-o--------E-----EX---------XXX-----------?-o--B--------------?-------o-----B---
------|--X------X---------------------oEX--B--------EM----------------------B-----BoX---XXMX---X-X----XX---oX-------E-------X--EXB-----X-E------X-----o--X---------E--X-----o-X-X-----XX--BE---XX--?-XX-
--BX-M|o---E---Bo----------X-X--E---E-X-----o----?-----X--XM----E-B-----X-E----------------------E-XB------o----o----M---B----?-----------------------X---B-X------E--------B-X-----------B-------B-----
--X-X-|-o------EX----------X--B-XMo-o---?X---?-B?-o------X--X--E--X-X----X---?E----E-------------XX-o----o----B------B-------M---------X------------X-------o-o---X----EX?-----X-------------X-EX----X--
------|------X---o---------XXoTB---X-?--o---------o----?--------XX------o----B----M--B-----o--M---XXX-B----X--X-?X----?-----o---B--Mo-X-BE---?-XoB-X----------XE--------------X-BX--------------?--o----
m-----|-XXo------o--XX--o?----XX----E----BM--o----X--M-X--B-----E-----------T--B--T-----T-XXo-T-------Xo-o-B------------X---T--B-E-o----X-XX-------------X--M----X--XT-B-X-----E------X-XB-X------------
XXXXXXXXXXXXXXXXXXXXXXXXXXXXXXXXXXXXXXXXXXXXXXXXXXXXXXXXXXXXXXXXXXXXXXXXXXXXXXXXXXXXXXXXXXXXXXXXXXXXXXXXXXXXXXXXXXXXXXXXXXXXXXXXXXXXXXXXXXXXXXXXXXXXXXXXXXXXXXXXXXXXXXXXXXXXXXXXXXXXXXXXXXXXXXXXXXXXXXXX
