-------oX-------------X--------------------BBoBX----------------?B---------------X-------------BBBX--XX------------?BB---BB----BMB--B-----------oBX----------X---------X---BX------B--------------------
XX-----XBX-?B-----------------BBX-E-------------------E-----X-------------o-----------------BB?--------BX------------M-----MBBX-------------------------M-B--XB?X------B-------------------MXB??B-BBBX--
ooBB---------------------BBBXXB-------------X-------M------BX-------XX---------B-----B------XX-------?BX----------??-----XBX?B------BB------------------------o-----B?----------------------------MBMXB-
-------------------------BX??XoB?B-----------------X?----------X---------o?-------------B--------------XM?M----------BBX?--BMMMBBBXoB----------------??-----B?-----XMB---------------------BBB?------X?-
---o??--------------BBB------BXX--------XB------------XB--------------------?BB-------o?------------X-o?BBXB------BM------------------------?BX?----BB-BXB?----B--------X--XX??--MXXM--------MMMBX?MBBB-
-----------MXBB--------------BBB-MB-BB--------MB-----XXB---BM----??B??X------------------------------------------X?---------BBB-------------BB--------------oX--------------XX-------MB-XX----X--------M
-M-------XX--BB--XXMM-?---------------X------------XBXMX--BBBXB------------------XX----------?XXXB-----------------XM?-----------oB-----------?XBXB-----------oBBBXBXB------------------oBX--X----------
-----------------X---------BBBBBB--X--------------------oM?B--------------oBB?------------------BBBXB--------XM---X-------XX---------B----BBBB-----------X-BBX---------------BBXB--BBMBBMXoM-----------v
--------BX---?--------BB-----------??XBBMBB----------------------MBX?---?BB--------------XXXB---XB?BX?B----------------------------XXM-----B---X----o--------------------------------------------------f
---------------------------------BXX-------------------------------ooXBB------B---------------------M--BMB--------------------B---oB--XX---------------------XXX------BM--------B?X--------------------f
----------BBMB-B?B---------------------------------X--------------------------------------------XMB---------BX-------??BX-EBBXBBB-----------------------------M-----XBB?B--------------X------BB-XBB---f
------------?BBBB---------------------X?M------oBM----------------------------------o?-oBX--------------------------------??-------B?---------B--------BBB?XXBXMX----------------------BXX------------Xf
-----BXX-------------------------------------------XX--------B-----------------------?M-------------B------------ooBX-----------XB-----BB--------------XXM?X-----------------X-BB--?-BXXX-------XXB--BXf
----------------MBXXB------XE?X-?X?B?B------XXBX----------BX----BB--o----M?--------------BB-----X------XX----------------------------------------------------------XX?----------------XXE--------------f
m---------------------------oXXMX---------BB---------------------EB------------------------------oXXBBB-?--BBBBMBB-----BX----------------------------------BBX---------------------------------T--XB-?-X
XB--XX?-?MB-----XX----------------XBB---------?XB---------BB---------------MB-BXX-------------------------------BXXBX--X------------XXBBE----------M?----?B--MB-------M-------X?X--------------|?-B----X
XXXXXXXXXXXX-XXX-XXXXXXX|XXXX--XXXX|||XX-XX-XX-|X|XXXXXX-XXX-|XXXXX|XXX-X-XX|XX-X-XXXX-X-XXXX-XXX-X-X|X|XX-|-XX-XX-XX|-|X-X-XXXX-XXX|-X--XX-XX-|XXXX|XXXXX-|XXX-X-XX-|--XXXX-X-XXXXXX--XXX--XXXXX-XXX--X
