-B?BBX-----------------------------------?XX-----X---o----------------oBBB--M-XX-------------------------XXXBB-----------X---------------------------EX--o?--------------------------------?---B?B?-----
------BX-------------?BX------------oB-----------------------------------------?XX?----M???----------X-----------?BX--------------MBX?---------------------------B----------------B------------oB----MEM
-------MXB-----------------------?B---------------------MMBXX----------------------XX----X-----------------XBX----------------------------MBM--B----M------------------------------------XBM--------B---
----E-----------BXX?--------------XXB-----------???M--EMX------------------------------MB----------------------------XX----------------BB?------------oBB---------------BXX---------XX---MM?------------
---BB------------------------------X?---BB-----oXXBBXB-------------------BX----M?---------------------------------------BBBXXMXB-----------X----------BXB----------------------BB-----------------------
---------BBX---------XMB---------B-----?BBB----------XBM-------BB--------------------------------X?----------BBBoM??XBBBM?BB-B---B--------------------X--o---------XXB--------X??B------B------MX-------
--------------BBBBBB-oB?X----------M?B?---------------?XX-??BX----BBM-----X--------EB-----EX-XBX-----X-------------------E--B?---------------?XX--BBB----?M-------------B------------BXBBB-----o------?-
--------------------------------------------X-------M-----------------------MMBBMBB??M------------B---M?B----------------------B-----------XB-------Bo----------------o--XB-----BB-B------B?B----------v
------------------------B----X?----------XM--XBX-----BX----------o----o----oX-MBX?----B--------XB--XBMX-------B---------EMXBMB-BX?--------------------XB---------BBBB-----XX?--BXMB------------?B--XXXXf
---MB?----------------MBBB?X-------XXMB-----XXBBB------MB-----------X?--B------B-----X?B??------X----B--------BM----XBBBB-----XM------BB--------------------o-------------------------BB-----EBM-------f
----B--B-----XX----MX?-M?BXM------?-----oB------------BB------------------------?----------?XX-------------------BB-------BM-------BBBX-BBB?B---------EXB-------B---------------BXXXXXXXB-MBB?B?-------f
-------------------X---------oX----------X???M------BBB-----EX-----o--------BB---------MX-XB----------BBB----------MB----------------BBX?XX----------------B?BX-------------------EB-------XBXXB--?BXBBf
---?--------o-----------------XB---------XBBB?--------X-B----------oo-------EB-------M-------BBX-----------------X?-----------------E-------------------MXM--------------------?----oB--EB-------------f
--BB-----------------------B----------B-----------------------------------------------B-----MBXBB---XX--T------------BMM---------------------------------------------------------------oB---------T-?XXf
m----M??B----BXB---------------XTB--oB-MB----------TXXB-------TMMB-------TT---T--T?XXXT---M?-----------T|?--T??-----XX-----------B------XBBX-----------B-BTXX-----BB---TB?--X----TXX?---------o-oX|BMXBX
X--?XXXXX-BBXXXX-BX-XXXXXXXXX--?|XXXX-BXXXX?XBXXXXXXX-BXM?X-XX|BXBB-XXXXMMXXXX|BX|BBXXX-XXXXXX-BBBBXXXX?M-XXXX-X-XXXXXXXXXXXXXX-XXXXXXBBBXX-BXXX-?XXXX-BXXBXXXXXXXBXX-XBB?X?XXXXX|BMB?BXXXXXX?XXXXXXXXXX
