-BB--------------------------------------?BBBB---MM--??X--------------oBBBX-MMXX?X--------------------------?X--------------?BB--?---------XBB-------MXX---------------B??---B-------------------X------
------BBMB-----------?BXB-----------oBBBBXX------------------------------------oXX-----BXX?----------B-----------XBXB-------------oB---------------------------------X--------B?BBX-----------------B?-M
-------X---------------------EX------------------------------BB?----------------------XXXo?B----BBXBB-------------------------X--?------XB---------o------------------B?--B?----------------------------
----BX----------?XB---------------XX-----------------oBBM------------------------------------------------------------B?X---------------BBB------------oXXX----EXX--B----MB--------------------------XBB-
---B-------------------------------oX---XM-----oXBB--------------------?BM-X--------------------XB----------------------------------------------X---------------------o--------------------------B------
---------BB----------B?----------------?BBBB---------BB--------BB----------------------X-X?X------------XBBM?--------------ooB??X----------X--------o--------------X??-oBEBXMX?B---oE?XXB----o?---------
--------------XBXXB--MX?X----------EX-----------------XXXBB??oX---XBB--------X----------------o----------BXXX--XB-----------XM----EX--o-----------------------X--------X?X--B--B?-------------?X------X-
--------------------------------------------BMB-----XB----------------------BB--MBXX?XXMB--------BXXX----M--BXB--MBX-------B--------BB-----B--------ooM--------B--------------B----------XBX?--------BBv
------------------------o----BBX---------X---XXX-----BBB---------B------------------------E-BBoXBXXB------------------------------BX----------?--------------------------------XB-E--------------------f
---B------------------BB-----------X?-------BBBB-------M------------MBB-BXB?-----B--B??-BXXXM?--------BB-------------------B?----------------XBM-----------------------------------------oMX?----------f
----?MMBX----BX----X---M----------o?XBXX?---X----MM--------------------o-----------B-X--------------------------------------------MXXM-X-------B---------------oXMBX?MMBX----------------XX------------f
-------MBB-----B---XB--------o?B?----BB------------------------XXB?B?B------o--------------?-----B-------------BBBXXXXMXX--------------------------------------------?-----B-?X------B--------XB-------f
---BB-------B-----------------oBX--------BXB----------XXB----------XXM------MBB------M-------XBB-----------M?B-------------------------------B?XBBBBBX-XMB---------------------MB----?B---------B??M---f
--BB-----------------------------BXB----------------------MBM--------B--------X----B--------XB-XX-----------------X??B?-BX---------B----MBX-------------X-------------------------------MB-------TBM---f
m----?--BB---MMXX---------------TB?-?B?------------T-BXM------TXMB-------TBB------?-------XBMB-BM---TMBTTXBMM-?B--BXB-TX----B?B--------B--------------?----BB-M-?MB-T---------TB-MXXX----XXB----EB-----X
XXXXXXXXXBMMBXXXXXX-XXXXXXXXXBBB|XXXBBXMXXXBBBMXXXXBXXXXXXXXXXXXXXBXBXXXXB?XX-XXX?BBXXXXX-XXXXXXXXXX-XXXXXXXXX-----?BBX??XMBBM-MXX-X-XXXXBXXXXXXX?-??BXXX--???XXBBXBXXBBMXXXXXX-XXB?MXXXXXXXXXXXXXXX-BXX
