--B?XB---------------------------------XBMB--------------B---------BBBB---oXXM---------------------------------------------XBBBM---------BB----------MBX?XB------?B?BBB----XM--------??M-?B----------MM-
-----B-----------oBBB-?B---------BXM-------oB-------XX?----------------------o?B---XXMB--------------------?-XXBB------------------XBBMBB---------------------------------?----------------------------B
------------MBB-----------ooBB-------BB-oX-------------------------------------------BB----------------------------------------------------X?----XMB----------B?BB--------B?B------B--------XXBB--------
XXB-------------------------XX--BBBB----X?B-------------------BXB-X---BMX??-?-----------------?XX?---MB?-B-----------------------------------------------?B?BB-------X----?BB-----XBX-----------------B-
-XXB---------B-----------B---------------------EMM-BMBB?----------------------------XXXBX--B-M-X------???BBBB?X??X-------------------B?XBXX?--------------------XX?B----------------------BX--BBBXX-?B--
-----X-----------------XBX?X??BBBBB-----?B-----MXBB------------------oX?-------------------B??XXB----------BBB-------B----------------XBBX---XB------------------------B--------?-------MEM?BXXBBXBB?---
-------?XB------MB-------------------------X-----------------??--------------------XB-?X---oo?----?-ooXM-----------------X----------------------------------o--oMXBX??---------?---------------BBX-X?XX-
-------------------BBB------------B--XX?XX-?---------------------------------------------------------------------------------------XX-----XB--B------BMXMMMB?-----------XMX-----------BX--X------------v
------MXB?BX-----XB---------MBB------XX-------?----XBBB-??B-----BBBBBBBBXBB--------X?BB-----BB----------------------------XX?-----------------------------oBXM--EoXB-----------BBBX---------------------
B?-XX--------------BB--BBXBMX--------MBB---M-------------------M--B??-----------X-XBM?XXB-----------BMBM?XM-------M?---------------oBXX-BBXB?BB---?---------------------MB---?B-----BBB-------XB--------
------MXX------------------------o---------?B--X----BBBB------------------EX---X?BB------------------------------MMBBB--------------------XMB----------------------------------------------------?BB----
--------------------------B?-----------------------XX---------B-----?B--X?------------------X-------X-------BXB?B-------XX----------------XXB------XXXBXX----X--B----BBX------B---X---------oBB??-------
------E--------MXB----?X-----XB--X-XMM-------------------------------?X-----X?----BBX--------------MBBX?B?BBMBB-------???------BXXXX---------BM?--------------------------------------------------------
----------------?--XXXB-----------B---oB?-----------------------BBX--oXX-?X-B?XX?X--------------BXXM-----------MBB-----oBBB-XB-----------------?XXB--------------BB---B-----------MX----------------?BBE
m-XXBBBBBoB---------------X-M----T---?BBBBBB?X--BT-X----XXBXXXB---------T?-B??TB---XMX-M-TMBB?B--oXMB---M--?BB-----M-----TXXX-???MXBXXBB------T---T---BB---XXM----B--------------TX----------XTXBBBBTo--
XXXXBXXX-BBXXXXXXXXXXXXBBXXXXXXXXXXXXX-XXXXXXXX--XXXXXX-BBXXXBM??MBXXX?BXXBXXX|?BBB?XXXB--XB-X-M?-BXXXBXX-BB?XXXXXXXXXXMXM-MXXB?XXXX-XXXXXXXXXB-XXXXXXXXXXXXXXXXXXXXXXXXXXXXXXXXXXXXXXXXXXXXXBMXXBBBX?X-
