-B---E-----------X-----X-------oB--B---EX-X----------------B-X-EXX-X-o--E----B--oE----X------X-X------o-XX--X------M----E-------X------o-X------oE-BX---MM-XX----------X--?E-------oo--?---B-BX-oX------
-----XTX----?o--?--------EX-------X?--------X--B-o---B--X--------------------------X---------B-----X-?-----X----X--o-M------o---?B----o------X--------X------X---XM---X-o--X---------------------X------
-----?|----X--E-E----X---------o--------B--------o--MX---------E--XB----------MM-XXo-----------E---X-------B-------B-------------X--o?------o------------M-X----X-?o------X-o---o--X--XX------o----?----
-E----|M---------------B-------------M------X-----o---------------XX-----oX-X---X-----E-E-M----M--E--X-------B--------X--?--------X--X--X-----o-----XE-?-ME--?-----E--B----o-X---o----X-X------o-M-----E
---X--|---B--o----------------X--?-o-XX-o--X-B-BB-----X-------------X-o----X----E-X-X---------B----X---X-------X-------B----E---oM--B--X------X---------------XX?-MXX-X----X----?--E-----X--X-----------
-X-X--|-oX-------X------XXE-X-?---XX-X---?o------------------X--------EX----B----E-----XXX-X--o--X-------X---------------oB--X--X-----o-X-------?------------B-----?B-X-XTX---------X---?E-X-M----------
oB----|-------------BB-------------------B------X-?-------X--------X-oE--X------------M---------X----?--E?-M?-E---------B--E---X-----?--E-o-M----B-----------Eo------XB--XX-----------Bo----o-----------
-X-?--|--o--------X-X----------E-------o---E------?----------X--M-X-----------X--o---X---Xo----E-----------B--B-----o-----X-----------M---o--X--------oo---------X-?---?-----B--oEo-o--------o?o-------v
-X--B-|---X--X-MX---M--B--E---X--------B--BX-----o---B-?BX-------E--X-oX-X--------X----X--M--------M-X-X------o----------o------X------X-o--BX----------B---o----X----------------?--oo--MX----X-X----X-
------|--XX-------X--EE----------------B-XX---XXEo----XE-------?B--XB-B--XB--------X------X---M--------o-o-----X-----XX---oX-X-B--o----o-----X--E---B----o---B----XE--Xo--XE---o--o----o-?---------X----
--?---|-X---oo-B-------o----X-----X-----X-------X--X-M------------X-------------o-?---Xo-----X---o-BM--X?------?-X-------?-------oEB-B--------X---------o-----M-X--?----E----------E---------X---X-o----
X-----|------o-o-X--B?----?--o--o------?-------B--E-----B-B---------B-----X-X-EXo-----o--X----E--XX----------o------o-E--o----------X------BEB-B-EE------oo-----------M--------X-----X---X--E-----------
o-----|--------X--X------o-----E---X-B-?---------?-B-X-?--X-XM----------o-X--X-X-?X-o-----Bo-?-----X-X------------X-E-------X-----X-X---o-X-X?---o-----X?----E----o--o-X-E----B------X-X----------X--X--
B-||-o|--|-------XE-X------o-------X-E-XX---X--------X------XBX---B---------oX--X---X----XEX---X---E--?----o------Xo----X---o------B---X-?----E---------B---M---X-?----------E--------E---X-----X--X----
m-||--|--|------XoT---X---------X----o--------------------?--XX----XX------X----------X---------B--o-E---B--X--?-M------B--B----X--X-----B--------|-o-|---XXEBo---------X---E------BBX---XX-B---XBo-----
XXXXXXXXXXXXXXXXXXXXXXXXXXXXXXXXXXXXXXXXXXXXXXXXXXXXXXXXXXXXXXXXXXXXXXXXXXXXXXXXXXXXXXXXXXXXXXXXXXXXXXXXXXXXXXXXXXXXXXXXXXXXXXXXXXXXXXXXXXXXXXXXXXXXXXXXXXXXXXXXXXXXXXXXXXXXXXXXXXXXXXXXXXXXXXXXXXXXXXXX
