----X----o-M-B---X---Xoo-X---------E---------------------BB---E----X--------X-X---------M---BoX-oB-X---B-B--M---E-X----X----M-----X--------------X---X--B--X--E?-BX-B---o-B----X-----X------X----X--o---
--E----B--EXo--------?X-M------X--------E--M-o--B--------------X-------o------X--X----B-XEXX-X-B--B----------o-M----o-X-----------------X-------X----o-o?-------------------X----oo--X---o--X---X---X-oM
----?X-M----------X-o-o-o---X------------X--X---------------o-o-o-o-------------------------Xoo-B-X--o-----?-X---B-------o----X-o------------E---o-X---M--X----o-X-----X----X--X--X--X------------------
---XX-X------BX----X--oM--XX-----X-----X-----------?---o---------XE-----X-XE---X-?-BX-o-X----o----------------XMX----o---X--o---oo---B-X-X---?----B---X-BX----B-------B---o-----------------------------
X-?-o-X-----X-X--o---o-----------------E-B-----XX----X-----o----X-o---B----o------------ooMX---E--------XX-------B-X--X---X--E-B---------X-------X-------E--oX------X--oXE--E-E--X-B-X--o---X------M-XX?
---------------MX-----MX-?Xo--EB-----X------o--o-------B--X---Xo------XX----------B--B-----X------X-----------B---B---?B------------E---o-BoX--B----X-----B-X----E-X-E--X-X-XB------------X---XX----X-E-
-EE--o??--------------X--------------X-------------XX--B-XM?-X------------X---X--------------------------------B-X--------X---oX-o----XB-X-------------?----?---X--o-X----X---X---------XX-o---B--------
X-----Bo-o----------X-----o?---?--X----?--------X--------BBX----?---X--?----X----o--X---B--XB-----o---?-----M---X--X-XX-X-XX----o------X-X--B-M-------BX-oEo--XEX--X--M------EB--------------XB------X-v
-Eo--MM--M------o----------------o----X--------------B---X--X--ooE----------------E-o-E--X--------o-----------o-B-X--X-----o---X---X---E-X-X--------------------------------?-o-------B-X?-X-----X----X-
-----o----X---XB-X------B-XE------B-------XB-o-----o-X----?----B------E------ME--o--o-o---B---oX--M---X-M-E---X---?X-B--------------E------------o--B---o----o-X----o-X----E--XX----X--X----------------
--M--------------X------------------BX--o-----?-----oo----E---?-------?-E-E---o-X-----o----XX-X---------XB-o-----X--------?----?-X--o-------XE-----B--------o-E-XX------?-------o------X---M----E---Xoo-
-------B---X-X---B---XBoo-----X-M-XX--------------------------BX--X-o------B--------XoX------o---X-----X------E----o---------------o-------X------------X----X-B---B-o-----------B--X--B-o-------------X
--X-----X--X------X--X----B?---XEX-------------M--X-X--------XB---XX---E---X-B------?-X-B---o---X--E---X-?-X-------o-?-----o-----o--X-E--X-----o-E-o----?X-------?-XM------B-----o--o----X----X-X-BXX---
-X----X--BX------------M-X---------B----X----X-o---X-----X----?Bo-X----EB-o---X-------------o-X-X------XXoXX---B------o-X---?o----?--X-----o-XXB-------------o?------X--M--X----X-?oXX--o-X--M----o-----
mEX----X-?-M--B-X-M--X--oo----X|EX-------------X-----XX-X-o-XB-X-Xo----XX----X-o--Xo?-|----X-o-X-----------X?---X------------X-M------B---------B-M-----T|--------X---------X-?------X-----E--X-X-X--o--
XXXXXXXXXXXXXXXXXXXXXXXXXXXXXXXXXXXXXXXXXXXXXXXXXXXXXXXXXXXXXXXXXXXXXXXXXXXXXXXXXXXXXXXXXXXXXXXXXXXXXXXXXXXXXXXXXXXXXXXXXXXXXXXXXXXXXXXXXXXXXXXXXXXXXXXXXXXXXXXXXXXXXXXXXXXXXXXXXXXXXXXXXXXXXXXXXXXXXXXX
