--------------------------?--------------------------------------?o-Mo---E--M------X-o----?---------B------Bo----------|-------------o-----Bo?------------|-----------o----B-----E-------B--------------
----o-------T-----------------o------E--------------------?-B----------B----oE--M-------B---------M--E-B-------E-------E-------o-------ET----o--------M----------------?--------------|-----------------
-------X-------?E---------------o?------------ToB----------|-M----------------o-B-----------------EE-----oB----------oo----------------o-----B----X---------------------------T--------B----?------o-o-E
---M-------B-----------------B--------?-X-----------?E---|-o--------X-------B---?------E-----?T|--------T--------M--B-B----o----E---------E-------------?---------T--o-E-T-?E-------B---B----B----o--E-E
----------X--EX----?-|B---------E|-----B------------------T---B-o-?-o-----B-------o---------o------B-E|-X--B---------------B-------X-------B--------o----------B-----oE-----B------o----------|E------T?
-------?---------X----M-----------B-------------------B----------B----?X----------B--M-------B----------|-------------------E-M------B----B---oX-T--B--M-------T----o---o--------o---------TM-----oT----
-?--------B-----X----E-?----------------o-------B----------XB-B---E--||-o----------B-?-------?---------------E-M------------B-------E---------------E-------oT--o----------B----?B---?-|-----?----E---o-
------?-----------------------------E-E------B-B----?-E--E----?-------o-o--------|------X--------X--o-o----o-----o--T----------o------M-------------------------------------------XB---------o-o-------v
--|-o--o----oE--------------------------------------B---------o-------------X--------------?------o--------------B--X----E-----o-X-----------|B-----------------o------?---T----E----------------------o
-------B---X-----E-|-----|-------------o--BM--?--E------------T-----M--B?-----------------------------Bo--M----?-------o--------o---B-------E--------------E------------B-o---------?---------?---MB-XX-
----------M-----------M------------T--|------B----X--------M---o---------------------o?-M----------oo--o-Bo--oM?-----B--M--?------o------o-|------------|-----o--B---B----B|-?--|----------------T------
---o-|----?-----B-----B-Eo---M|----?------------X---------------------T|----------------B---------E------------M---------------?-------------E-------------------E---------Bo--------------o--------T-B-
------|---------------------B--?E--|--B---B-------oB----------B--E----?-B-----B------?-------------------------------B----------------?o----B--------B------EB-------------------X-?--E--B---?-o--------
----?-?-E--o-------o---------M---?--X-------?-------?------E---?-------M-----ET----------------------------------------o|---------B-----E------X----?--E-------?-------E--o----X-----E---------X--------
m-----------X------?----------------------------T---o-----------------------?-------------------------E|?-----B-----B-------T------------o----B-------------------|----------------------B--B-|--X---oB-
----------------------------o-------T-----?-B---T-----X----?--------XM--?-----------?--------------------------T-------T-------E------B--------o-------------------------E-|-------E--B---------------B-
