--------?XB---?---------------------XB---------BB?BB-XEM-----XBBX----------B---BXB------BBX---------XXX?BB--XBB?-----B-----XXB---B----------------------------XEXXBBBMB-------------------------MBB?----
---X--------------------------BB?X---oBB?---------------BX--X--------------------o------------X-----------------B--------B---------XX?-----------------------X?B--------MBBX-------------------X?XBX---M
-B??B?----BB--------B---BX-----M-----XXBB?MX-----------?X--X--?XXB----XB----oXBB-?BXB-------------MMX----------XX-----------------------X-------------?BBBB---------o---BBB--EB-------XXX-MBB-M---------
-XX-BB--------M--?X--------EX------E-----------------BB-BB-o------o?X--------------------------B--BB?--------XXXXBB------?---B------------BXB?-----BBX-----?BBMB--------XX------X----------------?-XBBB-
--------------------------------BXXMXB-BB---------------oB------------------------?---MBB-----???BM-------oMB-X---------------------B-oX----------X-----X----------M--XBX--oB---B-----M-----------------
-------------------BB?BX----?---X--?XBB----?B?------------------------BX--BB-o?BX--------------BM--X?-------------------------EXB------------MBXBX-------M-X??B-------MB--??XXBXX-------------BBX-XB-oX-
---------MXBXXXXXB--------XM------------XX--B??BX---------?MBBB-----------XMXX---------------------------------------------------BBXBMB--?B------BXX?----------XMX----------------XBXX-B----------------
-------?-----------EB--------Xo---BXX----------BM--------------------MBMB-----------------------MM------B-------BXXBMB----X-----------B-------M----?-------------o----X---------------------B?---------v
--------------------------------B----X--MM?-BX-BBBBX-----------------BMXBBMBB----XX?------BX--MX---oX-B------MXBBXBBM---MBB----BX--E-----------BB---------------?-----B--?-------BX--------------------f
BX----------XX------------------XB--------?-------MMXBoB----MXB--------------XX--------BB-MBXM-----------BBBX----------BB?M--------------------BBBB--XB------------XX----------X-----------------------f
----------------XXX-BB-----------------------------??-----------BMMB----------------------?B?--?XX??X?-----------X?---------------------------------------------?----XXB-------------------------------f
---------------X?XMBXXXX-XBB---BBBB------M-----M-------??XX----------------BBBBB----X----------------------B---MXM-----------XX-----X?BX------XBXB-----?B------BBMBB--?B?B---------oX??-X?XXB-BXXBB----f
------------------ooX?--o-------------------------------------X?X----------------?-BXB---------------M?-----------B--------------?---------------B------BX--------B?B----BB----BX?---------------------f
------------?------------XB?-------------------M---------BBBM--------XXX---BB-------------------------------------B-------MBB---B-----B------------X------------------------------------------BX------Mf
m--------E--------BBBB?B--X?B?-----B---BB----M-----BXB---------------------XB----oBBBXB----X-----------BBBX------------------------B--------BB----------B-----TBB??-XX---MXM?X-------XBB---------------X
XBBX----B--EXB------------------MM--??B------------------------EBXMX?B?BB----M?X-BBB--BBMB------------BX--------------------------B------------XX---------B-TBX---------BBB---------?---------X--?-----X
XX|XXXXXXXXXXXXXXXXX---XXXXXXXXXXXX-XXXX-X|XXXXXXX-X|XXXX-XX-XXXXXXXXX--XXX-XXX|XXXXX---XXX|XXXX-X-X-XXXXXXXXXXXXXXXXXXXXXXXXXXXX-XXXX-X-XXXXXXXXXXXXXXXXXXX-XXXXX|XX-XXXXXXX||-|XX-XXXX-X-XXXXXXXXXX--X
