--XXB-----------B-------------BBMBBMBMXB-X?--------?XM?------------X----------------------------------?BBMoXMX---BX-------?B---??X---------XX---?X------MXBB------------XBBXXB-BX--------------------X?-
-------XXX-XX---?M-BB-BXB---------B-----------------BB-X---------------------------?X-----------------------------o----B-----------o?-------------X-----------------?-XX------------?--------B--------M-
---------X----------XB------BB-----XB----o--XMB-------XB-----oB--------------------XB--------------o--------------------------B-----------X--?-X-?----B-----X--E?MX------------X-B-------M--------------
----------------X-------------B-------XXB-B-------X--M?BM??-B?-------------------------------------XX--B?BB?--X---------M-X-?BB--------MX--------------------BXX?B--------------------o-----------------
-------------------------o---------------------------o--MB--?--------------------?X----------XXX-----?---------------E-B------B-----XX---X?-------------------------------------------X-----B-----?B---E
-o-MME----------XB-Bo---------?X--Eo---XB-o----------------BMoX------------------------E------M-----B----------oM----X--E--?MM----------?------------M----X--B---B-X-----oo-X-------B--Eo------------B-X
-------MBBE---XX?X--------XXB------------oB?-----------???B?XXX-------X----BX?-------MB--------------?B?X---X---------XoM-----------BB----?----B--XBM-----o-----B------------M?X-E-?M--BBBBB----------B-
B-------BX----BB-----------------?B----------------------oB-B?--BX------------------XX-BBXXX-oM-------XX??---M----------------------------------------------oo-------BBM---XX--------EB---o-XB?B----B?Xv
-----------------------XB-------?BX--BX--B?X--M---B-X--------------------------------M---BXBo-------------B-X----------------Xo---------oX---------BBX-------------------------------------------MXX---f
---------------------------oX---B---BB-oB--------BX--BB-------?-------------------------------BM-----B------------------BB------o--X---------------?---------------------------------------M-------oM-Xf
------------B?X-------B--------------M---------------?BBB??---XB?XX------XXB--BBBBM-B------?---------------?------XBM-----MB--------------------XXBM---------?-B-XM-B---X----?BBE-----?XBBB?------?B---f
---------XX-----XB--?M-----?---------?----oXXBB-----X---E??-----X--BXX-X-?M---M-----X------------XBB-----X-----------X--------------------MX?------------BBX-----------XB------------XXX---------------f
------------B-BXXB?M?-EE--M----BB----ooBB--E?---------oXXBBBB----------B?B---BX---------------B--------o----B?--------------BBX?o-E----------------------------X-BB--------------oX--------------------f
------------B--?------?--------?M--B---------oB--------------------o----?---------o----------------X---X------X----X--------B--X---------------------------------------oM------------------------------f
m------T-XXBX-------------X------o----??-X-M-------------X-------------------M------------------------M----B--------------------------X------------------------------M---T-XB----------------------MXBTX
Xo---E-M--B--------E------------B-------Xo--E?---------B-?B-----o--XX------------------X-BXX----------X------------o---------------------------------X?------------------?XM---------o--o-?-----------|X
XX-X-X||----XXX---XXX-X||XX-XXX-XXX-X-|X|-XXXXXXXXXXXXXXX-X-X|XXXXXXXX-|X--X-XXXX--X|X---XX--X|X|-X--XXXXXXXX-XXXXX---XX-XXXXX||XXXX--X-XXXXXXX--XX-X|XXXXX-|XXX-XX-XXXXXXXX-XXXXXXXXX-XXXXXXXX-X-XXXX|X
