-----E--?--E--o--------------M-X-----?B--B--X---------------oME------BX-------------E------?---------B-----o-o--------------E------X---------------B--------X---------X-X--X----------?---------EX------
?-X--X----o-E--X----X-------------X------B------------BE----o----B---------------M----B----X-------------o--X--BE-------------o?--o------o---B--------B----------X--------E--?-----------X------?-----X-
E----M---------X----?--------X-----o---X-o--E---------B----o-------------?--------?-M-X----------E--------B--o-o-----X---------------E--X--------B----------------------------------M--X---X--------?---
-----o-----?----o------X-X-------B-E--------?-------E--?E-------X-o-------------o---?-----X------B-----------X------?-----M-----X---------E?---E-------Mo----------------X----------?M-----------o------
--o-----------------X-----?----------?---M-----o-----o--------------------------B--------X-----o--------Xo------X-----------X-------X-E------X-E----------B--------oE-----B-------------------B---E-----
-----EB-------E---o-------o-----M-----X----o-----B---------------------------o---------EM---Eo----X----------o-M-----E---o--E----------?--E----------X-------BX------E----M-oE----?-X-------------------
---------------?------o--?-?---------oB-M-X-----------------X--B-X-Bo------oB---------o-----X--?--------------------o--X----o------B-------------X---B------o-----o-----------------B-------------X--BE?
------------M------B----o---------------X---------B---------B-----M?------------------oX--M-E----------?B-X---------o----o-M---------E-----?-B-BB---X--B--EXBBX----------M-B--------E--------------B--?v
----M-X----------o-----X-------------o--------------------------E----------X------E-----------------X----o---E----------B-o------------X--------X-----------MB-----------E----o-----------B---------X---
------?----B-------?---B---------E--X--o---X--M---B---------Bo--E--M---M------oE-----X--------X--XX----X-o------------?B-------------B-E----------B------------o----X-oX--X--X---------oo-----E--?-o---B
----EE-------X-----oX--------------------MX---E----------BXE---B---BM-----M----B-?--------X-------o----?-------------------------B-----------X--------E--------o---X--M-E--X----X------------E-----X----
-----o-----------X-X------X-X-------Xo--M------M-oX-BM-------X--------E---X-----E-------o---------B-?---------oXo-----------E--E----------X-----------X------------------X-o--------X--X-X-XM-----------
--------------?---------------X-----------M-------oo-X?----X-B--------E-------E-------T---B--X-o-------B--o-XM----?----------?--------X------------E?-------------X-----o--?---X------o----?--E--o-?-o--
--------------M--EXT---T-TToTTooB--T---oT----o-B----T-X--------B-o-o--------------T-XX|--E---------T-------T----------------E--------T---TEE------------X-o--?------M-----------TB-B-?----?-------?T---?
m--------------o--o|--o|-||-||-----|-B-E|----------B|------o-B----E-B?oEM--X--B-o-|---|---?-X-o----|--E----|Bo--o----o-------?----X--|---|----o---E---?-----o-o---X---X--o-----E|----X----------E--|B-o-
XXXXXXXXXXXXXXXXXXXXXXXXXXXXXXXXXXXXXXXXXXXXXXXXXXXXXXXXXXXXXXXXXXXXXXXXXXXXXXXXXXXXXXXXXXXXXXXXXXXXXXXXXXXXXXXXXXXXXXXXXXXXXXXXXXXXXXXXXXXXXXXXXXXXXXXXXXXXXXXXXXXXXXXXXXXXXXXXXXXXXXXXXXXXXXXXXXXXXXXX
