-----------XX-----oM---XX-o--X-?----|-----XB--XX----X---?--E--o-X--o-?o---T--X----X-------B---B---X-----XX--X-|--?-------T-------X-XX----XBEB--------o----o-----------X-----M---E----M-M-XT-T-XB--o----M
-B---------X----------|-o-M-BB-E-----X-Xo--TXXo-------------------Xo--X---X--B--XE----------X-X----B-X-?-o-X-To-M---------oB---o--B-X-X-------X------Xo-BX----MT----------------------X-------X------X--
X--------E-B---E----X---Xo----------E---B----X--X-----TE----BE--Mo--o--X----X-oB-----------------|XX-X------X-|----X---------X-XX-----o---------------------B--?-o-|--o-------X------M---o----X--------X
E------E----?----M--o----?---o------X---XX-TX------------X----o--?------|-XXo--T--o-?---|-----E-o-E--B------------X-X-?X-----oo---o--T-B-X|----|-B-X-M--XX-----------oX---T??----|----B-------------X-XE
-B---E----X--X------o--X-----X-M|--|----o----X---X---o--o-X------E------EE--oMTX------X?o-X-----X---X----?X---------------X-----X-----------|---X-------------X--?---BT-------------E--|-----o---------B
-X--oX-------?XX-X---BX--o-?o-o------X--Xo---|-----M--X-----?X----o----------X---------XE--EE---?---o--B-X--------M--B----------X--BB------------X-----M?----o-----X-X------M--M-----o---------Xo-------
-----------------X-------------------E--B---B----Xo-o-B-------|------E-XE-----E---X----X--T--X---X----E----X--?-|-----------TX-XX--X--------X--X-------E----o--Bo-----B---XX-o-----X-----X----o-B--oo---
o------o-XX------X--oX-oX----X-X----X-------T--XXXXXB--XX--XE----BoX--------o-MM---?-o----X-X-----X-M-----o---|E-X----------------?X-X------------Xo---X----T--------E--X--?---------oB--EX----X------Xv
-----XX---XB--------|-o--XB--------X--X-----?-------X----X--------o---X-X------------X----E---|T?BX---X-X---E--TX-----B------------E------|o-o-|X----XBEX-E---TX------------|----Xo-o-o-----BXXE--------
--X----BX----?-----o---X-----X--X---X--------?-MX----XX--o-----X--X--XBX------Xo---T----------------------E-T-----X-----B----E----E-E-T---------|-o-----XX---X-o----X-X---X----------BX-----o---Xo------
-----------X--o--B--------------------------M--T------X--------?--X----X----T----X---------?-o-o--X-E------?M---B-----B--X?X-------------BX-------?X-?--E----X----o--o------X--X--|X-------?----oX-X----
--X-X---------------------B-X---X-----T-oT----------------oM|-------|?M---XX------E---X|---o--------EE--------T--------E-o-----X---X-------X--M--Xo--o?B--o-M-o-------------M--X-------------X---B----E-
-------------o--?-B-X--X-----BX---X----?-E---E---?--X-----M--------X-X--M--X-o---------o-M---|XX-B--------Xo---M----XX-------X--?-T--B--M---X------B-o-T-X-X--X-B-B-------X--XX------?o--BE-Xo-X--------
---------o--------|--------B----B---X-------------B-X------X-------o----------?-----X----X--M------M---o---|-?X-oXo----------X--o--Xo-E-----o---------------------------------------|---X------X--o-----
mB|-B---X--?-o---XX--X-X--B-XX--MTM-X----oB--X-----B--T--X----o------X-----o--o---X---XE--------XE-?--?--T----B--------o----------X-----E--oEo---------X----------|XMX--B--------------o----X-?X--------
XXXXXXXXXXXXXXXXXXXXXXXXXXXXXXXXXXXXXXXXXXXXXXXXXXXXXXXXXXXXXXXXXXXXXXXXXXXXXXXXXXXXXXXXXXXXXXXXXXXXXXXXXXXXXXXXXXXXXXXXXXXXXXXXXXXXXXXXXXXXXXXXXXXXXXXXXXXXXXXXXXXXXXXXXXXXXXXXXXXXXXXXXXXXXXXXXXXXXXXX
