-----XMX--------XXXBB--------------------?B------oBB-oMX--------------o-BBXXM-XXXB--------------------------??BM------------BBBB-?--------------XX-oX----------o?B--------------BB----------------------
------------------------------------BMXX---------------------------------------oXX-----?XX?----------BM?M?MB-----BBX--------------o----------------------------------XB-------B?XB?XX--------B----XBBXB-
-----E----------o-----------------------------?B----??B--BX----B---MM---XB---------?XB?B--BB?B---------o-----------B?--B---------------MX-------------MB-------XB-----BB-----------X---------------?B---
----------------------XBBB?----------BB-----oB-?X?MXB?---------------------------------XXB----BXBBM--XMX--BM---o?-----------BM------------BB-------------------M---oB?B------------oB-BBM---------------
--------oB------X--------------------XM??----BXB?MB---------M-?M--BB?M--------------------------M-----?M-----------------?X-----------MXX------BX----B-----------------XX----------BMB----------M-------
-B-----XBXM----------XBX---------------?MBB----------BBXX------BB----------------------XB------XXMBXX---------------------B------------------------------X-XB-----------------------------?B?XX---------
------XBBM---------ooB-------------E?-----------------XB?MXBBoX---BB?MX------B----------------o----------BBXXM-X------------MMX---??M-?-----------------------X--------E---E-----------------------B----
--------------------------------------------oM------BB----------------------X---XXM??------------?XXX?B--XB-MX--oXX------------------BB?B------------oX-------------------------?--------BMX-----------v
XX--------------EXBBX-------------------B-----XM--------------------------X-----EXB----------oBX--X-----------o-------------------BX----------?------------------------B?B-X?BB-------------oB---------f
--XXB-B?--------------XBMMBB-------X------X---BBB-------------------------------------BXXX-MBB---------------M-------BBMXXBB----------------MXX?B-----------oBB-------------XBB--------MB--------------f
--------------------XM------------------??B?XX-----B----------------------B-----------oBBBBB---------XMX---------?BB----BXX--X---------------------------------------------XX--------XB-----BBB-----X--f
------?BBXBXBX--------oX-------------XBX------XBB----------------------XMBX-------BBB?-----XBX---E-------------BBBX?X-----oMXB?--X---------MX----------BX?B---------B--------------------?-------------f
------------------MMB---------oX?--------B?B?---------XBBXB--------XoB---XXBBM----------EXX--BB-----------XB--------------o------------XX----------------------BBBBXX--------------BB-----------M?-----f
o?--------o?B-------XX-----------M------------------------MB---------BMB------X----oBBBB---------------?X-----------------XB--TX------------??X--XBMB-------------?XoB--XXB-----------?X---------------f
m-B---------T---EX-----TM-----MT------------------B---TMBBX---XBBX---?--------------T---------T----XMBM?-E-XB-?MT----------B--BBB??BBBBB-----TB-XoB-B-----B--------B---TB---?--TBBB------X---BXBBB----XX
XXX-?BBXX-XX|XXXXXXXBXBBXXXXXXXBBBXXX-XXBBXXXBBBBXXXXXXXXXXXMXXXX-?X-BBX?BXXXXXMXBBB|X--MBXXMX|XXX--XMBXX-XXXXXXM?XXBBXXB?BXXXXXXX-XXXXXX-XXXXXXX--B-XXXXXXXXX-BXXXXXXX|X-XXXXXX-XXXXXBBXXXXXXXXXXXXXXXX
