-?---------------------------------------??------oB?-B----------------BBBBXXM-XXXXBM------------------------??B-------------BBBB-?X-------------oXBo-----------oBX--------------BBMBX---BX--------------
------X?-------------XB-------------oMX----------------------------------------oBBB----?XBB----------B-----------XBX------MM------------------?MoXBXM----------------E--------B?BB?B--X----------------M
-------XX------------------------X----------------------XB---BB-----------------------BEBoBB----XB?----------------??X-B--------------oMBB---------??-----BBXMB?X------------------BBB-------------MBX--
----X?B?BX------------XBB------------BXB----?BXXXB?X-----------------------------------M------X?BB---?BX--BMX--BX-----------M-------------BBX------------------M---oB?-------------MB-M-----------------
---XM------------------------------o----BB-----BX?XBBB-------------------X-----XBB??------------------------------------BMM-----------BX?------BX----X--------------------BXBM?M-------??MM-----XB------
---------XX----------BMB---------------?BB??---------BB--------BBBB--------------------XX------??--XB---------------------MB------X-----MM-?XX?X---------------BB-o?---------------B--------------------
---------B-XB?-----------------X---BXBB?X-------XB---XXXB-------MXBB---EX----------M------B--BB------?-------------------E--B----------------B?---XBBB---oM----------------------XX?-EXX--------o-------
-----------------------XXX------XB-------BX?XXBXMBBM-------------XX----------------------------------------o-oBXo---------B------------M----------------oBM---------------M------------------BB-MB-----v
------------------------o----BX----------B---BBX-----?-----------BBB-------BB-MB?-----XB-------B---MB---------XB---B--------MM??X???XXX-------BB-X--------B---------MXB----X-----XXB--------oXBX--oX?--f
---M------------------BX-----------BB-------BXBB-------B------------X?--XB-----BBBB--oBB--------M----B--------B-----BBM?M?----BM------BX--------------------X---------------XB?------------------------f
----B?-XB----BXMX--X---MXXBBBB----XBB?--o??B-----------X?--------------oM----------XB??-----------------------------------XXXXM----BXB------------------------------------------------X?------BB-------f
-------------------------------B??X-E--BB------oXBXXXM------??oBX-----?BBXMBBMB----------XB--------------------BMBoMB-----oX-----?---------BMM---------MB?XXXBBB----X--------------------BBB-----------f
---?B-------------MMB---------oXXXX------BBB?X--------XBB----------Xo?------EB-------X?X-----BB------------MBX?------------------------------B??XB----------EXX----------------------------------BXBB--f
--BB-----------------------------B------------------------MB---------M--------XX---oB-------B--o------------------BBMBBBM---------X----?-----------oX--?BBT?---------------------------XX----------BXX-f
m----B--B?---BB-----------------TB--BXBB----XB?----T-------------X-?------EX--?--XXBBX-----------------T?BX-XX------?------------?XXX---?B-B---B-------B--BM?X-MTXXT-----XB-------o---TM--TMTBB-TX----TX
XX-XXXXXXXXXXXXXBBX-?BXXXXXXX--?|MMX--X-BXX?XXXXXXX?XXXXXXXXXXXXXXBB-XBBXXXXXX-XBB?XXMXXX-BBXXXXXXXX-XXXXXXXXX-----BMBB??XB?XX-MXX-XBXXXXMXXXXXXX--XBXXXXX-XBBXXBXX|BX?BMXXXXXXBMM??-XXX-XXXXXXM|XXXXXXX
