-oo------------B-?---X-B--X---X--|X-----M-B--------X------o--X---------M--XB---B-----o-X-----------------E--XX--XX----X-X-o----------M--?--B-E-X-------B-o?-E-X?-X-o------EX----o----BX-E--|------------
---E--T---?-----B--------X------X----X----X---X---------------------X----------M-----E--oX---X--------o-BX--X-X---T-X--E---E---E-----o--B--XB--|-o---------X-X--o--------------o----o------------o---B-X
-B|---|?------T-------------|-----X-X------o----o-------B-?X--BBM---X-----X-X----o--------X---X|-|-?--oE-X-B----XX---X-----o---X--------------o-----X--M-----M---E-MX-X---T--o----B----|----XX--XT----B-
X---B||-XEX----------M-T----E-B--X---B-?------------?---------XM------M-B---X----EX-----BE--E-----X--X---------X-o-ooX-------X-X----Bo-X--?---X--o---oo--E-X--BM--T---E-B---M----X-oX----------|o-XXo---
------|X?--------E?--B--X---B--o----o---o-M---XB-----B---------o--------X------?E------------X--XM------o--oX---X-Mo----------B----X--------X--X--XEX-X----oo-B--MT---XEX|oT--o----X---------o-----B-B-B
B-----|B------XE---X-T-------o------o----------X----M-E--X------X-------------------M-|---o-?X?--|T-E---?-E--X---M----------Xo-----X---------XE--XX-o---X-X---XXX-o---B--o---XX----EE--o-X-Xo----XB---E-
---XE-|----X-XXX----oX---MEo-------XX--------------|Xo---X--|T----X-----?----T--X---B--?o----------EXo----------------X-------XX----?--X------X--X---------X--o--X-X-B----X--X?------B-----o--------B---
-BX---|oX-------X--------X--MB---------------------X------X-------Xo-----T----T-X----XMX---B--XXX?-----?BX---X----o--------------------oT--oE----------X--X?---X-----o-E---?----------------X-----|-XE|v
------|---E-Xo--X--B----oXXo-BXX-|?--Xo-X----MB-----------X--------X-?-X-B--ME--------o--TB----Xo---X----o--X-o-----X-------X----X---X----X?o----?--MT---X---B-----TB--X---XX-X---------?-X-ooo----Booo-
--o-oX||----XB-B--oE--M---T--?---X--X---X|?-XX---------------------X-|T----M----T---|---X---XM-XX-B---------------o---E----X-----------?X---X?o--------E----------X-o--B-o------BXEXB--X---X---B-----E--
------|---------BB----------X-----X------o---X---X-oX-E-X----B---------BoT----------B----B-----|--BX-E-X---X-------?--X---o-----X--------Xo----??---o--?-------E--M-??--o----------?--XE-?--T--oE--B----
------|---------oT-?-X----M-X----B------------B-?-X-----o-X--X--X-?--------------oMX--------X-----o--XoX--?--o-------XX----XX----X----o?-B---B----X--XB------B---X--X----X--o--------------|--o---------
------|-------------------oX------M---X---o?--XX-----?X----o---?---?-----X?T-----X-EE--------X-o---XX--EMT-X---E---o|---?-?--o------------B------?-------XE----T-------oM--Eo-?---M-X----E---X--X-------
-----?|--|---XE-------B---o|----?--------X-----|M----X--|--o-o?---X------T-X----XX-----X-----?-|X------B--X-E?--o----M-X---X---oE---------T------XTX---------B----X---------BXX---X--X---------E--X--E--
m-XE--|--|---o---XX--------------------?--X------o----X----------------BT-------X-----------o-----X-o---X----X-?--B-------o------oX--?---E---X-XM--o-o----|---------X-X------X------oXo--X-X--------X-X-
XXXXXXXXXXXXXXXXXXXXXXXXXXXXXXXXXXXXXXXXXXXXXXXXXXXXXXXXXXXXXXXXXXXXXXXXXXXXXXXXXXXXXXXXXXXXXXXXXXXXXXXXXXXXXXXXXXXXXXXXXXXXXXXXXXXXXXXXXXXXXXXXXXXXXXXXXXXXXXXXXXXXXXXXXXXXXXXXXXXXXXXXXXXXXXXXXXXXXXXX
