--o?---o-X-oX-E-----B-?X-o-B---------B------XBo---E-X-X-----o-?-------EMo------------oE-X----X---E-----X-----X???X---X-B---------o-X-XB-------------------------X--------o--------------M-X--X---|-----X
--X---T--X--E-EX------X-oE--X--M----------o---X----X-------------X---------?X--X-BX----|-----X---X-B----X---?------------B-----B--|---X-X-----|-----o-E---------o-X------B-----ooX--T----------X-------X
-----X|-X--------X-X--Bo---?--EEX-oM--?-----E-o-----E-----o-----?-o---------o--o-B--o---------------?-X---X-----X------------XXX----X-oX--B------------------?--X-------o-X------X--|XX-----------------
-E-X--|----T---------BoX--?---X-----o---------------Bo-----X-o--B-X------------E-----X--XX-------XX---o?------o-?B---------------E--B---XXX-----o------------X-------X-E--B-E-----|-|-------|-----X-----
BM-X--|-B-X|----M-------X--------o-XB----X-?---E---E--?----XB----X-------------X------o-XB---X----XX---oXX-------X------E------------B--o--B----B----------X---XE-B-----------X---o-|----|---B-X--------
X-----|-----X----E--XX-o---?---E----B----EX---X---BX---X-------B--oB--B--M------X-X------B-E-----X-B-XE--o-X---E---E--XXEX-----B-----------------B-----o---X--------B------XX--X----|-----E----Eo-----X-
--o--?|-----Xo-X?-o-?o---?-----?-------XX--XX------X----E--E--?X-----X----o------|-X---XE--------M---oo-----E----X---------X---o----------|o------B--------|--X--X-----o--------BB--|B-MBX-----?XX-----X
-?-B--|----B-------o|X---B-----B-X-----oo----X------?---E----?---oXE|o----------X---------X----------------?oB--X------?-------------------?-o---X------X---XBB---o---o---?-|----o--|--E-------------o-v
-E---X|---M-----XX---|X----?------X-X-X-XM-----BX?---Xo---X------o-o-X-M----o--|-?-BXo---|----?X----X----o-B--?-X----o--------B--------XBE?---X---M---M--------------------------X--|?X-----E-----E-E--o
--o?--|----BE---?--------oXB--?--------X-----B----B-X-XX-XX-oX--Xo----oXX--?-Xo--M-------E---------X-XM-X--?---------B-X-M-------X---------o---X---oXX-------B------------|-?---XB--|------B---oX--EX---
-----X|-?--------------Mo-------X--X-X-------E--E--------B-E------------X---------------|-?X-----X-?----XX--?-X-X---X-----------o--X-Xo---o-E-|-o---XX-X--------BXo-----------------|---o-oo-X--------B-
------|--E---M-o-----EXX---X--B-oX--oX-?--o---X--E---X--E-X---------X---M----M|E-E------X-|X----X?----------X--o--XB--X-M----X---------o-X-X-o-o-o-----X-o--?-----------Xo--------?-|---EX-----M-?------
---X--|---XX|----X-B|-?----o------o-----------o----M----------E-X--B----?---o------MX--X-------X-------B|-X-o---X-?-X-----B---------X---oE-XX-E----------X--B----oX--X---B--?--oX---|---X-------------o-
---XX-|---Eo--Xo----XX---B---Bo--XB-o----X-----X---B--B---X----XM---o-oo--?---o--oX-X---X-X----X----?------E------o----?----X------?--X----X------oo-------M-|-X------?------------X|X-o--X--o----------
mE----|--XE--X------oX---?o-o----M--X-X-----ME----------?--------X-X---o-o-----X--X------X----------X-----X---E---E----X-X---XX----X-E-o------------X---ME------------X----X--o-oo--|---------X-XX-o--o-
XXXXXXXXXXXXXXXXXXXXXXXXXXXXXXXXXXXXXXXXXXXXXXXXXXXXXXXXXXXXXXXXXXXXXXXXXXXXXXXXXXXXXXXXXXXXXXXXXXXXXXXXXXXXXXXXXXXXXXXXXXXXXXXXXXXXXXXXXXXXXXXXXXXXXXXXXXXXXXXXXXXXXXXXXXXXXXXXXXXXXXXXXXXXXXXXXXXXXXXX
