-BX---X-----------o------X-B------?------------E----E----------------E-------E------X--?E-------X---E----X?-?----------------XX-B--o--------------EB-E-----?E----------X-E--------X----M-----E--------o-
-X-------X--------------------------MX------------------B-B-----------o--X--Bo----o-------------X------------M-------o----X-B--?-----E---------?--XXo-----?-----------------X---------------o-----------
--o--B----------E--------------------------o---oX---E------E--X-------------E----------oo-------------------------M-B-----o--X----E-------?-M---B-X-E--------------------B----------o----o-----o---E----
o---------------E----X-------B---X---E-B----B------------o--?-o--------------------X---M-X------------oo-------?-----------oXE----------E--------E-E--------X------------Xo------X---XEX-X---------E?B--
-B----------B---?---o--X---------X--oX-----------------E----B--X-X--------BX-----oB----E-----?------------E--B--X------------?--o----B-------------M---------------o------E---X-----MX--Eo--------------
---E------B?---------X-X-----o-----------o--B------------------X--?---E--X---o--X----X-E---------B------E----------?---B--------X----oB--?----X------------X-XX----X-----------o?--E--------BX---------o
--------X-----------E--?--XX----X-?--------------?--?------------o?------X-B--E-M-----X----E----------X-B-------o-------X--XE---------?------o--------B-o--EX--o-----X----?X------X------------X--------
--B----EX--------X-----X------M-----------o-------------------------------------X------------o--X------M------------------------X------o----------o----Bo--ME----B--B--B--o---------------?--EX--------v
-------M---EE----?-o----------------------------o----XE-----B----B-------B---------B---E----------B--------------oE-------X---------------------------------------?E----------o--------------------E---o
----------o-----------X-X------B----------------X-----E--B--------E---?--E-MB?------------o--B--M-----M--E----?--X---------------------o-E---BXM-M-----------------X-----E-----Xo----------?----o---X--B
------X------------X-o----Bo-----------------------------------X--E-----X-------EM--------o---?---------------------------B-----E-------X-X-------o------E----XoM---X--------o-?X---EE-----E------------
-----------EX------------------o--B------o---X-----X------M-o-X------------------M----------?-----------?----E--------o---?-------B---------------?--E-o-?---oME-----------------------?------------o---
--------B--o--X?-o----X----o-------?-----------X---o---M--X-?------B-----o------E---B---o---X-------------------o---B-----------E-----------X-------oBE--?-E------B----X-B------------o-----------------
-----T-TTT-T---T--------TBTE----B-T--M--T--------oTTo-----X--BET-----------T---T--T--TX--To---T-TT------T-------o--T--B--E------T--ETXEE-E---T---X-TE--?-ToT--X-T--X-T-MT-T---------------T----T-TT-T-T-
m----|-|||E|---|---B----|-|-XMB---|-----|E----?B-X||-o--X-----X|-X---------|---|--|--|?--|-?E-|-||-----M|?-----B--X|-----B--X-?-|---|M-------|---M-|--B--|-|----|-X--|X-|-|-X---B--B---B--|--o-|-||-|-|X
XXXXXXXXXXXXXXXXXXXXXXXXXXXXXXXXXXXXXXXXXXXXXXXXXXXXXXXXXXXXXXXXXXXXXXXXXXXXXXXXXXXXXXXXXXXXXXXXXXXXXXXXXXXXXXXXXXXXXXXXXXXXXXXXXXXXXXXXXXXXXXXXXXXXXXXXXXXXXXXXXXXXXXXXXXXXXXXXXXXXXXXXXXXXXXXXXXXXXXXX
